schedule_season,schedule_week,type,team_home,team_away,team_favorite_id,score_home,score_away,spread_score,spread_favorite,score_total,over_under_line,stadium_neutral,dome,badweather,weather_detail,spread_diff,score_diff
1990,1,reg,Atlanta Falcons,Houston Oilers,ATL,47,27,20,1,74,46,FALSE,0,0,"",19,28
1990,1,reg,Buffalo Bills,Indianapolis Colts,BUF,26,10,16,7.5,36,37,FALSE,0,0,"",8.5,1
1990,1,reg,Chicago Bears,Seattle Seahawks,CHI,17,0,17,6,17,37,FALSE,0,0,"",11,20
1990,1,reg,Cincinnati Bengals,New York Jets,CIN,25,20,5,9,45,42,FALSE,0,0,"",4,3
1990,1,reg,Cleveland Browns,Pittsburgh Steelers,CLE,13,3,10,3,16,37,FALSE,0,0,"",7,21
1990,1,reg,Dallas Cowboys,San Diego Chargers,LAC,17,14,3,3,31,37,FALSE,0,0,"",0,6
1990,1,reg,Detroit Lions,Tampa Bay Buccaneers,DET,21,38,17,6.5,59,43,FALSE,1,0,DOME,10.5,16
1990,1,reg,Green Bay Packers,Los Angeles Rams,LAR,36,24,12,3.5,60,43,FALSE,0,0,"",8.5,17
1990,1,reg,Kansas City Chiefs,Minnesota Vikings,MIN,24,21,3,1.5,45,37,FALSE,0,0,"",1.5,8
1990,1,reg,Los Angeles Raiders,Denver Broncos,DEN,14,9,5,1.5,23,39,FALSE,0,0,"",3.5,16
1990,1,reg,New England Patriots,Miami Dolphins,MIA,24,27,3,1.5,51,39,FALSE,0,0,"",1.5,12
1990,1,reg,New York Giants,Philadelphia Eagles,NYG,27,20,7,4,47,38,FALSE,0,0,"",3,9
1990,1,reg,Washington Redskins,Phoenix Cardinals,WAS,31,0,31,12,31,43,FALSE,0,0,"",19,12
1990,1,reg,New Orleans Saints,San Francisco 49ers,SF,12,13,1,4.5,25,44,FALSE,1,0,DOME,3.5,19
1990,2,reg,Dallas Cowboys,New York Giants,NYG,7,28,21,7.5,35,37,FALSE,0,0,"",13.5,2
1990,2,reg,Detroit Lions,Atlanta Falcons,DET,21,14,7,3.5,35,50,FALSE,1,0,DOME,3.5,15
1990,2,reg,Green Bay Packers,Chicago Bears,GB,13,31,18,3,44,38,FALSE,0,0,"",15,6
1990,2,reg,Indianapolis Colts,New England Patriots,IND,14,16,2,2.5,30,36,FALSE,1,0,DOME,0.5,6
1990,2,reg,Miami Dolphins,Buffalo Bills,BUF,30,7,23,2,37,42,FALSE,0,0,"",21,5
1990,2,reg,Minnesota Vikings,New Orleans Saints,MIN,32,3,29,6,35,40,FALSE,1,0,DOME,23,5
1990,2,reg,New York Jets,Cleveland Browns,CLE,24,21,3,2.5,45,38,FALSE,0,0,"",0.5,7
1990,2,reg,Philadelphia Eagles,Phoenix Cardinals,PHI,21,23,2,13.5,44,37,FALSE,0,0,"",11.5,7
1990,2,reg,Pittsburgh Steelers,Houston Oilers,PIT,20,9,11,2.5,29,42,FALSE,0,0,"",8.5,13
1990,2,reg,San Diego Chargers,Cincinnati Bengals,CIN,16,21,5,3,37,39,FALSE,0,0,"",2,2
1990,2,reg,San Francisco 49ers,Washington Redskins,SF,26,13,13,5,39,44,FALSE,0,0,"",8,5
1990,2,reg,Seattle Seahawks,Los Angeles Raiders,OAK,13,17,4,1,30,36,FALSE,1,0,DOME,3,6
1990,2,reg,Tampa Bay Buccaneers,Los Angeles Rams,LAR,14,35,21,3,49,47,FALSE,0,0,"",18,2
1990,2,reg,Denver Broncos,Kansas City Chiefs,DEN,24,23,1,6,47,39,FALSE,0,0,"",5,8
1990,3,reg,Chicago Bears,Minnesota Vikings,CHI,19,16,3,2.5,35,37,FALSE,0,0,"",0.5,2
1990,3,reg,Cincinnati Bengals,New England Patriots,CIN,41,7,34,9.5,48,42,FALSE,0,0,"",24.5,6
1990,3,reg,Cleveland Browns,San Diego Chargers,CLE,14,24,10,4,38,36,FALSE,0,0,"",6,2
1990,3,reg,Denver Broncos,Seattle Seahawks,DEN,34,31,3,9,65,37,FALSE,0,0,"",6,28
1990,3,reg,Green Bay Packers,Kansas City Chiefs,GB,3,17,14,2.5,20,42,FALSE,0,0,"",11.5,22
1990,3,reg,Houston Oilers,Indianapolis Colts,TEN,24,10,14,9.5,34,41,FALSE,1,0,DOME,4.5,7
1990,3,reg,Los Angeles Raiders,Pittsburgh Steelers,OAK,20,3,17,5.5,23,35,FALSE,0,0,"",11.5,12
1990,3,reg,Los Angeles Rams,Philadelphia Eagles,LAR,21,27,6,5.5,48,46,FALSE,0,0,"",0.5,2
1990,3,reg,New Orleans Saints,Phoenix Cardinals,NO,28,7,21,9.5,35,37,FALSE,1,0,DOME,11.5,2
1990,3,reg,New York Giants,Miami Dolphins,NYG,20,3,17,6.5,23,40,FALSE,0,0,"",10.5,17
1990,3,reg,San Francisco 49ers,Atlanta Falcons,SF,19,13,6,11.5,32,46,FALSE,0,0,"",5.5,14
1990,3,reg,Tampa Bay Buccaneers,Detroit Lions,TB,23,20,3,3,43,47,FALSE,0,0,"",0,4
1990,3,reg,Washington Redskins,Dallas Cowboys,WAS,19,15,4,14,34,42,FALSE,0,0,"",10,8
1990,3,reg,New York Jets,Buffalo Bills,PICK,7,30,23,0,37,43,FALSE,0,0,"",23,6
1990,4,reg,Buffalo Bills,Denver Broncos,BUF,29,28,1,3,57,41,FALSE,0,0,"",2,16
1990,4,reg,Detroit Lions,Green Bay Packers,DET,21,24,3,2.5,45,46,FALSE,1,0,DOME,0.5,1
1990,4,reg,Kansas City Chiefs,Cleveland Browns,KC,34,0,34,6.5,34,36,FALSE,0,0,"",27.5,2
1990,4,reg,Los Angeles Raiders,Chicago Bears,OAK,24,10,14,1.5,34,34,FALSE,0,0,"",12.5,0
1990,4,reg,Minnesota Vikings,Tampa Bay Buccaneers,MIN,20,23,3,8,43,40,FALSE,1,0,DOME,5,3
1990,4,reg,New England Patriots,New York Jets,PICK,13,37,24,0,50,40,FALSE,0,0,"",24,10
1990,4,reg,New York Giants,Dallas Cowboys,NYG,31,17,14,13.5,48,36,FALSE,0,0,"",0.5,12
1990,4,reg,Philadelphia Eagles,Indianapolis Colts,PHI,23,24,1,13,47,37,FALSE,0,0,"",12,10
1990,4,reg,Phoenix Cardinals,Washington Redskins,WAS,10,38,28,6.5,48,37,FALSE,0,0,"",21.5,11
1990,4,reg,Pittsburgh Steelers,Miami Dolphins,MIA,6,28,22,2,34,36,FALSE,0,0,"",20,2
1990,4,reg,San Diego Chargers,Houston Oilers,LAC,7,17,10,2.5,24,40,FALSE,0,0,"",7.5,16
1990,4,reg,Seattle Seahawks,Cincinnati Bengals,CIN,31,16,15,2.5,47,43,FALSE,1,0,DOME,12.5,4
1990,5,reg,Atlanta Falcons,New Orleans Saints,ATL,28,27,1,2.5,55,40,FALSE,0,0,"",1.5,15
1990,5,reg,Buffalo Bills,Los Angeles Raiders,BUF,38,24,14,3,62,37,FALSE,0,0,"",11,25
1990,5,reg,Chicago Bears,Green Bay Packers,CHI,27,13,14,4,40,38,FALSE,0,0,"",10,2
1990,5,reg,Dallas Cowboys,Tampa Bay Buccaneers,TB,14,10,4,2.5,24,40,FALSE,0,0,"",1.5,16
1990,5,reg,Houston Oilers,San Francisco 49ers,SF,21,24,3,5.5,45,46,FALSE,1,0,DOME,2.5,1
1990,5,reg,Indianapolis Colts,Kansas City Chiefs,KC,23,19,4,6,42,37,FALSE,1,0,DOME,2,5
1990,4,reg,Los Angeles Rams,Cincinnati Bengals,LAR,31,34,3,5,65,47,FALSE,0,0,"",2,18
1990,5,reg,Miami Dolphins,New York Jets,MIA,20,16,4,6.5,36,45,FALSE,0,0,"",2.5,9
1990,4,reg,Minnesota Vikings,Detroit Lions,MIN,27,34,7,7,61,43,FALSE,1,0,DOME,0,18
1990,5,reg,New England Patriots,Seattle Seahawks,SEA,20,33,13,3,53,39,FALSE,0,0,"",10,14
1990,5,reg,Pittsburgh Steelers,San Diego Chargers,LAC,36,14,22,1,50,34,FALSE,0,0,"",21,16
1990,5,reg,Denver Broncos,Cleveland Browns,DEN,29,30,1,9.5,59,39,FALSE,0,0,"",8.5,20
1990,6,reg,Atlanta Falcons,San Francisco 49ers,SF,35,45,10,5.5,80,46,FALSE,0,0,"",4.5,34
1990,6,reg,Chicago Bears,Los Angeles Rams,CHI,38,9,29,2,47,41,FALSE,0,0,"",27,6
1990,6,reg,Denver Broncos,Pittsburgh Steelers,DEN,17,34,17,7.5,51,39,FALSE,0,0,"",9.5,12
1990,6,reg,Houston Oilers,Cincinnati Bengals,TEN,48,17,31,4,65,48,FALSE,1,0,DOME,27,17
1990,6,reg,Kansas City Chiefs,Detroit Lions,KC,43,24,19,6.5,67,41,FALSE,0,0,"",12.5,26
1990,6,reg,Los Angeles Raiders,Seattle Seahawks,OAK,24,17,7,4.5,41,39,FALSE,0,0,"",2.5,2
1990,6,reg,New Orleans Saints,Cleveland Browns,NO,25,20,5,5,45,38,FALSE,1,0,DOME,0,7
1990,6,reg,New York Jets,San Diego Chargers,NYJ,3,39,36,4,42,38,FALSE,0,0,"",32,4
1990,6,reg,Phoenix Cardinals,Dallas Cowboys,ARI,20,3,17,1.5,23,37,FALSE,0,0,"",15.5,14
1990,6,reg,Tampa Bay Buccaneers,Green Bay Packers,TB,26,14,12,2.5,40,44,FALSE,0,0,"",9.5,4
1990,6,reg,Washington Redskins,New York Giants,NYG,20,24,4,1,44,39,FALSE,0,0,"",3,5
1990,6,reg,Philadelphia Eagles,Minnesota Vikings,PHI,32,24,8,4.5,56,41,FALSE,0,0,"",3.5,15
1990,7,reg,Miami Dolphins,New England Patriots,MIA,17,10,7,10,27,42,FALSE,0,0,"",3,15
1990,7,reg,Buffalo Bills,New York Jets,BUF,30,27,3,9,57,42,FALSE,0,0,"",6,15
1990,7,reg,Houston Oilers,New Orleans Saints,TEN,23,10,13,5,33,43,FALSE,1,0,DOME,8,10
1990,7,reg,Indianapolis Colts,Denver Broncos,IND,17,27,10,1,44,44,FALSE,1,0,DOME,9,0
1990,7,reg,Los Angeles Rams,Atlanta Falcons,LAR,44,24,20,6,68,50,FALSE,0,0,"",14,18
1990,7,reg,New York Giants,Phoenix Cardinals,NYG,20,19,1,13.5,39,38,FALSE,0,0,"",12.5,1
1990,7,reg,San Diego Chargers,Los Angeles Raiders,OAK,9,24,15,3,33,37,FALSE,0,0,"",12,4
1990,7,reg,San Francisco 49ers,Pittsburgh Steelers,SF,27,7,20,10,34,42,FALSE,0,0,"",10,8
1990,7,reg,Seattle Seahawks,Kansas City Chiefs,SEA,19,7,12,1.5,26,42,FALSE,1,0,DOME,10.5,16
1990,7,reg,Tampa Bay Buccaneers,Dallas Cowboys,TB,13,17,4,8.5,30,38,FALSE,0,0,"",4.5,8
1990,7,reg,Washington Redskins,Philadelphia Eagles,WAS,13,7,6,5,20,44,FALSE,0,0,"",1,24
1990,7,reg,Cleveland Browns,Cincinnati Bengals,CLE,13,34,21,2.5,47,43,FALSE,0,0,"",18.5,4
1990,8,reg,Atlanta Falcons,Cincinnati Bengals,PICK,38,17,21,0,55,53,FALSE,0,0,"",21,2
1990,8,reg,Dallas Cowboys,Philadelphia Eagles,PHI,20,21,1,3.5,41,37,FALSE,0,0,"",2.5,4
1990,8,reg,Green Bay Packers,Minnesota Vikings,GB,24,10,14,2,34,42,FALSE,0,0,"",12,8
1990,8,reg,Houston Oilers,New York Jets,TEN,12,17,5,8.5,29,46,FALSE,1,0,DOME,3.5,17
1990,8,reg,Indianapolis Colts,Miami Dolphins,MIA,7,27,20,2.5,34,41,FALSE,1,0,DOME,17.5,7
1990,8,reg,New England Patriots,Buffalo Bills,BUF,10,27,17,6,37,42,FALSE,0,0,"",11,5
1990,8,reg,New Orleans Saints,Detroit Lions,NO,10,27,17,5,37,43,FALSE,1,0,DOME,12,6
1990,8,reg,New York Giants,Washington Redskins,NYG,21,10,11,3.5,31,38,FALSE,0,0,"",7.5,7
1990,8,reg,Phoenix Cardinals,Chicago Bears,CHI,21,31,10,6.5,52,37,FALSE,0,0,"",3.5,15
1990,8,reg,San Diego Chargers,Tampa Bay Buccaneers,LAC,41,10,31,3.5,51,36,FALSE,0,0,"",27.5,15
1990,8,reg,San Francisco 49ers,Cleveland Browns,SF,20,17,3,13,37,42,FALSE,0,0,"",10,5
1990,8,reg,Pittsburgh Steelers,Los Angeles Rams,PIT,41,10,31,1,51,44,FALSE,0,0,"",30,7
1990,9,reg,Cincinnati Bengals,New Orleans Saints,CIN,7,21,14,7,28,44,FALSE,0,0,"",7,16
1990,9,reg,Cleveland Browns,Buffalo Bills,BUF,0,42,42,3,42,39,FALSE,0,0,"",39,3
1990,9,reg,Detroit Lions,Washington Redskins,WAS,38,41,3,3,79,43,FALSE,1,0,DOME,0,36
1990,9,reg,Green Bay Packers,San Francisco 49ers,SF,20,24,4,7,44,43,FALSE,0,0,"",3,1
1990,9,reg,Kansas City Chiefs,Los Angeles Raiders,KC,9,7,2,2,16,38,FALSE,0,0,"",0,22
1990,9,reg,Los Angeles Rams,Houston Oilers,LAR,17,13,4,4,30,51,FALSE,0,0,"",0,21
1990,9,reg,Miami Dolphins,Phoenix Cardinals,MIA,23,3,20,9.5,26,39,FALSE,0,0,"",10.5,13
1990,9,reg,Minnesota Vikings,Denver Broncos,DEN,27,22,5,1,49,44,FALSE,1,0,DOME,4,5
1990,9,reg,New York Jets,Dallas Cowboys,NYJ,24,9,15,4.5,33,38,FALSE,0,0,"",10.5,5
1990,9,reg,Philadelphia Eagles,New England Patriots,PHI,48,20,28,9,68,38,FALSE,0,0,"",19,30
1990,9,reg,Pittsburgh Steelers,Atlanta Falcons,PIT,21,9,12,4,30,44,FALSE,0,0,"",8,14
1990,9,reg,Seattle Seahawks,San Diego Chargers,SEA,14,31,17,5,45,39,FALSE,1,0,DOME,12,6
1990,9,reg,Tampa Bay Buccaneers,Chicago Bears,CHI,6,26,20,5,32,39,FALSE,0,0,"",15,7
1990,9,reg,Indianapolis Colts,New York Giants,NYG,7,24,17,10,31,37,FALSE,1,0,DOME,7,6
1990,10,reg,Buffalo Bills,Phoenix Cardinals,BUF,45,14,31,12.5,59,38,FALSE,0,0,"",18.5,21
1990,10,reg,Chicago Bears,Atlanta Falcons,CHI,30,24,6,9,54,41,FALSE,0,0,"",3,13
1990,10,reg,Dallas Cowboys,San Francisco 49ers,SF,6,24,18,10,30,40,FALSE,0,0,"",8,10
1990,10,reg,Detroit Lions,Minnesota Vikings,DET,7,17,10,2.5,24,46,FALSE,1,0,DOME,7.5,22
1990,10,reg,Kansas City Chiefs,Seattle Seahawks,KC,16,17,1,6.5,33,38,FALSE,0,0,"",5.5,5
1990,10,reg,Los Angeles Raiders,Green Bay Packers,OAK,16,29,13,7,45,38,FALSE,0,0,"",6,7
1990,10,reg,Los Angeles Rams,New York Giants,NYG,7,31,24,4,38,44,FALSE,0,0,"",20,6
1990,10,reg,New England Patriots,Indianapolis Colts,NE,10,13,3,2,23,37,FALSE,0,0,"",1,14
1990,10,reg,New Orleans Saints,Tampa Bay Buccaneers,NO,35,7,28,7,42,38,FALSE,1,0,DOME,21,4
1990,10,reg,New York Jets,Miami Dolphins,MIA,3,17,14,3.5,20,38,FALSE,0,0,"",10.5,18
1990,10,reg,San Diego Chargers,Denver Broncos,LAC,19,7,12,2.5,26,40,FALSE,0,0,"",9.5,14
1990,10,reg,Philadelphia Eagles,Washington Redskins,PHI,28,14,14,3,42,44,FALSE,0,0,"",11,2
1990,11,reg,Atlanta Falcons,Philadelphia Eagles,ATL,23,24,1,1,47,47,FALSE,0,0,"",0,0
1990,11,reg,Buffalo Bills,New England Patriots,BUF,14,0,14,15,14,39,FALSE,0,0,"",1,25
1990,11,reg,Cincinnati Bengals,Pittsburgh Steelers,CIN,27,3,24,2.5,30,42,FALSE,0,0,"",21.5,12
1990,11,reg,Cleveland Browns,Houston Oilers,TEN,23,35,12,3.5,58,38,FALSE,0,0,"",8.5,20
1990,11,reg,Denver Broncos,Chicago Bears,CHI,13,16,3,2.5,29,40,FALSE,0,0,"",0.5,11
1990,11,reg,Indianapolis Colts,New York Jets,NYJ,17,14,3,3,31,37,FALSE,1,0,DOME,0,6
1990,11,reg,Kansas City Chiefs,San Diego Chargers,KC,27,10,17,3.5,37,35,FALSE,0,0,"",13.5,2
1990,11,reg,Los Angeles Rams,Dallas Cowboys,LAR,21,24,3,9,45,42,FALSE,0,0,"",6,3
1990,11,reg,New York Giants,Detroit Lions,NYG,20,0,20,12.5,20,40,FALSE,0,0,"",7.5,20
1990,11,reg,Phoenix Cardinals,Green Bay Packers,GB,21,24,3,5,45,41,FALSE,0,0,"",2,4
1990,11,reg,San Francisco 49ers,Tampa Bay Buccaneers,SF,31,7,24,14.5,38,43,FALSE,0,0,"",9.5,5
1990,11,reg,Seattle Seahawks,Minnesota Vikings,SEA,21,24,3,3.5,45,39,FALSE,1,0,DOME,0.5,6
1990,11,reg,Washington Redskins,New Orleans Saints,WAS,31,17,14,3.5,48,38,FALSE,0,0,"",10.5,10
1990,11,reg,Miami Dolphins,Los Angeles Raiders,MIA,10,13,3,3.5,23,37,FALSE,0,0,"",0.5,14
1990,12,reg,Dallas Cowboys,Washington Redskins,WAS,27,17,10,5.5,44,39,FALSE,0,0,"",4.5,5
1990,12,reg,Detroit Lions,Denver Broncos,DET,40,27,13,1,67,45,FALSE,1,0,DOME,12,22
1990,12,reg,Cincinnati Bengals,Indianapolis Colts,CIN,20,34,14,11.5,54,41,FALSE,0,0,"",2.5,13
1990,12,reg,Cleveland Browns,Miami Dolphins,MIA,13,30,17,5,43,36,FALSE,0,0,"",12,7
1990,12,reg,Green Bay Packers,Tampa Bay Buccaneers,GB,20,10,10,7.5,30,39,FALSE,0,0,"",2.5,9
1990,12,reg,Los Angeles Raiders,Kansas City Chiefs,OAK,24,27,3,4,51,36,FALSE,0,0,"",1,15
1990,12,reg,Minnesota Vikings,Chicago Bears,CHI,41,13,28,2.5,54,38,FALSE,1,0,DOME,25.5,16
1990,12,reg,New Orleans Saints,Atlanta Falcons,NO,10,7,3,4.5,17,43,FALSE,1,0,DOME,1.5,26
1990,12,reg,New York Jets,Pittsburgh Steelers,PIT,7,24,17,3.5,31,37,FALSE,0,0,"",13.5,6
1990,12,reg,Philadelphia Eagles,New York Giants,NYG,31,13,18,3,44,37,FALSE,0,0,"",15,7
1990,12,reg,Phoenix Cardinals,New England Patriots,ARI,34,14,20,5,48,38,FALSE,0,0,"",15,10
1990,12,reg,San Diego Chargers,Seattle Seahawks,LAC,10,13,3,3.5,23,37,FALSE,0,0,"",0.5,14
1990,12,reg,San Francisco 49ers,Los Angeles Rams,SF,17,28,11,11.5,45,47,FALSE,0,0,"",0.5,2
1990,12,reg,Houston Oilers,Buffalo Bills,TEN,27,24,3,3,51,47,FALSE,1,0,DOME,0,4
1990,13,reg,Buffalo Bills,Philadelphia Eagles,BUF,30,23,7,3,53,40,FALSE,0,0,"",4,13
1990,13,reg,Chicago Bears,Detroit Lions,CHI,23,17,6,8.5,40,38,FALSE,0,0,"",2.5,2
1990,13,reg,Cleveland Browns,Los Angeles Rams,LAR,23,38,15,3.5,61,41,FALSE,0,0,"",11.5,20
1990,13,reg,Dallas Cowboys,New Orleans Saints,NO,17,13,4,1,30,36,FALSE,0,0,"",3,6
1990,13,reg,Denver Broncos,Los Angeles Raiders,OAK,20,23,3,2.5,43,38,FALSE,0,0,"",0.5,5
1990,13,reg,Minnesota Vikings,Green Bay Packers,MIN,23,7,16,6,30,42,FALSE,1,0,DOME,10,12
1990,13,reg,New England Patriots,Kansas City Chiefs,KC,7,37,30,8.5,44,37,FALSE,0,0,"",21.5,7
1990,13,reg,Phoenix Cardinals,Indianapolis Colts,ARI,20,17,3,2,37,40,FALSE,0,0,"",1,3
1990,13,reg,Pittsburgh Steelers,Cincinnati Bengals,PIT,12,16,4,4.5,28,41,FALSE,0,0,"",0.5,13
1990,13,reg,San Diego Chargers,New York Jets,LAC,38,17,21,7,55,37,FALSE,0,0,"",14,18
1990,13,reg,Seattle Seahawks,Houston Oilers,TEN,13,10,3,1.5,23,42,FALSE,1,0,DOME,1.5,19
1990,13,reg,Tampa Bay Buccaneers,Atlanta Falcons,ATL,23,17,6,2.5,40,42,FALSE,0,0,"",3.5,2
1990,13,reg,Washington Redskins,Miami Dolphins,WAS,42,20,22,3,62,39,FALSE,0,0,"",19,23
1990,13,reg,San Francisco 49ers,New York Giants,SF,7,3,4,3.5,10,42,FALSE,0,0,"",0.5,32
1990,14,reg,Atlanta Falcons,Phoenix Cardinals,ATL,13,24,11,5,37,42,FALSE,0,0,"",6,5
1990,14,reg,Cincinnati Bengals,San Francisco 49ers,SF,17,20,3,3.5,37,45,FALSE,0,0,"",0.5,8
1990,14,reg,Green Bay Packers,Seattle Seahawks,GB,14,20,6,3.5,34,37,FALSE,0,0,"",2.5,3
1990,14,reg,Houston Oilers,Cleveland Browns,TEN,58,14,44,13,72,44,FALSE,1,0,DOME,31,28
1990,14,reg,Indianapolis Colts,Buffalo Bills,BUF,7,31,24,5.5,38,40,FALSE,1,0,DOME,18.5,2
1990,14,reg,Kansas City Chiefs,Denver Broncos,KC,31,20,11,7,51,38,FALSE,0,0,"",4,13
1990,14,reg,Los Angeles Rams,New Orleans Saints,LAR,20,24,4,5,44,43,FALSE,0,0,"",1,1
1990,14,reg,Miami Dolphins,Philadelphia Eagles,MIA,23,20,3,1,43,42,FALSE,0,0,"",2,1
1990,14,reg,New York Giants,Minnesota Vikings,NYG,23,15,8,6.5,38,36,FALSE,0,0,"",1.5,2
1990,14,reg,Pittsburgh Steelers,New England Patriots,PIT,24,3,21,13.5,27,36,FALSE,0,0,"",7.5,9
1990,14,reg,Washington Redskins,Chicago Bears,WAS,10,9,1,4.5,19,41,FALSE,0,0,"",3.5,22
1990,14,reg,Detroit Lions,Los Angeles Raiders,OAK,31,38,7,3.5,69,43,FALSE,1,0,DOME,3.5,26
1990,15,reg,New England Patriots,Washington Redskins,WAS,10,25,15,14,35,38,FALSE,0,0,"",1,3
1990,15,reg,New York Giants,Buffalo Bills,NYG,13,17,4,4,30,37,FALSE,0,0,"",0,7
1990,15,reg,Cleveland Browns,Atlanta Falcons,PICK,13,10,3,0,23,39,FALSE,0,0,"",3,16
1990,15,reg,Dallas Cowboys,Phoenix Cardinals,DAL,41,10,31,4.5,51,37,FALSE,0,0,"",26.5,14
1990,15,reg,Denver Broncos,San Diego Chargers,DEN,20,10,10,2.5,30,38,FALSE,0,0,"",7.5,8
1990,15,reg,Detroit Lions,Chicago Bears,CHI,38,21,17,3,59,44,FALSE,1,0,DOME,14,15
1990,15,reg,Kansas City Chiefs,Houston Oilers,KC,10,27,17,3.5,37,42,FALSE,0,0,"",13.5,5
1990,15,reg,Los Angeles Raiders,Cincinnati Bengals,OAK,24,7,17,6.5,31,39,FALSE,0,0,"",10.5,8
1990,15,reg,Miami Dolphins,Seattle Seahawks,MIA,24,17,7,4.5,41,37,FALSE,0,0,"",2.5,4
1990,15,reg,New Orleans Saints,Pittsburgh Steelers,NO,6,9,3,3,15,36,FALSE,1,0,DOME,0,21
1990,15,reg,New York Jets,Indianapolis Colts,NYJ,21,29,8,3.5,50,37,FALSE,0,0,"",4.5,13
1990,15,reg,Philadelphia Eagles,Green Bay Packers,PHI,31,0,31,10,31,40,FALSE,0,0,"",21,9
1990,15,reg,Tampa Bay Buccaneers,Minnesota Vikings,MIN,26,13,13,6.5,39,38,FALSE,0,0,"",6.5,1
1990,15,reg,Los Angeles Rams,San Francisco 49ers,SF,10,26,16,6,36,46,FALSE,0,0,"",10,10
1990,16,reg,Green Bay Packers,Detroit Lions,DET,17,24,7,3,41,36,FALSE,0,0,"",4,5
1990,16,reg,Indianapolis Colts,Washington Redskins,WAS,35,28,7,5.5,63,41,FALSE,1,0,DOME,1.5,22
1990,16,reg,Minnesota Vikings,Los Angeles Raiders,OAK,24,28,4,1,52,41,FALSE,1,0,DOME,3,11
1990,16,reg,Atlanta Falcons,Los Angeles Rams,LAR,20,13,7,3,33,41,FALSE,0,0,"",4,8
1990,16,reg,Buffalo Bills,Miami Dolphins,BUF,24,14,10,3.5,38,35,FALSE,0,0,"",6.5,3
1990,16,reg,Chicago Bears,Tampa Bay Buccaneers,CHI,27,14,13,6.5,41,35,FALSE,0,0,"",6.5,6
1990,16,reg,Cincinnati Bengals,Houston Oilers,TEN,40,20,20,3,60,44,FALSE,0,0,"",17,16
1990,16,reg,New York Jets,New England Patriots,NYJ,42,7,35,7,49,37,FALSE,0,0,"",28,12
1990,16,reg,Philadelphia Eagles,Dallas Cowboys,PHI,17,3,14,7,20,37,FALSE,0,0,"",7,17
1990,16,reg,Phoenix Cardinals,New York Giants,NYG,21,24,3,6.5,45,36,FALSE,0,0,"",3.5,9
1990,16,reg,Pittsburgh Steelers,Cleveland Browns,PIT,35,0,35,11,35,35,FALSE,0,0,"",24,0
1990,16,reg,San Diego Chargers,Kansas City Chiefs,KC,21,24,3,3,45,37,FALSE,0,0,"",0,8
1990,16,reg,San Francisco 49ers,New Orleans Saints,SF,10,13,3,9,23,38,FALSE,0,0,"",6,15
1990,16,reg,Seattle Seahawks,Denver Broncos,SEA,17,12,5,5,29,42,FALSE,1,0,DOME,0,13
1990,17,reg,Chicago Bears,Kansas City Chiefs,KC,10,21,11,1.5,31,36,FALSE,0,0,"",9.5,5
1990,17,reg,Phoenix Cardinals,Philadelphia Eagles,PHI,21,23,2,7.5,44,43,FALSE,0,0,"",5.5,1
1990,17,reg,Atlanta Falcons,Dallas Cowboys,ATL,26,7,19,2,33,36,FALSE,0,0,"",17,3
1990,17,reg,Cincinnati Bengals,Cleveland Browns,CIN,21,14,7,16,35,39,FALSE,0,0,"",9,4
1990,17,reg,Denver Broncos,Green Bay Packers,DEN,22,13,9,7,35,37,FALSE,0,0,"",2,2
1990,17,reg,Houston Oilers,Pittsburgh Steelers,PIT,34,14,20,2,48,38,FALSE,1,0,DOME,18,10
1990,17,reg,Los Angeles Raiders,San Diego Chargers,OAK,17,12,5,10.5,29,39,FALSE,0,0,"",5.5,10
1990,17,reg,Miami Dolphins,Indianapolis Colts,MIA,23,17,6,8,40,41,FALSE,0,0,"",2,1
1990,17,reg,Minnesota Vikings,San Francisco 49ers,SF,17,20,3,4,37,41,FALSE,1,0,DOME,1,4
1990,17,reg,New England Patriots,New York Giants,NYG,10,13,3,14,23,36,FALSE,0,0,"",11,13
1990,17,reg,Seattle Seahawks,Detroit Lions,SEA,30,10,20,3,40,47,FALSE,1,0,DOME,17,7
1990,17,reg,Tampa Bay Buccaneers,New York Jets,TB,14,16,2,3.5,30,41,FALSE,0,0,"",1.5,11
1990,17,reg,Washington Redskins,Buffalo Bills,WAS,29,14,15,4,43,40,FALSE,0,0,"",11,3
1990,17,reg,New Orleans Saints,Los Angeles Rams,NO,20,17,3,6.5,37,40,FALSE,1,0,DOME,3.5,3
1990,Wildcard,post,Miami Dolphins,Kansas City Chiefs,MIA,17,16,1,2.5,33,41,FALSE,0,0,"",1.5,8
1990,Wildcard,post,Philadelphia Eagles,Washington Redskins,PHI,6,20,14,4.5,26,40,FALSE,0,0,"",9.5,14
1990,Wildcard,post,Chicago Bears,New Orleans Saints,CHI,16,6,10,6.5,22,32,FALSE,0,0,"",3.5,10
1990,Wildcard,post,Cincinnati Bengals,Houston Oilers,CIN,41,14,27,3.5,55,42,FALSE,0,0,"",23.5,13
1990,Division,post,Buffalo Bills,Miami Dolphins,BUF,44,34,10,7,78,34,FALSE,0,0,"",3,44
1990,Division,post,San Francisco 49ers,Washington Redskins,SF,28,10,18,8,38,41,FALSE,0,0,"",10,3
1990,Division,post,Los Angeles Raiders,Cincinnati Bengals,OAK,20,10,10,6,30,43,FALSE,0,0,"",4,13
1990,Division,post,New York Giants,Chicago Bears,NYG,31,3,28,7,34,33,FALSE,0,0,"",21,1
1990,Conference,post,Buffalo Bills,Los Angeles Raiders,BUF,51,3,48,7,54,37,FALSE,0,0,"",41,17
1990,Conference,post,San Francisco 49ers,New York Giants,SF,13,15,2,8,28,37,FALSE,0,0,"",6,9
1990,Superbowl,post,Buffalo Bills,New York Giants,BUF,19,20,1,7,39,40.5,TRUE,0,0,"",6,1.5
1991,1,reg,Buffalo Bills,Miami Dolphins,BUF,35,31,4,7,66,42,FALSE,0,0,"",3,24
1991,1,reg,Chicago Bears,Minnesota Vikings,CHI,10,6,4,2,16,36,FALSE,0,0,"",2,20
1991,1,reg,Cleveland Browns,Dallas Cowboys,DAL,14,26,12,2.5,40,36,FALSE,0,0,"",9.5,4
1991,1,reg,Denver Broncos,Cincinnati Bengals,DEN,45,14,31,2,59,45,FALSE,0,0,"",29,14
1991,1,reg,Green Bay Packers,Philadelphia Eagles,PHI,3,20,17,2,23,44,FALSE,0,0,"",15,21
1991,1,reg,Houston Oilers,Los Angeles Raiders,TEN,47,17,30,2.5,64,44,FALSE,1,0,DOME,27.5,20
1991,1,reg,Indianapolis Colts,New England Patriots,IND,7,16,9,9,23,37,FALSE,1,0,DOME,0,14
1991,1,reg,Kansas City Chiefs,Atlanta Falcons,KC,14,3,11,7,17,42,FALSE,0,0,"",4,25
1991,1,reg,Los Angeles Rams,Phoenix Cardinals,LAR,14,24,10,7,38,42,FALSE,0,0,"",3,4
1991,1,reg,New Orleans Saints,Seattle Seahawks,NO,27,24,3,4,51,35,FALSE,1,0,DOME,1,16
1991,1,reg,New York Jets,Tampa Bay Buccaneers,NYJ,16,13,3,2.5,29,40,FALSE,0,0,"",0.5,11
1991,1,reg,Pittsburgh Steelers,San Diego Chargers,PIT,26,20,6,6,46,36,FALSE,0,0,"",0,10
1991,1,reg,Washington Redskins,Detroit Lions,WAS,45,0,45,7.5,45,44,FALSE,0,0,"",37.5,1
1991,1,reg,New York Giants,San Francisco 49ers,NYG,16,14,2,1.5,30,37,FALSE,0,0,"",0.5,7
1991,2,reg,Atlanta Falcons,Minnesota Vikings,ATL,19,20,1,1.5,39,41,FALSE,0,0,"",0.5,2
1991,2,reg,Buffalo Bills,Pittsburgh Steelers,BUF,52,34,18,7,86,42,FALSE,0,0,"",11,44
1991,2,reg,Cincinnati Bengals,Houston Oilers,CIN,7,30,23,2.5,37,51,FALSE,0,0,"",20.5,14
1991,2,reg,Detroit Lions,Green Bay Packers,DET,23,14,9,2,37,44,FALSE,1,0,DOME,7,7
1991,2,reg,Kansas City Chiefs,New Orleans Saints,KC,10,17,7,6.5,27,36,FALSE,0,0,"",0.5,9
1991,2,reg,Los Angeles Raiders,Denver Broncos,OAK,16,13,3,4,29,40,FALSE,0,0,"",1,11
1991,2,reg,Miami Dolphins,Indianapolis Colts,MIA,17,6,11,8,23,42,FALSE,0,0,"",3,19
1991,2,reg,New England Patriots,Cleveland Browns,CLE,0,20,20,1,20,36,FALSE,0,0,"",19,16
1991,2,reg,New York Giants,Los Angeles Rams,NYG,13,19,6,7,32,38,FALSE,0,0,"",1,6
1991,2,reg,Philadelphia Eagles,Phoenix Cardinals,PHI,10,26,16,6.5,36,36.5,FALSE,0,0,"",9.5,0.5
1991,2,reg,San Francisco 49ers,San Diego Chargers,SF,34,14,20,12,48,38,FALSE,0,0,"",8,10
1991,2,reg,Seattle Seahawks,New York Jets,SEA,20,13,7,5,33,36,FALSE,1,0,DOME,2,3
1991,2,reg,Tampa Bay Buccaneers,Chicago Bears,CHI,20,21,1,3.5,41,36,FALSE,0,0,"",2.5,5
1991,2,reg,Dallas Cowboys,Washington Redskins,WAS,31,33,2,2,64,40,FALSE,0,0,"",0,24
1991,3,reg,Chicago Bears,New York Giants,NYG,20,17,3,1.5,37,34,FALSE,0,0,"",1.5,3
1991,3,reg,Cleveland Browns,Cincinnati Bengals,CIN,14,13,1,3.5,27,40,FALSE,0,0,"",2.5,13
1991,3,reg,Dallas Cowboys,Philadelphia Eagles,DAL,0,24,24,3.5,24,38,FALSE,0,0,"",20.5,14
1991,3,reg,Denver Broncos,Seattle Seahawks,DEN,16,10,6,6,26,38,FALSE,0,0,"",0,12
1991,3,reg,Detroit Lions,Miami Dolphins,MIA,17,13,4,3,30,44,FALSE,1,0,DOME,1,14
1991,3,reg,Green Bay Packers,Tampa Bay Buccaneers,GB,15,13,2,3.5,28,38,FALSE,0,0,"",1.5,10
1991,3,reg,Los Angeles Raiders,Indianapolis Colts,OAK,16,0,16,8.5,16,36,FALSE,0,0,"",7.5,20
1991,3,reg,Minnesota Vikings,San Francisco 49ers,SF,17,14,3,3,31,42,FALSE,1,0,DOME,0,11
1991,3,reg,New Orleans Saints,Los Angeles Rams,NO,24,7,17,3,31,37,FALSE,1,0,DOME,14,6
1991,3,reg,New York Jets,Buffalo Bills,BUF,20,23,3,9.5,43,46,FALSE,0,0,"",6.5,3
1991,3,reg,Pittsburgh Steelers,New England Patriots,PIT,20,6,14,13.5,26,36,FALSE,0,0,"",0.5,10
1991,3,reg,San Diego Chargers,Atlanta Falcons,LAC,10,13,3,2,23,40,FALSE,0,0,"",1,17
1991,3,reg,Washington Redskins,Phoenix Cardinals,WAS,34,0,34,9,34,41,FALSE,0,0,"",25,7
1991,3,reg,Houston Oilers,Kansas City Chiefs,TEN,17,7,10,4.5,24,43,FALSE,1,0,DOME,5.5,19
1991,4,reg,Atlanta Falcons,Los Angeles Raiders,OAK,21,17,4,2.5,38,36,FALSE,0,0,"",1.5,2
1991,4,reg,Cincinnati Bengals,Washington Redskins,WAS,27,34,7,3.5,61,43,FALSE,0,0,"",3.5,18
1991,4,reg,Denver Broncos,San Diego Chargers,DEN,27,19,8,8,46,38,FALSE,0,0,"",0,8
1991,4,reg,Indianapolis Colts,Detroit Lions,DET,24,33,9,1,57,37,FALSE,1,0,DOME,8,20
1991,4,reg,Kansas City Chiefs,Seattle Seahawks,KC,20,13,7,7.5,33,36,FALSE,0,0,"",0.5,3
1991,4,reg,Miami Dolphins,Green Bay Packers,MIA,16,13,3,7,29,38,FALSE,0,0,"",4,9
1991,4,reg,New England Patriots,Houston Oilers,TEN,24,20,4,12.5,44,38,FALSE,0,0,"",8.5,6
1991,4,reg,New Orleans Saints,Minnesota Vikings,NO,26,0,26,3,26,36,FALSE,1,0,DOME,23,10
1991,4,reg,New York Giants,Cleveland Browns,NYG,13,10,3,12,23,36,FALSE,0,0,"",9,13
1991,4,reg,Philadelphia Eagles,Pittsburgh Steelers,PHI,23,14,9,3,37,36,FALSE,0,0,"",6,1
1991,4,reg,Phoenix Cardinals,Dallas Cowboys,ARI,9,17,8,1,26,36,FALSE,0,0,"",7,10
1991,4,reg,San Francisco 49ers,Los Angeles Rams,SF,27,10,17,7.5,37,38,FALSE,0,0,"",9.5,1
1991,4,reg,Tampa Bay Buccaneers,Buffalo Bills,BUF,10,17,7,8,27,44,FALSE,0,0,"",1,17
1991,4,reg,Chicago Bears,New York Jets,CHI,19,13,6,7.5,32,36,FALSE,0,0,"",1.5,4
1991,5,reg,Atlanta Falcons,New Orleans Saints,NO,6,27,21,2.5,33,35,FALSE,0,0,"",18.5,2
1991,5,reg,Buffalo Bills,Chicago Bears,BUF,35,20,15,8,55,44,FALSE,0,0,"",7,11
1991,5,reg,Dallas Cowboys,New York Giants,NYG,21,16,5,2.5,37,36,FALSE,0,0,"",2.5,1
1991,5,reg,Detroit Lions,Tampa Bay Buccaneers,DET,31,3,28,6,34,40,FALSE,1,0,DOME,22,6
1991,5,reg,Los Angeles Raiders,San Francisco 49ers,SF,12,6,6,3,18,36,FALSE,0,0,"",3,18
1991,5,reg,Los Angeles Rams,Green Bay Packers,LAR,23,21,2,4.5,44,38,FALSE,0,0,"",2.5,6
1991,5,reg,Minnesota Vikings,Denver Broncos,MIN,6,13,7,5,19,40,FALSE,1,0,DOME,2,21
1991,5,reg,New York Jets,Miami Dolphins,MIA,41,23,18,2,64,38,FALSE,0,0,"",16,26
1991,5,reg,Phoenix Cardinals,New England Patriots,ARI,24,10,14,6,34,36,FALSE,0,0,"",8,2
1991,5,reg,San Diego Chargers,Kansas City Chiefs,KC,13,14,1,3.5,27,36,FALSE,0,0,"",2.5,9
1991,5,reg,Seattle Seahawks,Indianapolis Colts,SEA,31,3,28,8,34,36,FALSE,1,0,DOME,20,2
1991,5,reg,Washington Redskins,Philadelphia Eagles,WAS,23,0,23,6,23,40,FALSE,0,0,"",17,17
1991,6,reg,Chicago Bears,Washington Redskins,WAS,7,20,13,3,27,37,FALSE,0,0,"",10,10
1991,6,reg,Cincinnati Bengals,Seattle Seahawks,CIN,7,13,6,3.5,20,40,FALSE,0,0,"",2.5,20
1991,6,reg,Cleveland Browns,New York Jets,NYJ,14,17,3,1.5,31,34,FALSE,0,0,"",1.5,3
1991,6,reg,Detroit Lions,Minnesota Vikings,DET,24,20,4,3,44,40,FALSE,1,0,DOME,1,4
1991,6,reg,Green Bay Packers,Dallas Cowboys,DAL,17,20,3,2.5,37,35,FALSE,0,0,"",0.5,2
1991,6,reg,Houston Oilers,Denver Broncos,TEN,42,14,28,7.5,56,44,FALSE,1,0,DOME,20.5,12
1991,6,reg,Indianapolis Colts,Pittsburgh Steelers,PIT,3,21,18,6,24,36,FALSE,1,0,DOME,12,12
1991,6,reg,Los Angeles Raiders,San Diego Chargers,OAK,13,21,8,7.5,34,34,FALSE,0,0,"",0.5,0
1991,6,reg,New England Patriots,Miami Dolphins,MIA,10,20,10,6.5,30,35,FALSE,0,0,"",3.5,5
1991,6,reg,New York Giants,Phoenix Cardinals,NYG,20,9,11,9.5,29,34,FALSE,0,0,"",1.5,5
1991,6,reg,Tampa Bay Buccaneers,Philadelphia Eagles,PHI,14,13,1,3,27,32,FALSE,0,0,"",2,5
1991,6,reg,Kansas City Chiefs,Buffalo Bills,BUF,33,6,27,3,39,40,FALSE,0,0,"",24,1
1991,7,reg,Buffalo Bills,Indianapolis Colts,BUF,42,6,36,20,48,41,FALSE,0,0,"",16,7
1991,7,reg,Dallas Cowboys,Cincinnati Bengals,DAL,35,23,12,6.5,58,40,FALSE,0,0,"",5.5,18
1991,7,reg,Kansas City Chiefs,Miami Dolphins,KC,42,7,35,7,49,35,FALSE,0,0,"",28,14
1991,7,reg,Los Angeles Rams,San Diego Chargers,LAR,30,24,6,3.5,54,38,FALSE,0,0,"",2.5,16
1991,7,reg,Minnesota Vikings,Phoenix Cardinals,MIN,34,7,27,6.5,41,36,FALSE,1,0,DOME,20.5,5
1991,7,reg,New York Jets,Houston Oilers,TEN,20,23,3,3,43,40,FALSE,0,0,"",0,3
1991,7,reg,Philadelphia Eagles,New Orleans Saints,NO,6,13,7,6,19,30,FALSE,0,0,"",1,11
1991,7,reg,San Francisco 49ers,Atlanta Falcons,SF,34,39,5,10.5,73,36,FALSE,0,0,"",5.5,37
1991,7,reg,Seattle Seahawks,Los Angeles Raiders,SEA,20,23,3,2.5,43,34,FALSE,1,0,DOME,0.5,9
1991,7,reg,Washington Redskins,Cleveland Browns,WAS,42,17,25,14,59,37,FALSE,0,0,"",11,22
1991,7,reg,Pittsburgh Steelers,New York Giants,NYG,20,23,3,3.5,43,34,FALSE,0,0,"",0.5,9
1991,8,reg,Green Bay Packers,Chicago Bears,CHI,0,10,10,3,10,35,FALSE,0,0,"",7,25
1991,8,reg,Denver Broncos,Kansas City Chiefs,KC,19,16,3,2,35,37,FALSE,0,0,"",1,2
1991,8,reg,Indianapolis Colts,New York Jets,NYJ,6,17,11,12.5,23,34,FALSE,1,0,DOME,1.5,11
1991,8,reg,Los Angeles Raiders,Los Angeles Rams,OAK,20,17,3,4,37,38,FALSE,0,0,"",1,1
1991,8,reg,Miami Dolphins,Houston Oilers,TEN,13,17,4,5.5,30,42,FALSE,0,0,"",1.5,12
1991,8,reg,New England Patriots,Minnesota Vikings,MIN,26,23,3,7,49,34,FALSE,0,0,"",4,15
1991,8,reg,New Orleans Saints,Tampa Bay Buccaneers,NO,23,7,16,13,30,32,FALSE,1,0,DOME,3,2
1991,8,reg,Phoenix Cardinals,Atlanta Falcons,ATL,16,10,6,2.5,26,38,FALSE,0,0,"",3.5,12
1991,8,reg,Pittsburgh Steelers,Seattle Seahawks,PIT,7,27,20,3.5,34,36,FALSE,0,0,"",16.5,2
1991,8,reg,San Diego Chargers,Cleveland Browns,LAC,24,30,6,5,54,36,FALSE,0,0,"",1,18
1991,8,reg,San Francisco 49ers,Detroit Lions,SF,35,3,32,7,38,42,FALSE,0,0,"",25,4
1991,8,reg,Buffalo Bills,Cincinnati Bengals,BUF,35,16,19,13.5,51,50,FALSE,0,0,"",5.5,1
1991,9,reg,Atlanta Falcons,Los Angeles Rams,ATL,31,14,17,2.5,45,40,FALSE,0,0,"",14.5,5
1991,9,reg,Cleveland Browns,Pittsburgh Steelers,CLE,17,14,3,1.5,31,35,FALSE,0,0,"",1.5,4
1991,9,reg,Detroit Lions,Dallas Cowboys,DET,34,10,24,2.5,44,44,FALSE,1,0,DOME,21.5,0
1991,9,reg,Houston Oilers,Cincinnati Bengals,TEN,35,3,32,15.5,38,46,FALSE,1,0,DOME,16.5,8
1991,9,reg,New England Patriots,Denver Broncos,DEN,6,9,3,6,15,36,FALSE,0,0,"",3,21
1991,9,reg,New Orleans Saints,Chicago Bears,NO,17,20,3,6.5,37,32,FALSE,1,0,DOME,3.5,5
1991,9,reg,New York Giants,Washington Redskins,WAS,13,17,4,2.5,30,38,FALSE,0,0,"",1.5,8
1991,9,reg,Philadelphia Eagles,San Francisco 49ers,SF,7,23,16,4,30,35,FALSE,0,0,"",12,5
1991,9,reg,Phoenix Cardinals,Minnesota Vikings,MIN,0,28,28,2,28,34,FALSE,0,0,"",26,6
1991,9,reg,Seattle Seahawks,San Diego Chargers,SEA,20,9,11,6.5,29,37,FALSE,1,0,DOME,4.5,8
1991,9,reg,Tampa Bay Buccaneers,Green Bay Packers,TB,0,27,27,2.5,27,34,FALSE,0,0,"",24.5,7
1991,9,reg,Kansas City Chiefs,Los Angeles Raiders,KC,24,21,3,6.5,45,35,FALSE,0,0,"",3.5,10
1991,10,reg,Atlanta Falcons,San Francisco 49ers,SF,17,14,3,5,31,39,FALSE,0,0,"",2,8
1991,10,reg,Buffalo Bills,New England Patriots,BUF,22,17,5,17,39,41,FALSE,0,0,"",12,2
1991,10,reg,Chicago Bears,Detroit Lions,CHI,20,10,10,7,30,32,FALSE,0,0,"",3,2
1991,10,reg,Cincinnati Bengals,Cleveland Browns,CLE,23,21,2,2.5,44,36,FALSE,0,0,"",0.5,8
1991,10,reg,Dallas Cowboys,Phoenix Cardinals,DAL,27,7,20,9.5,34,36,FALSE,0,0,"",10.5,2
1991,10,reg,Denver Broncos,Pittsburgh Steelers,DEN,20,13,7,6.5,33,35,FALSE,0,0,"",0.5,2
1991,10,reg,Indianapolis Colts,Miami Dolphins,MIA,6,10,4,9,16,36,FALSE,1,0,DOME,5,20
1991,10,reg,Los Angeles Rams,New Orleans Saints,NO,17,24,7,4,41,36,FALSE,0,0,"",3,5
1991,10,reg,Minnesota Vikings,Tampa Bay Buccaneers,MIN,28,13,15,11.5,41,36,FALSE,1,0,DOME,3.5,5
1991,10,reg,New York Jets,Green Bay Packers,NYJ,19,16,3,6.5,35,35,FALSE,0,0,"",3.5,0
1991,10,reg,Washington Redskins,Houston Oilers,WAS,16,13,3,6.5,29,43,FALSE,0,0,"",3.5,14
1991,10,reg,Philadelphia Eagles,New York Giants,NYG,30,7,23,3.5,37,32,FALSE,0,0,"",19.5,5
1991,11,reg,Cincinnati Bengals,Pittsburgh Steelers,CIN,27,33,6,1.5,60,38,FALSE,0,0,"",4.5,22
1991,11,reg,Cleveland Browns,Philadelphia Eagles,PHI,30,32,2,2,62,33,FALSE,0,0,"",0,29
1991,11,reg,Denver Broncos,Los Angeles Raiders,DEN,16,17,1,3,33,36,FALSE,0,0,"",2,3
1991,11,reg,Green Bay Packers,Buffalo Bills,BUF,24,34,10,7,58,37,FALSE,0,0,"",3,21
1991,11,reg,Houston Oilers,Dallas Cowboys,TEN,26,23,3,10,49,43,FALSE,1,0,DOME,7,6
1991,11,reg,Los Angeles Rams,Kansas City Chiefs,KC,20,27,7,4,47,40,FALSE,0,0,"",3,7
1991,11,reg,Miami Dolphins,New England Patriots,MIA,30,20,10,6.5,50,35,FALSE,0,0,"",3.5,15
1991,11,reg,New Orleans Saints,San Francisco 49ers,NO,10,3,7,5.5,13,31,FALSE,1,0,DOME,1.5,18
1991,11,reg,New York Jets,Indianapolis Colts,NYJ,27,28,1,13.5,55,32,FALSE,0,0,"",12.5,23
1991,11,reg,Phoenix Cardinals,New York Giants,NYG,14,21,7,6.5,35,34,FALSE,0,0,"",0.5,1
1991,11,reg,San Diego Chargers,Seattle Seahawks,SEA,17,14,3,2,31,36,FALSE,0,0,"",1,5
1991,11,reg,Tampa Bay Buccaneers,Detroit Lions,DET,30,21,9,3,51,36,FALSE,0,0,"",6,15
1991,11,reg,Washington Redskins,Atlanta Falcons,WAS,56,17,39,12,73,35,FALSE,0,0,"",27,38
1991,11,reg,Minnesota Vikings,Chicago Bears,MIN,17,34,17,3,51,36,FALSE,1,0,DOME,14,15
1991,12,reg,Atlanta Falcons,Tampa Bay Buccaneers,ATL,43,7,36,6.5,50,38,FALSE,0,0,"",29.5,12
1991,12,reg,Detroit Lions,Los Angeles Rams,DET,21,10,11,4.5,31,46,FALSE,1,0,DOME,6.5,15
1991,12,reg,Green Bay Packers,Minnesota Vikings,MIN,21,35,14,2,56,36,FALSE,0,0,"",12,20
1991,12,reg,Houston Oilers,Cleveland Browns,TEN,28,24,4,13,52,45,FALSE,1,0,DOME,9,7
1991,12,reg,Indianapolis Colts,Chicago Bears,CHI,17,31,14,9.5,48,38,FALSE,1,0,DOME,4.5,10
1991,12,reg,Kansas City Chiefs,Denver Broncos,KC,20,24,4,6.5,44,36,FALSE,0,0,"",2.5,8
1991,12,reg,Los Angeles Raiders,Seattle Seahawks,OAK,31,7,24,3.5,38,34,FALSE,0,0,"",20.5,4
1991,12,reg,New England Patriots,New York Jets,NYJ,21,28,7,3,49,35,FALSE,0,0,"",4,14
1991,12,reg,New York Giants,Dallas Cowboys,NYG,22,9,13,6,31,36,FALSE,0,0,"",7,5
1991,12,reg,Philadelphia Eagles,Cincinnati Bengals,PHI,17,10,7,9.5,27,38,FALSE,0,0,"",2.5,11
1991,12,reg,Pittsburgh Steelers,Washington Redskins,WAS,14,41,27,7,55,40,FALSE,0,0,"",20,15
1991,12,reg,San Diego Chargers,New Orleans Saints,NO,24,21,3,4.5,45,32,FALSE,0,0,"",1.5,13
1991,12,reg,San Francisco 49ers,Phoenix Cardinals,SF,14,10,4,12,24,32,FALSE,0,0,"",8,8
1991,12,reg,Miami Dolphins,Buffalo Bills,BUF,27,41,14,4,68,46,FALSE,0,0,"",10,22
1991,13,reg,Chicago Bears,Miami Dolphins,CHI,13,16,3,8,29,36,FALSE,0,0,"",5,7
1991,13,reg,Cincinnati Bengals,Los Angeles Raiders,OAK,14,38,24,6.5,52,36,FALSE,0,0,"",17.5,16
1991,13,reg,Cleveland Browns,Kansas City Chiefs,KC,20,15,5,4,35,36,FALSE,0,0,"",1,1
1991,13,reg,Green Bay Packers,Indianapolis Colts,GB,14,10,4,7,24,34,FALSE,0,0,"",3,10
1991,13,reg,Minnesota Vikings,Detroit Lions,MIN,14,34,20,6,48,42,FALSE,1,0,DOME,14,6
1991,13,reg,New England Patriots,Buffalo Bills,BUF,16,13,3,8.5,29,42,FALSE,0,0,"",5.5,13
1991,13,reg,New Orleans Saints,Atlanta Falcons,NO,20,23,3,6.5,43,35,FALSE,1,0,DOME,3.5,8
1991,13,reg,New York Jets,San Diego Chargers,NYJ,24,3,21,4,27,38,FALSE,0,0,"",17,11
1991,13,reg,Phoenix Cardinals,Philadelphia Eagles,PHI,14,34,20,6.5,48,33,FALSE,0,0,"",13.5,15
1991,13,reg,Pittsburgh Steelers,Houston Oilers,TEN,26,14,12,7.5,40,40,FALSE,0,0,"",4.5,0
1991,13,reg,Seattle Seahawks,Denver Broncos,SEA,13,10,3,3.5,23,36,FALSE,1,0,DOME,0.5,13
1991,13,reg,Tampa Bay Buccaneers,New York Giants,NYG,14,21,7,9,35,34,FALSE,0,0,"",2,1
1991,13,reg,Washington Redskins,Dallas Cowboys,WAS,21,24,3,12.5,45,42,FALSE,0,0,"",9.5,3
1991,13,reg,Los Angeles Rams,San Francisco 49ers,SF,10,33,23,3,43,38,FALSE,0,0,"",20,5
1991,14,reg,Dallas Cowboys,Pittsburgh Steelers,DAL,20,10,10,6,30,40,FALSE,0,0,"",4,10
1991,14,reg,Detroit Lions,Chicago Bears,DET,16,6,10,3,22,41,FALSE,1,0,DOME,7,19
1991,14,reg,Atlanta Falcons,Green Bay Packers,ATL,35,31,4,8.5,66,38,FALSE,0,0,"",4.5,28
1991,14,reg,Buffalo Bills,New York Jets,BUF,24,13,11,9,37,46,FALSE,0,0,"",2,9
1991,14,reg,Cincinnati Bengals,New York Giants,NYG,27,24,3,7,51,39,FALSE,0,0,"",4,12
1991,14,reg,Denver Broncos,New England Patriots,DEN,20,3,17,6.5,23,33,FALSE,0,0,"",10.5,10
1991,14,reg,Indianapolis Colts,Cleveland Browns,CLE,0,31,31,4.5,31,38,FALSE,1,0,DOME,26.5,7
1991,14,reg,Los Angeles Rams,Washington Redskins,WAS,6,27,21,12,33,46,FALSE,0,0,"",9,13
1991,14,reg,Miami Dolphins,Tampa Bay Buccaneers,MIA,33,14,19,9,47,38,FALSE,0,0,"",10,9
1991,14,reg,San Diego Chargers,Los Angeles Raiders,OAK,7,9,2,5.5,16,36,FALSE,0,0,"",3.5,20
1991,14,reg,San Francisco 49ers,New Orleans Saints,SF,38,24,14,4,62,34,FALSE,0,0,"",10,28
1991,14,reg,Seattle Seahawks,Kansas City Chiefs,SEA,6,19,13,1.5,25,36,FALSE,1,0,DOME,11.5,11
1991,14,reg,Houston Oilers,Philadelphia Eagles,TEN,6,13,7,6.5,19,42,FALSE,1,0,DOME,0.5,23
1991,15,reg,Chicago Bears,Green Bay Packers,CHI,27,13,14,9.5,40,36,FALSE,0,0,"",4.5,4
1991,15,reg,Cleveland Browns,Denver Broncos,PICK,7,17,10,0,24,36,FALSE,0,0,"",10,12
1991,15,reg,Dallas Cowboys,New Orleans Saints,DAL,23,14,9,2,37,36,FALSE,0,0,"",7,1
1991,15,reg,Detroit Lions,New York Jets,DET,34,20,14,5.5,54,42,FALSE,1,0,DOME,8.5,12
1991,15,reg,Houston Oilers,Pittsburgh Steelers,TEN,31,6,25,10,37,44,FALSE,1,0,DOME,15,7
1991,15,reg,Kansas City Chiefs,San Diego Chargers,KC,20,17,3,9,37,36,FALSE,0,0,"",6,1
1991,15,reg,Los Angeles Raiders,Buffalo Bills,OAK,27,30,3,1.5,57,41,FALSE,0,0,"",1.5,16
1991,15,reg,Los Angeles Rams,Atlanta Falcons,ATL,14,31,17,6,45,43,FALSE,0,0,"",11,2
1991,15,reg,New England Patriots,Indianapolis Colts,NE,23,17,6,8,40,34,FALSE,0,0,"",2,6
1991,15,reg,New York Giants,Philadelphia Eagles,NYG,14,19,5,3,33,33,FALSE,0,0,"",2,0
1991,15,reg,Phoenix Cardinals,Washington Redskins,WAS,14,20,6,14,34,40,FALSE,0,0,"",8,6
1991,15,reg,Seattle Seahawks,San Francisco 49ers,SF,22,24,2,3.5,46,36,FALSE,1,0,DOME,1.5,10
1991,15,reg,Tampa Bay Buccaneers,Minnesota Vikings,MIN,24,26,2,4,50,38,FALSE,0,0,"",2,12
1991,15,reg,Miami Dolphins,Cincinnati Bengals,MIA,37,13,24,8,50,46,FALSE,0,0,"",16,4
1991,16,reg,Chicago Bears,Tampa Bay Buccaneers,CHI,27,0,27,13,27,34,FALSE,0,0,"",14,7
1991,16,reg,San Francisco 49ers,Kansas City Chiefs,SF,28,14,14,4.5,42,37,FALSE,0,0,"",9.5,5
1991,16,reg,Atlanta Falcons,Seattle Seahawks,ATL,26,13,13,7,39,40,FALSE,0,0,"",6,1
1991,16,reg,Cleveland Browns,Houston Oilers,TEN,14,17,3,3,31,35,FALSE,0,0,"",0,4
1991,16,reg,Denver Broncos,Phoenix Cardinals,DEN,24,19,5,11.5,43,34,FALSE,0,0,"",6.5,9
1991,16,reg,Green Bay Packers,Detroit Lions,DET,17,21,4,3,38,34,FALSE,0,0,"",1,4
1991,16,reg,Indianapolis Colts,Buffalo Bills,BUF,7,35,28,13,42,42.5,FALSE,1,0,DOME,15,0.5
1991,16,reg,Minnesota Vikings,Los Angeles Rams,MIN,20,14,6,10,34,45,FALSE,1,0,DOME,4,11
1991,16,reg,New York Jets,New England Patriots,NYJ,3,6,3,7,9,36,FALSE,0,0,"",4,27
1991,16,reg,Philadelphia Eagles,Dallas Cowboys,PHI,13,25,12,3.5,38,32,FALSE,0,0,"",8.5,6
1991,16,reg,Pittsburgh Steelers,Cincinnati Bengals,PIT,17,10,7,6,27,39,FALSE,0,0,"",1,12
1991,16,reg,San Diego Chargers,Miami Dolphins,MIA,38,30,8,1,68,38,FALSE,0,0,"",7,30
1991,16,reg,Washington Redskins,New York Giants,WAS,34,17,17,9,51,37,FALSE,0,0,"",8,14
1991,16,reg,New Orleans Saints,Los Angeles Raiders,NO,27,0,27,3,27,37,FALSE,1,0,DOME,24,10
1991,17,reg,Minnesota Vikings,Green Bay Packers,MIN,7,27,20,6,34,44,FALSE,1,0,DOME,14,10
1991,17,reg,New York Giants,Houston Oilers,TEN,24,20,4,3,44,37,FALSE,0,0,"",1,7
1991,17,reg,Buffalo Bills,Detroit Lions,BUF,14,17,3,5,31,41,FALSE,0,0,"",2,10
1991,17,reg,Cincinnati Bengals,New England Patriots,NE,29,7,22,2,36,38,FALSE,0,0,"",20,2
1991,17,reg,Dallas Cowboys,Atlanta Falcons,DAL,31,27,4,3,58,39,FALSE,0,0,"",1,19
1991,17,reg,Los Angeles Raiders,Kansas City Chiefs,OAK,21,27,6,2.5,48,35,FALSE,0,0,"",3.5,13
1991,17,reg,Miami Dolphins,New York Jets,MIA,20,23,3,5.5,43,44,FALSE,0,0,"",2.5,1
1991,17,reg,Philadelphia Eagles,Washington Redskins,WAS,24,22,2,3,46,35,FALSE,0,0,"",1,11
1991,17,reg,Phoenix Cardinals,New Orleans Saints,NO,3,27,24,7,30,35,FALSE,0,0,"",17,5
1991,17,reg,Pittsburgh Steelers,Cleveland Browns,PIT,17,10,7,3,27,37,FALSE,0,0,"",4,10
1991,17,reg,San Diego Chargers,Denver Broncos,DEN,14,17,3,3,31,37,FALSE,0,0,"",0,6
1991,17,reg,Seattle Seahawks,Los Angeles Rams,SEA,23,9,14,6,32,39,FALSE,1,0,DOME,8,7
1991,17,reg,Tampa Bay Buccaneers,Indianapolis Colts,TB,17,3,14,5.5,20,35,FALSE,0,0,"",8.5,15
1991,17,reg,San Francisco 49ers,Chicago Bears,SF,52,14,38,5,66,39,FALSE,0,0,"",33,27
1991,Wildcard,post,Kansas City Chiefs,Los Angeles Raiders,KC,10,6,4,5,16,36,FALSE,0,0,"",1,20
1991,Wildcard,post,New Orleans Saints,Atlanta Falcons,NO,20,27,7,6,47,39,FALSE,1,0,DOME,1,8
1991,Wildcard,post,Chicago Bears,Dallas Cowboys,CHI,13,17,4,3,30,37,FALSE,0,0,"",1,7
1991,Wildcard,post,Houston Oilers,New York Jets,TEN,17,10,7,9,27,44,FALSE,1,0,DOME,2,17
1991,Division,post,Denver Broncos,Houston Oilers,DEN,26,24,2,3.5,50,37,FALSE,0,0,"",1.5,13
1991,Division,post,Washington Redskins,Atlanta Falcons,WAS,24,7,17,11.5,31,43,FALSE,0,0,"",5.5,12
1991,Division,post,Buffalo Bills,Kansas City Chiefs,BUF,37,14,23,10.5,51,41,FALSE,0,0,"",12.5,10
1991,Division,post,Detroit Lions,Dallas Cowboys,PICK,38,6,32,0,44,43,FALSE,1,0,DOME,32,1
1991,Conference,post,Buffalo Bills,Denver Broncos,BUF,10,7,3,12,17,46,FALSE,0,0,"",9,29
1991,Conference,post,Washington Redskins,Detroit Lions,WAS,41,10,31,14,51,43,FALSE,0,0,"",17,8
1991,Superbowl,post,Washington Redskins,Buffalo Bills,WAS,37,24,13,7,61,49,TRUE,1,0,DOME,6,12
1992,1,reg,Atlanta Falcons,New York Jets,ATL,20,17,3,3,37,43,FALSE,1,0,DOME,0,6
1992,1,reg,Buffalo Bills,Los Angeles Rams,BUF,40,7,33,11,47,45,FALSE,0,0,"",22,2
1992,1,reg,Chicago Bears,Detroit Lions,CHI,27,24,3,3.5,51,37,FALSE,0,0,"",0.5,14
1992,1,reg,Denver Broncos,Los Angeles Raiders,DEN,17,13,4,3,30,36,FALSE,0,0,"",1,6
1992,1,reg,Green Bay Packers,Minnesota Vikings,MIN,20,23,3,5,43,37,FALSE,0,0,"",2,6
1992,1,reg,Houston Oilers,Pittsburgh Steelers,TEN,24,29,5,12.5,53,45,FALSE,1,0,DOME,7.5,8
1992,1,reg,Indianapolis Colts,Cleveland Browns,CLE,14,3,11,6,17,34,FALSE,1,0,DOME,5,17
1992,1,reg,New York Giants,San Francisco 49ers,SF,14,31,17,4,45,37,FALSE,0,0,"",13,8
1992,1,reg,Philadelphia Eagles,New Orleans Saints,PHI,15,13,2,3.5,28,34,FALSE,0,0,"",1.5,6
1992,1,reg,San Diego Chargers,Kansas City Chiefs,KC,10,24,14,2.5,34,35,FALSE,0,0,"",11.5,1
1992,1,reg,Seattle Seahawks,Cincinnati Bengals,SEA,3,21,18,4,24,37,FALSE,1,0,DOME,14,13
1992,1,reg,Tampa Bay Buccaneers,Phoenix Cardinals,TB,23,7,16,1,30,37,FALSE,0,0,"",15,7
1992,1,reg,Dallas Cowboys,Washington Redskins,WAS,23,10,13,2,33,43,FALSE,0,0,"",11,10
1992,2,reg,Cincinnati Bengals,Los Angeles Raiders,OAK,24,21,3,2.5,45,37,FALSE,0,0,"",0.5,8
1992,2,reg,Denver Broncos,San Diego Chargers,DEN,21,13,8,6.5,34,34,FALSE,0,0,"",1.5,0
1992,2,reg,Detroit Lions,Minnesota Vikings,DET,31,17,14,3.5,48,43,FALSE,1,0,DOME,10.5,5
1992,2,reg,Indianapolis Colts,Houston Oilers,IND,10,20,10,9,30,39,FALSE,1,0,DOME,1,9
1992,2,reg,Kansas City Chiefs,Seattle Seahawks,KC,26,7,19,10,33,33,FALSE,0,0,"",9,0
1992,2,reg,Los Angeles Rams,New England Patriots,LAR,14,0,14,4,14,37,FALSE,0,0,"",10,23
1992,2,reg,New Orleans Saints,Chicago Bears,NO,28,6,22,4,34,34,FALSE,1,0,DOME,18,0
1992,2,reg,New York Giants,Dallas Cowboys,DAL,28,34,6,3,62,38,FALSE,0,0,"",3,24
1992,2,reg,Phoenix Cardinals,Philadelphia Eagles,PHI,14,31,17,7,45,35,FALSE,0,0,"",10,10
1992,2,reg,Pittsburgh Steelers,New York Jets,NYJ,27,10,17,2.5,37,38,FALSE,0,0,"",14.5,1
1992,2,reg,San Francisco 49ers,Buffalo Bills,SF,31,34,3,3.5,65,44,FALSE,0,0,"",0.5,21
1992,2,reg,Tampa Bay Buccaneers,Green Bay Packers,TB,31,3,28,2.5,34,37,FALSE,0,0,"",25.5,3
1992,2,reg,Washington Redskins,Atlanta Falcons,WAS,24,17,7,10,41,45,FALSE,0,0,"",3,4
1992,2,reg,Cleveland Browns,Miami Dolphins,MIA,23,27,4,2.5,50,38,FALSE,0,0,"",1.5,12
1992,3,reg,Atlanta Falcons,New Orleans Saints,ATL,7,10,3,1,17,37,FALSE,1,0,DOME,2,20
1992,3,reg,Buffalo Bills,Indianapolis Colts,BUF,38,0,38,17,38,41,FALSE,0,0,"",21,3
1992,3,reg,Dallas Cowboys,Phoenix Cardinals,DAL,31,20,11,13.5,51,40,FALSE,0,0,"",2.5,11
1992,3,reg,Green Bay Packers,Cincinnati Bengals,PICK,24,23,1,0,47,37,FALSE,0,0,"",1,10
1992,3,reg,Houston Oilers,Kansas City Chiefs,TEN,23,20,3,5.5,43,39,FALSE,1,0,DOME,2.5,4
1992,3,reg,Los Angeles Raiders,Cleveland Browns,OAK,16,28,12,8.5,44,33,FALSE,0,0,"",3.5,11
1992,3,reg,Miami Dolphins,Los Angeles Rams,MIA,26,10,16,8.5,36,38,FALSE,0,0,"",7.5,2
1992,3,reg,Minnesota Vikings,Tampa Bay Buccaneers,MIN,26,20,6,7,46,39,FALSE,1,0,DOME,1,7
1992,3,reg,New England Patriots,Seattle Seahawks,NE,6,10,4,3,16,33,FALSE,0,0,"",1,17
1992,3,reg,New York Jets,San Francisco 49ers,SF,14,31,17,4,45,41,FALSE,0,0,"",13,4
1992,3,reg,Philadelphia Eagles,Denver Broncos,PHI,30,0,30,6.5,30,35,FALSE,0,0,"",23.5,5
1992,3,reg,San Diego Chargers,Pittsburgh Steelers,LAC,6,23,17,3,29,35,FALSE,0,0,"",14,6
1992,3,reg,Washington Redskins,Detroit Lions,WAS,13,10,3,9,23,45,FALSE,0,0,"",6,22
1992,3,reg,Chicago Bears,New York Giants,CHI,14,27,13,5,41,37,FALSE,0,0,"",8,4
1992,4,reg,Chicago Bears,Atlanta Falcons,CHI,41,31,10,4.5,72,39,FALSE,0,0,"",5.5,33
1992,4,reg,Cincinnati Bengals,Minnesota Vikings,CIN,7,42,35,2,49,41,FALSE,0,0,"",33,8
1992,4,reg,Cleveland Browns,Denver Broncos,DEN,0,12,12,4.5,12,34,FALSE,0,0,"",7.5,22
1992,4,reg,Detroit Lions,Tampa Bay Buccaneers,DET,23,27,4,10.5,50,41,FALSE,1,0,DOME,6.5,9
1992,4,reg,Green Bay Packers,Pittsburgh Steelers,PIT,17,3,14,3.5,20,37,FALSE,0,0,"",10.5,17
1992,4,reg,Houston Oilers,San Diego Chargers,TEN,27,0,27,11,27,41,FALSE,1,0,DOME,16,14
1992,4,reg,Los Angeles Rams,New York Jets,PICK,18,10,8,0,28,38,FALSE,0,0,"",8,10
1992,4,reg,New England Patriots,Buffalo Bills,BUF,7,41,34,14,48,38,FALSE,0,0,"",20,10
1992,4,reg,New Orleans Saints,San Francisco 49ers,SF,10,16,6,3,26,37,FALSE,1,0,DOME,3,11
1992,4,reg,Seattle Seahawks,Miami Dolphins,MIA,17,19,2,6,36,35,FALSE,1,0,DOME,4,1
1992,4,reg,Kansas City Chiefs,Los Angeles Raiders,KC,27,7,20,6,34,37,FALSE,0,0,"",14,3
1992,5,reg,Atlanta Falcons,Green Bay Packers,ATL,24,10,14,7.5,34,42,FALSE,1,0,DOME,6.5,8
1992,5,reg,Buffalo Bills,Miami Dolphins,BUF,10,37,27,10.5,47,50,FALSE,0,0,"",16.5,3
1992,5,reg,Denver Broncos,Kansas City Chiefs,DEN,20,19,1,1,39,33,FALSE,0,0,"",0,6
1992,5,reg,Detroit Lions,New Orleans Saints,PICK,7,13,6,0,20,36,FALSE,1,0,DOME,6,16
1992,5,reg,Los Angeles Raiders,New York Giants,PICK,13,10,3,0,23,38,FALSE,0,0,"",3,15
1992,5,reg,Minnesota Vikings,Chicago Bears,MIN,21,20,1,4,41,43,FALSE,1,0,DOME,3,2
1992,5,reg,New York Jets,New England Patriots,NYJ,30,21,9,10,51,35,FALSE,0,0,"",1,16
1992,5,reg,Phoenix Cardinals,Washington Redskins,WAS,27,24,3,10,51,39,FALSE,0,0,"",7,12
1992,5,reg,San Diego Chargers,Seattle Seahawks,LAC,17,6,11,3.5,23,32,FALSE,0,0,"",7.5,9
1992,5,reg,San Francisco 49ers,Los Angeles Rams,SF,27,24,3,15,51,42,FALSE,0,0,"",12,9
1992,5,reg,Tampa Bay Buccaneers,Indianapolis Colts,TB,14,24,10,10,38,35,FALSE,0,0,"",0,3
1992,5,reg,Philadelphia Eagles,Dallas Cowboys,PHI,31,7,24,3.5,38,39,FALSE,0,0,"",20.5,1
1992,6,reg,Cincinnati Bengals,Houston Oilers,TEN,24,38,14,7,62,43,FALSE,0,0,"",7,19
1992,6,reg,Cleveland Browns,Pittsburgh Steelers,PIT,17,9,8,3,26,33,FALSE,0,0,"",5,7
1992,6,reg,Dallas Cowboys,Seattle Seahawks,DAL,27,0,27,18,27,37,FALSE,0,0,"",9,10
1992,6,reg,Indianapolis Colts,New York Jets,NYJ,6,3,3,2,9,37,FALSE,1,0,DOME,1,28
1992,6,reg,Kansas City Chiefs,Philadelphia Eagles,PHI,24,17,7,2,41,34,FALSE,0,0,"",5,7
1992,6,reg,Los Angeles Raiders,Buffalo Bills,BUF,20,3,17,9.5,23,42,FALSE,0,0,"",7.5,19
1992,6,reg,Miami Dolphins,Atlanta Falcons,MIA,21,17,4,8,38,44,FALSE,0,0,"",4,6
1992,6,reg,New England Patriots,San Francisco 49ers,SF,12,24,12,17.5,36,39,FALSE,0,0,"",5.5,3
1992,6,reg,New Orleans Saints,Los Angeles Rams,NO,13,10,3,9,23,34,FALSE,1,0,DOME,6,11
1992,6,reg,New York Giants,Phoenix Cardinals,NYG,31,21,10,8,52,38,FALSE,0,0,"",2,14
1992,6,reg,Washington Redskins,Denver Broncos,WAS,34,3,31,8,37,38,FALSE,0,0,"",23,1
1992,7,reg,Minnesota Vikings,Detroit Lions,MIN,31,14,17,5.5,45,43,FALSE,1,0,DOME,11.5,2
1992,7,reg,Chicago Bears,Tampa Bay Buccaneers,CHI,31,14,17,5.5,45,40,FALSE,0,0,"",11.5,5
1992,7,reg,Cleveland Browns,Green Bay Packers,CLE,17,6,11,3,23,33,FALSE,0,0,"",8,10
1992,7,reg,Dallas Cowboys,Kansas City Chiefs,DAL,17,10,7,4,27,38,FALSE,0,0,"",3,11
1992,7,reg,Denver Broncos,Houston Oilers,TEN,27,21,6,3,48,39,FALSE,0,0,"",3,9
1992,7,reg,Indianapolis Colts,San Diego Chargers,IND,14,34,20,2,48,32,FALSE,1,0,DOME,18,16
1992,7,reg,Los Angeles Rams,New York Giants,NYG,38,17,21,1.5,55,37,FALSE,0,0,"",19.5,18
1992,7,reg,Miami Dolphins,New England Patriots,MIA,38,17,21,15,55,39,FALSE,0,0,"",6,16
1992,7,reg,Phoenix Cardinals,New Orleans Saints,NO,21,30,9,7,51,35,FALSE,0,0,"",2,16
1992,7,reg,San Francisco 49ers,Atlanta Falcons,SF,56,17,39,10,73,45,FALSE,0,0,"",29,28
1992,7,reg,Seattle Seahawks,Los Angeles Raiders,OAK,0,19,19,7,19,32,FALSE,1,0,DOME,12,13
1992,7,reg,Washington Redskins,Philadelphia Eagles,WAS,16,12,4,2,28,38,FALSE,0,0,"",2,10
1992,7,reg,Pittsburgh Steelers,Cincinnati Bengals,PIT,20,0,20,7.5,20,38,FALSE,0,0,"",12.5,18
1992,8,reg,Green Bay Packers,Chicago Bears,CHI,10,30,20,3.5,40,37,FALSE,0,0,"",16.5,3
1992,8,reg,Houston Oilers,Cincinnati Bengals,TEN,26,10,16,17,36,44,FALSE,1,0,DOME,1,8
1992,8,reg,Kansas City Chiefs,Pittsburgh Steelers,KC,3,27,24,8.5,30,36,FALSE,0,0,"",15.5,6
1992,8,reg,Los Angeles Raiders,Dallas Cowboys,DAL,13,28,15,3,41,36,FALSE,0,0,"",12,5
1992,8,reg,Miami Dolphins,Indianapolis Colts,MIA,20,31,11,13.5,51,39,FALSE,0,0,"",2.5,12
1992,8,reg,Minnesota Vikings,Washington Redskins,WAS,13,15,2,2.5,28,42,FALSE,1,0,DOME,0.5,14
1992,8,reg,New England Patriots,Cleveland Browns,CLE,17,19,2,4.5,36,30,FALSE,0,0,"",2.5,6
1992,8,reg,New York Giants,Seattle Seahawks,NYG,23,10,13,14.5,33,32,FALSE,0,0,"",1.5,1
1992,8,reg,Philadelphia Eagles,Phoenix Cardinals,PHI,7,3,4,15,10,38,FALSE,0,0,"",11,28
1992,8,reg,San Diego Chargers,Denver Broncos,LAC,24,21,3,1.5,45,33,FALSE,0,0,"",1.5,12
1992,8,reg,Tampa Bay Buccaneers,Detroit Lions,TB,7,38,31,2.5,45,40,FALSE,0,0,"",28.5,5
1992,8,reg,New York Jets,Buffalo Bills,BUF,20,24,4,8.5,44,43,FALSE,0,0,"",4.5,1
1992,9,reg,Atlanta Falcons,Los Angeles Rams,ATL,30,28,2,5,58,42,FALSE,1,0,DOME,3,16
1992,9,reg,Buffalo Bills,New England Patriots,BUF,16,7,9,19,23,40,FALSE,0,0,"",10,17
1992,9,reg,Cincinnati Bengals,Cleveland Browns,CLE,30,10,20,2,40,35,FALSE,0,0,"",18,5
1992,9,reg,Dallas Cowboys,Philadelphia Eagles,DAL,20,10,10,4,30,36,FALSE,0,0,"",6,6
1992,9,reg,Detroit Lions,Green Bay Packers,DET,13,27,14,10,40,39,FALSE,1,0,DOME,4,1
1992,9,reg,New Orleans Saints,Tampa Bay Buccaneers,NO,23,21,2,11.5,44,36,FALSE,1,0,DOME,9.5,8
1992,9,reg,New York Jets,Miami Dolphins,MIA,26,14,12,6.5,40,39,FALSE,0,0,"",5.5,1
1992,9,reg,Phoenix Cardinals,San Francisco 49ers,SF,24,14,10,13,38,44,FALSE,0,0,"",3,6
1992,9,reg,Pittsburgh Steelers,Houston Oilers,TEN,21,20,1,3,41,39,FALSE,0,0,"",2,2
1992,9,reg,San Diego Chargers,Indianapolis Colts,LAC,26,0,26,6,26,38,FALSE,0,0,"",20,12
1992,9,reg,Washington Redskins,New York Giants,WAS,7,24,17,10.5,31,38,FALSE,0,0,"",6.5,7
1992,9,reg,Chicago Bears,Minnesota Vikings,CHI,10,38,28,3.5,48,40,FALSE,0,0,"",24.5,8
1992,10,reg,Buffalo Bills,Pittsburgh Steelers,BUF,28,20,8,7,48,38,FALSE,0,0,"",1,10
1992,10,reg,Chicago Bears,Cincinnati Bengals,CHI,28,31,3,9,59,39,FALSE,0,0,"",6,20
1992,10,reg,Denver Broncos,New York Jets,DEN,27,16,11,6,43,35,FALSE,0,0,"",5,8
1992,10,reg,Detroit Lions,Dallas Cowboys,DAL,3,37,34,6.5,40,41,FALSE,1,0,DOME,27.5,1
1992,10,reg,Houston Oilers,Cleveland Browns,TEN,14,24,10,11,38,40,FALSE,1,0,DOME,1,2
1992,10,reg,Indianapolis Colts,Miami Dolphins,MIA,0,28,28,6.5,28,38,FALSE,1,0,DOME,21.5,10
1992,10,reg,Kansas City Chiefs,San Diego Chargers,KC,16,14,2,6,30,35,FALSE,0,0,"",4,5
1992,10,reg,Los Angeles Rams,Phoenix Cardinals,LAR,14,20,6,5,34,40,FALSE,0,0,"",1,6
1992,10,reg,New England Patriots,New Orleans Saints,NO,14,31,17,8,45,32,FALSE,0,0,"",9,13
1992,10,reg,New York Giants,Green Bay Packers,NYG,27,7,20,9,34,37,FALSE,0,0,"",11,3
1992,10,reg,Philadelphia Eagles,Los Angeles Raiders,PHI,31,10,21,6.5,41,33,FALSE,0,0,"",14.5,8
1992,10,reg,Seattle Seahawks,Washington Redskins,WAS,3,16,13,12.5,19,33,FALSE,1,0,DOME,0.5,14
1992,10,reg,Tampa Bay Buccaneers,Minnesota Vikings,MIN,7,35,28,6,42,40,FALSE,0,0,"",22,2
1992,10,reg,Atlanta Falcons,San Francisco 49ers,SF,3,41,38,7,44,45,FALSE,1,0,DOME,31,1
1992,11,reg,Atlanta Falcons,Phoenix Cardinals,ATL,20,17,3,4,37,41.5,FALSE,1,0,DOME,1,4.5
1992,11,reg,Cleveland Browns,San Diego Chargers,CLE,13,14,1,2.5,27,31,FALSE,0,0,"",1.5,4
1992,11,reg,Dallas Cowboys,Los Angeles Rams,DAL,23,27,4,14.5,50,40,FALSE,0,0,"",10.5,10
1992,11,reg,Denver Broncos,New York Giants,DEN,27,13,14,3.5,40,37,FALSE,0,0,"",10.5,3
1992,11,reg,Green Bay Packers,Philadelphia Eagles,PHI,27,24,3,8.5,51,35,FALSE,0,0,"",5.5,16
1992,11,reg,Indianapolis Colts,New England Patriots,IND,34,37,3,7,71,32,FALSE,1,0,DOME,4,39
1992,11,reg,Kansas City Chiefs,Washington Redskins,KC,35,16,19,1,51,35,FALSE,0,0,"",18,16
1992,11,reg,Los Angeles Raiders,Seattle Seahawks,OAK,20,3,17,14,23,32,FALSE,0,0,"",3,9
1992,11,reg,Minnesota Vikings,Houston Oilers,MIN,13,17,4,7.5,30,43,FALSE,1,0,DOME,3.5,13
1992,11,reg,New York Jets,Cincinnati Bengals,NYJ,17,14,3,6,31,40,FALSE,0,0,"",3,9
1992,11,reg,Pittsburgh Steelers,Detroit Lions,PIT,17,14,3,11,31,34,FALSE,0,0,"",8,3
1992,11,reg,San Francisco 49ers,New Orleans Saints,SF,21,20,1,6,41,40,FALSE,0,0,"",5,1
1992,11,reg,Tampa Bay Buccaneers,Chicago Bears,CHI,20,17,3,6.5,37,41,FALSE,0,0,"",3.5,4
1992,11,reg,Miami Dolphins,Buffalo Bills,BUF,20,26,6,1,46,46.5,FALSE,0,0,"",5,0.5
1992,12,reg,Buffalo Bills,Atlanta Falcons,BUF,41,14,27,13,55,43,FALSE,0,0,"",14,12
1992,12,reg,Chicago Bears,Green Bay Packers,CHI,3,17,14,5.5,20,38,FALSE,0,0,"",8.5,18
1992,12,reg,Cincinnati Bengals,Detroit Lions,CIN,13,19,6,2.5,32,38,FALSE,0,0,"",3.5,6
1992,12,reg,Los Angeles Raiders,Denver Broncos,OAK,24,0,24,3.5,24,35,FALSE,0,0,"",20.5,11
1992,12,reg,Los Angeles Rams,San Francisco 49ers,SF,10,27,17,7,37,43,FALSE,0,0,"",10,6
1992,12,reg,Miami Dolphins,Houston Oilers,MIA,19,16,3,3.5,35,41,FALSE,0,0,"",0.5,6
1992,12,reg,Minnesota Vikings,Cleveland Browns,MIN,17,13,4,9,30,37,FALSE,1,0,DOME,5,7
1992,12,reg,New England Patriots,New York Jets,NYJ,24,3,21,4.5,27,35,FALSE,0,0,"",16.5,8
1992,12,reg,New York Giants,Philadelphia Eagles,PHI,34,47,13,3.5,81,35,FALSE,0,0,"",9.5,46
1992,12,reg,Phoenix Cardinals,Dallas Cowboys,DAL,10,16,6,8.5,26,42,FALSE,0,0,"",2.5,16
1992,12,reg,Pittsburgh Steelers,Indianapolis Colts,PIT,30,14,16,12,44,33,FALSE,0,0,"",4,11
1992,12,reg,San Diego Chargers,Tampa Bay Buccaneers,LAC,29,14,15,8.5,43,37,FALSE,0,0,"",6.5,6
1992,12,reg,Seattle Seahawks,Kansas City Chiefs,KC,14,24,10,12,38,32,FALSE,1,0,DOME,2,6
1992,12,reg,New Orleans Saints,Washington Redskins,NO,20,3,17,4,23,37,FALSE,1,0,DOME,13,14
1992,13,reg,Dallas Cowboys,New York Giants,DAL,30,3,27,15,33,41,FALSE,0,0,"",12,8
1992,13,reg,Detroit Lions,Houston Oilers,TEN,21,24,3,1.5,45,41,FALSE,1,0,DOME,1.5,4
1992,13,reg,Atlanta Falcons,New England Patriots,ATL,34,0,34,5.5,34,41,FALSE,1,0,DOME,28.5,7
1992,13,reg,Cincinnati Bengals,Pittsburgh Steelers,PIT,9,21,12,7.5,30,36,FALSE,0,0,"",4.5,6
1992,13,reg,Cleveland Browns,Chicago Bears,CLE,27,14,13,3.5,41,35,FALSE,0,0,"",9.5,6
1992,13,reg,Green Bay Packers,Tampa Bay Buccaneers,GB,19,14,5,5.5,33,36,FALSE,0,0,"",0.5,3
1992,13,reg,Indianapolis Colts,Buffalo Bills,BUF,16,13,3,16.5,29,41,FALSE,1,0,DOME,13.5,12
1992,13,reg,Los Angeles Rams,Minnesota Vikings,MIN,17,31,14,2.5,48,37,FALSE,0,0,"",11.5,11
1992,13,reg,New Orleans Saints,Miami Dolphins,NO,24,13,11,4,37,37,FALSE,1,0,DOME,7,0
1992,13,reg,New York Jets,Kansas City Chiefs,KC,7,23,16,6,30,35,FALSE,0,0,"",10,5
1992,13,reg,San Diego Chargers,Los Angeles Raiders,LAC,27,3,24,3.5,30,35,FALSE,0,0,"",20.5,5
1992,13,reg,San Francisco 49ers,Philadelphia Eagles,SF,20,14,6,6.5,34,41,FALSE,0,0,"",0.5,7
1992,13,reg,Washington Redskins,Phoenix Cardinals,WAS,41,3,38,8,44,36,FALSE,0,0,"",30,8
1992,13,reg,Seattle Seahawks,Denver Broncos,DEN,16,13,3,5.5,29,34,FALSE,1,0,DOME,2.5,5
1992,14,reg,New Orleans Saints,Atlanta Falcons,NO,22,14,8,10,36,39,FALSE,1,0,DOME,2,3
1992,14,reg,Buffalo Bills,New York Jets,BUF,17,24,7,17,41,36,FALSE,0,0,"",10,5
1992,14,reg,Cleveland Browns,Cincinnati Bengals,CLE,37,21,16,10,58,33,FALSE,0,0,"",6,25
1992,14,reg,Denver Broncos,Dallas Cowboys,DAL,27,31,4,7,58,35,FALSE,0,0,"",3,23
1992,14,reg,Green Bay Packers,Detroit Lions,GB,38,10,28,3.5,48,35,FALSE,0,0,"",24.5,13
1992,14,reg,Los Angeles Raiders,Kansas City Chiefs,KC,28,7,21,2.5,35,33,FALSE,0,0,"",18.5,2
1992,14,reg,New England Patriots,Indianapolis Colts,NE,0,6,6,1.5,6,33,FALSE,0,0,"",4.5,27
1992,14,reg,New York Giants,Washington Redskins,WAS,10,28,18,7,38,35,FALSE,0,0,"",11,3
1992,14,reg,Philadelphia Eagles,Minnesota Vikings,PHI,28,17,11,5.5,45,36,FALSE,0,0,"",5.5,9
1992,14,reg,Phoenix Cardinals,San Diego Chargers,LAC,21,27,6,4.5,48,37,FALSE,0,0,"",1.5,11
1992,14,reg,Pittsburgh Steelers,Seattle Seahawks,PIT,20,14,6,13.5,34,31,FALSE,0,0,"",7.5,3
1992,14,reg,San Francisco 49ers,Miami Dolphins,SF,27,3,24,8,30,42,FALSE,0,0,"",16,12
1992,14,reg,Tampa Bay Buccaneers,Los Angeles Rams,TB,27,31,4,1,58,39,FALSE,0,0,"",3,19
1992,14,reg,Houston Oilers,Chicago Bears,TEN,24,7,17,11,31,42,FALSE,1,0,DOME,6,11
1992,15,reg,Buffalo Bills,Denver Broncos,BUF,27,17,10,14,44,37,FALSE,0,0,"",4,7
1992,15,reg,Phoenix Cardinals,New York Giants,ARI,19,0,19,4,19,37.5,FALSE,0,0,"",15,18.5
1992,15,reg,Chicago Bears,Pittsburgh Steelers,PIT,30,6,24,3.5,36,35,FALSE,0,0,"",20.5,1
1992,15,reg,Detroit Lions,Cleveland Browns,CLE,24,14,10,3.5,38,37,FALSE,1,0,DOME,6.5,1
1992,15,reg,Houston Oilers,Green Bay Packers,TEN,14,16,2,7,30,39,FALSE,1,0,DOME,5,9
1992,15,reg,Kansas City Chiefs,New England Patriots,KC,27,20,7,16.5,47,33,FALSE,0,0,"",9.5,14
1992,15,reg,Los Angeles Rams,New Orleans Saints,NO,14,37,23,5.5,51,38,FALSE,0,0,"",17.5,13
1992,15,reg,Minnesota Vikings,San Francisco 49ers,SF,17,20,3,5,37,41,FALSE,1,0,DOME,2,4
1992,15,reg,New York Jets,Indianapolis Colts,NYJ,6,10,4,5.5,16,34,FALSE,0,0,"",1.5,18
1992,15,reg,San Diego Chargers,Cincinnati Bengals,LAC,27,10,17,14,37,38,FALSE,0,0,"",3,1
1992,15,reg,Seattle Seahawks,Philadelphia Eagles,PHI,17,20,3,9.5,37,34,FALSE,1,0,DOME,6.5,3
1992,15,reg,Tampa Bay Buccaneers,Atlanta Falcons,ATL,7,35,28,1,42,41,FALSE,0,0,"",27,1
1992,15,reg,Washington Redskins,Dallas Cowboys,WAS,20,17,3,3,37,38,FALSE,0,0,"",0,1
1992,15,reg,Miami Dolphins,Los Angeles Raiders,MIA,20,7,13,6.5,27,37,FALSE,0,0,"",6.5,10
1992,16,reg,New York Giants,Kansas City Chiefs,KC,35,21,14,7.5,56,34,FALSE,0,0,"",6.5,22
1992,16,reg,San Francisco 49ers,Tampa Bay Buccaneers,SF,21,14,7,20,35,41,FALSE,0,0,"",13,6
1992,16,reg,Cincinnati Bengals,New England Patriots,CIN,20,10,10,4.5,30,34,FALSE,0,0,"",5.5,4
1992,16,reg,Cleveland Browns,Houston Oilers,TEN,14,17,3,1,31,36,FALSE,0,0,"",2,5
1992,16,reg,Denver Broncos,Seattle Seahawks,DEN,10,6,4,9,16,35,FALSE,0,0,"",5,19
1992,16,reg,Detroit Lions,Chicago Bears,DET,16,3,13,3,19,40,FALSE,1,0,DOME,10,21
1992,16,reg,Green Bay Packers,Los Angeles Rams,GB,28,13,15,6,41,39,FALSE,0,0,"",9,2
1992,16,reg,Indianapolis Colts,Phoenix Cardinals,IND,16,13,3,2.5,29,35,FALSE,1,0,DOME,0.5,6
1992,16,reg,Los Angeles Raiders,San Diego Chargers,LAC,14,36,22,3,50,35,FALSE,0,0,"",19,15
1992,16,reg,Miami Dolphins,New York Jets,MIA,19,17,2,11.5,36,37,FALSE,0,0,"",9.5,1
1992,16,reg,New Orleans Saints,Buffalo Bills,NO,16,20,4,3.5,36,39,FALSE,1,0,DOME,0.5,3
1992,16,reg,Philadelphia Eagles,Washington Redskins,PHI,17,13,4,3,30,36,FALSE,0,0,"",1,6
1992,16,reg,Pittsburgh Steelers,Minnesota Vikings,PIT,3,6,3,1.5,9,35,FALSE,0,0,"",1.5,26
1992,16,reg,Atlanta Falcons,Dallas Cowboys,DAL,17,41,24,7,58,42,FALSE,1,0,DOME,17,16
1992,17,reg,New York Jets,New Orleans Saints,NO,0,20,20,8,20,33,FALSE,0,0,"",12,13
1992,17,reg,Washington Redskins,Los Angeles Raiders,WAS,20,21,1,13.5,41,35,FALSE,0,0,"",12.5,6
1992,17,reg,Cincinnati Bengals,Indianapolis Colts,IND,17,21,4,2,38,34,FALSE,0,0,"",2,4
1992,17,reg,Dallas Cowboys,Chicago Bears,DAL,27,14,13,12,41,39,FALSE,0,0,"",1,2
1992,17,reg,Houston Oilers,Buffalo Bills,BUF,27,3,24,2.5,30,41,FALSE,1,0,DOME,21.5,11
1992,17,reg,Kansas City Chiefs,Denver Broncos,KC,42,20,22,7,62,36,FALSE,0,0,"",15,26
1992,17,reg,Los Angeles Rams,Atlanta Falcons,LAR,38,27,11,1,65,45,FALSE,0,0,"",10,20
1992,17,reg,Minnesota Vikings,Green Bay Packers,MIN,27,7,20,3,34,37,FALSE,1,0,DOME,17,3
1992,17,reg,New England Patriots,Miami Dolphins,MIA,13,16,3,11,29,34,FALSE,0,0,"",8,5
1992,17,reg,Philadelphia Eagles,New York Giants,PHI,20,10,10,8,30,38,FALSE,0,0,"",2,8
1992,17,reg,Phoenix Cardinals,Tampa Bay Buccaneers,ARI,3,7,4,7.5,10,38,FALSE,0,0,"",3.5,28
1992,17,reg,Pittsburgh Steelers,Cleveland Browns,PIT,23,13,10,6.5,36,32,FALSE,0,0,"",3.5,4
1992,17,reg,Seattle Seahawks,San Diego Chargers,LAC,14,31,17,9.5,45,34,FALSE,1,0,DOME,7.5,11
1992,17,reg,San Francisco 49ers,Detroit Lions,SF,24,6,18,13.5,30,37,FALSE,0,0,"",4.5,7
1992,Wildcard,post,Minnesota Vikings,Washington Redskins,MIN,7,24,17,3.5,31,37,FALSE,1,0,DOME,13.5,6
1992,Wildcard,post,San Diego Chargers,Kansas City Chiefs,LAC,17,0,17,3,17,37,FALSE,0,0,"",14,20
1992,Wildcard,post,Buffalo Bills,Houston Oilers,BUF,41,38,3,2,79,37,FALSE,0,0,"",1,42
1992,Wildcard,post,New Orleans Saints,Philadelphia Eagles,NO,20,36,16,3.5,56,35,FALSE,1,0,DOME,12.5,21
1992,Division,post,Pittsburgh Steelers,Buffalo Bills,PIT,3,24,21,2,27,36,FALSE,0,0,"",19,9
1992,Division,post,San Francisco 49ers,Washington Redskins,SF,20,13,7,9.5,33,39,FALSE,0,0,"",2.5,6
1992,Division,post,Dallas Cowboys,Philadelphia Eagles,DAL,34,10,24,6.5,44,38,FALSE,0,0,"",17.5,6
1992,Division,post,Miami Dolphins,San Diego Chargers,MIA,31,0,31,2,31,37,FALSE,0,0,"",29,6
1992,Conference,post,Miami Dolphins,Buffalo Bills,BUF,10,29,19,2.5,39,41,FALSE,0,0,"",16.5,2
1992,Conference,post,San Francisco 49ers,Dallas Cowboys,SF,20,30,10,4,50,37,FALSE,0,0,"",6,13
1992,Superbowl,post,Dallas Cowboys,Buffalo Bills,DAL,52,17,35,6.5,69,44.5,TRUE,0,0,"",28.5,24.5
1993,1,reg,Buffalo Bills,New England Patriots,BUF,38,14,24,14,52,38.5,FALSE,0,0,"",10,13.5
1993,1,reg,Chicago Bears,New York Giants,CHI,20,26,6,1,46,35,FALSE,0,0,"",5,11
1993,1,reg,Cleveland Browns,Cincinnati Bengals,CLE,27,14,13,7.5,41,35.5,FALSE,0,0,"",5.5,5.5
1993,1,reg,Detroit Lions,Atlanta Falcons,DET,30,13,17,5,43,44,FALSE,1,0,DOME,12,1
1993,1,reg,Green Bay Packers,Los Angeles Rams,GB,36,6,30,6.5,42,38.5,FALSE,0,0,"",23.5,3.5
1993,1,reg,Indianapolis Colts,Miami Dolphins,MIA,20,24,4,6,44,36.5,FALSE,1,0,DOME,2,7.5
1993,1,reg,Los Angeles Raiders,Minnesota Vikings,MIN,24,7,17,3,31,36,FALSE,0,0,"",14,5
1993,1,reg,New Orleans Saints,Houston Oilers,NO,33,21,12,3,54,39,FALSE,1,0,DOME,9,15
1993,1,reg,New York Jets,Denver Broncos,PICK,20,26,6,0,46,36.5,FALSE,0,0,"",6,9.5
1993,1,reg,Philadelphia Eagles,Phoenix Cardinals,PHI,23,17,6,6.5,40,37.5,FALSE,0,0,"",0.5,2.5
1993,1,reg,Pittsburgh Steelers,San Francisco 49ers,SF,13,24,11,6,37,36,FALSE,0,0,"",5,1
1993,1,reg,San Diego Chargers,Seattle Seahawks,LAC,18,12,6,11,30,33,FALSE,0,0,"",5,3
1993,1,reg,Tampa Bay Buccaneers,Kansas City Chiefs,KC,3,27,24,7,30,36,FALSE,0,0,"",17,6
1993,1,reg,Washington Redskins,Dallas Cowboys,WAS,35,16,19,2.5,51,40,FALSE,0,0,"",16.5,11
1993,2,reg,Atlanta Falcons,New Orleans Saints,NO,31,34,3,3.5,65,39.5,FALSE,1,0,DOME,0.5,25.5
1993,2,reg,Cincinnati Bengals,Indianapolis Colts,IND,6,9,3,2,15,36,FALSE,0,0,"",1,21
1993,2,reg,Dallas Cowboys,Buffalo Bills,DAL,10,13,3,5,23,44.5,FALSE,0,0,"",2,21.5
1993,2,reg,Denver Broncos,San Diego Chargers,DEN,34,17,17,3,51,36,FALSE,0,0,"",14,15
1993,2,reg,Green Bay Packers,Philadelphia Eagles,GB,17,20,3,3.5,37,40,FALSE,0,0,"",0.5,3
1993,2,reg,Houston Oilers,Kansas City Chiefs,TEN,30,0,30,3,30,41,FALSE,1,0,DOME,27,11
1993,2,reg,Los Angeles Rams,Pittsburgh Steelers,PIT,27,0,27,3,27,35.5,FALSE,0,0,"",24,8.5
1993,2,reg,Miami Dolphins,New York Jets,MIA,14,24,10,9,38,39.5,FALSE,0,0,"",1,1.5
1993,2,reg,Minnesota Vikings,Chicago Bears,MIN,10,7,3,7,17,36,FALSE,1,0,DOME,4,19
1993,2,reg,New England Patriots,Detroit Lions,DET,16,19,3,7,35,38,FALSE,0,0,"",4,3
1993,2,reg,New York Giants,Tampa Bay Buccaneers,NYG,23,7,16,10,30,37.5,FALSE,0,0,"",6,7.5
1993,2,reg,Seattle Seahawks,Los Angeles Raiders,OAK,13,17,4,3,30,33,FALSE,1,0,DOME,1,3
1993,2,reg,Washington Redskins,Phoenix Cardinals,WAS,10,17,7,10,27,40.5,FALSE,0,0,"",3,13.5
1993,2,reg,Cleveland Browns,San Francisco 49ers,SF,23,13,10,6.5,36,39,FALSE,0,0,"",3.5,3
1993,3,reg,Los Angeles Raiders,Cleveland Browns,OAK,16,19,3,3,35,35,FALSE,0,0,"",0,0
1993,3,reg,New England Patriots,Seattle Seahawks,NE,14,17,3,2.5,31,32,FALSE,0,0,"",0.5,1
1993,3,reg,New Orleans Saints,Detroit Lions,NO,14,3,11,5,17,41,FALSE,1,0,DOME,6,24
1993,3,reg,New York Giants,Los Angeles Rams,NYG,20,10,10,7,30,37,FALSE,0,0,"",3,7
1993,3,reg,Philadelphia Eagles,Washington Redskins,PHI,34,31,3,5.5,65,36,FALSE,0,0,"",2.5,29
1993,3,reg,Phoenix Cardinals,Dallas Cowboys,DAL,10,17,7,6.5,27,38.5,FALSE,0,0,"",0.5,11.5
1993,3,reg,Pittsburgh Steelers,Cincinnati Bengals,PIT,34,7,27,8.5,41,34,FALSE,0,0,"",18.5,7
1993,3,reg,San Diego Chargers,Houston Oilers,LAC,18,17,1,2.5,35,38,FALSE,0,0,"",1.5,3
1993,3,reg,San Francisco 49ers,Atlanta Falcons,SF,37,30,7,13.5,67,47,FALSE,0,0,"",6.5,20
1993,3,reg,Kansas City Chiefs,Denver Broncos,KC,15,7,8,6,22,43,FALSE,0,0,"",2,21
1993,4,reg,Buffalo Bills,Miami Dolphins,BUF,13,22,9,6,35,39,FALSE,0,0,"",3,4
1993,4,reg,Chicago Bears,Tampa Bay Buccaneers,CHI,47,17,30,7,64,33.5,FALSE,0,0,"",23,30.5
1993,4,reg,Cincinnati Bengals,Seattle Seahawks,SEA,10,19,9,3,29,31.5,FALSE,0,0,"",6,2.5
1993,4,reg,Detroit Lions,Phoenix Cardinals,DET,26,20,6,5,46,36.5,FALSE,1,0,DOME,1,9.5
1993,4,reg,Houston Oilers,Los Angeles Rams,TEN,13,28,15,10.5,41,39.5,FALSE,1,0,DOME,4.5,1.5
1993,4,reg,Indianapolis Colts,Cleveland Browns,CLE,23,10,13,2.5,33,33,FALSE,1,0,DOME,10.5,0
1993,4,reg,Minnesota Vikings,Green Bay Packers,MIN,15,13,2,3,28,36.5,FALSE,1,0,DOME,1,8.5
1993,4,reg,New Orleans Saints,San Francisco 49ers,SF,16,13,3,1,29,41,FALSE,1,0,DOME,2,12
1993,4,reg,New York Jets,New England Patriots,NYJ,45,7,38,9.5,52,36.5,FALSE,0,0,"",28.5,15.5
1993,4,reg,Atlanta Falcons,Pittsburgh Steelers,ATL,17,45,28,3,62,42.5,FALSE,1,0,DOME,25,19.5
1993,5,reg,Buffalo Bills,New York Giants,BUF,17,14,3,6,31,43,FALSE,0,0,"",3,12
1993,5,reg,Chicago Bears,Atlanta Falcons,CHI,6,0,6,6,6,44,FALSE,0,0,"",0,38
1993,5,reg,Dallas Cowboys,Green Bay Packers,DAL,36,14,22,11,50,37,FALSE,0,0,"",11,13
1993,5,reg,Denver Broncos,Indianapolis Colts,DEN,35,13,22,8.5,48,36.5,FALSE,0,0,"",13.5,11.5
1993,5,reg,Kansas City Chiefs,Los Angeles Raiders,KC,24,9,15,9,33,36.5,FALSE,0,0,"",6,3.5
1993,5,reg,Los Angeles Rams,New Orleans Saints,NO,6,37,31,4,43,38,FALSE,0,0,"",27,5
1993,5,reg,New York Jets,Philadelphia Eagles,NYJ,30,35,5,1,65,40.5,FALSE,0,0,"",4,24.5
1993,5,reg,San Francisco 49ers,Minnesota Vikings,SF,38,19,19,9.5,57,39,FALSE,0,0,"",9.5,18
1993,5,reg,Seattle Seahawks,San Diego Chargers,LAC,31,14,17,3.5,45,31.5,FALSE,1,0,DOME,13.5,13.5
1993,5,reg,Tampa Bay Buccaneers,Detroit Lions,DET,27,10,17,7,37,37.5,FALSE,0,0,"",10,0.5
1993,5,reg,Miami Dolphins,Washington Redskins,MIA,17,10,7,4,27,41,FALSE,0,0,"",3,14
1993,6,reg,Cleveland Browns,Miami Dolphins,MIA,14,24,10,2,38,36.5,FALSE,0,0,"",8,1.5
1993,6,reg,Green Bay Packers,Denver Broncos,GB,30,27,3,2.5,57,40,FALSE,0,0,"",0.5,17
1993,6,reg,Indianapolis Colts,Dallas Cowboys,DAL,3,27,24,11,30,38,FALSE,1,0,DOME,13,8
1993,6,reg,Kansas City Chiefs,Cincinnati Bengals,KC,17,15,2,14,32,35,FALSE,0,0,"",12,3
1993,6,reg,Los Angeles Raiders,New York Jets,OAK,24,20,4,2.5,44,37,FALSE,0,0,"",1.5,7
1993,6,reg,Minnesota Vikings,Tampa Bay Buccaneers,MIN,15,0,15,9.5,15,36.6,FALSE,1,0,DOME,5.5,21.6
1993,6,reg,Philadelphia Eagles,Chicago Bears,PHI,6,17,11,7,23,36.5,FALSE,0,0,"",4,13.5
1993,6,reg,Phoenix Cardinals,New England Patriots,ARI,21,23,2,10,44,37,FALSE,0,0,"",8,7
1993,6,reg,Pittsburgh Steelers,San Diego Chargers,PIT,16,3,13,5,19,37,FALSE,0,0,"",8,18
1993,6,reg,Washington Redskins,New York Giants,WAS,7,41,34,3.5,48,37,FALSE,0,0,"",30.5,11
1993,6,reg,Buffalo Bills,Houston Oilers,BUF,35,7,28,3.5,42,41,FALSE,0,0,"",24.5,1
1993,7,reg,Atlanta Falcons,Los Angeles Rams,ATL,30,24,6,1,54,43,FALSE,1,0,DOME,5,11
1993,7,reg,Cincinnati Bengals,Cleveland Browns,CLE,17,28,11,5.5,45,34,FALSE,0,0,"",5.5,11
1993,7,reg,Dallas Cowboys,San Francisco 49ers,DAL,26,17,9,6.5,43,43,FALSE,0,0,"",2.5,0
1993,7,reg,Detroit Lions,Seattle Seahawks,DET,30,10,20,5.5,40,34.5,FALSE,1,0,DOME,14.5,5.5
1993,7,reg,New England Patriots,Houston Oilers,TEN,14,28,14,6.5,42,36,FALSE,0,0,"",7.5,6
1993,7,reg,New York Giants,Philadelphia Eagles,NYG,21,10,11,7.5,31,35.5,FALSE,0,0,"",3.5,4.5
1993,7,reg,Phoenix Cardinals,Washington Redskins,WAS,36,6,30,1.5,42,37.5,FALSE,0,0,"",28.5,4.5
1993,7,reg,Pittsburgh Steelers,New Orleans Saints,NO,37,14,23,3,51,33,FALSE,0,0,"",20,18
1993,7,reg,San Diego Chargers,Kansas City Chiefs,KC,14,17,3,4,31,34,FALSE,0,0,"",1,3
1993,7,reg,Denver Broncos,Los Angeles Raiders,DEN,20,23,3,6.5,43,39,FALSE,0,0,"",3.5,4
1993,8,reg,Cleveland Browns,Pittsburgh Steelers,PIT,28,23,5,2,51,34.5,FALSE,0,0,"",3,16.5
1993,8,reg,Houston Oilers,Cincinnati Bengals,TEN,28,12,16,13.5,40,39,FALSE,1,0,DOME,2.5,1
1993,8,reg,Los Angeles Rams,Detroit Lions,DET,13,16,3,1,29,37.5,FALSE,0,0,"",2,8.5
1993,8,reg,Miami Dolphins,Indianapolis Colts,MIA,41,27,14,7.5,68,35.5,FALSE,0,0,"",6.5,32.5
1993,8,reg,New Orleans Saints,Atlanta Falcons,NO,15,26,11,11,41,43,FALSE,1,0,DOME,0,2
1993,8,reg,New York Jets,Buffalo Bills,BUF,10,19,9,3,29,41,FALSE,0,0,"",6,12
1993,8,reg,San Francisco 49ers,Phoenix Cardinals,SF,28,14,14,10.5,42,42.5,FALSE,0,0,"",3.5,0.5
1993,8,reg,Seattle Seahawks,New England Patriots,SEA,10,9,1,8.5,19,33,FALSE,1,0,DOME,7.5,14
1993,8,reg,Tampa Bay Buccaneers,Green Bay Packers,GB,14,37,23,6,51,36.5,FALSE,0,0,"",17,14.5
1993,8,reg,Chicago Bears,Minnesota Vikings,CHI,12,19,7,3,31,34,FALSE,0,0,"",4,3
1993,9,reg,Atlanta Falcons,Tampa Bay Buccaneers,ATL,24,31,7,9.5,55,42.5,FALSE,1,0,DOME,2.5,12.5
1993,9,reg,Denver Broncos,Seattle Seahawks,DEN,28,17,11,8.5,45,36.5,FALSE,0,0,"",2.5,8.5
1993,9,reg,Green Bay Packers,Chicago Bears,GB,17,3,14,6.5,20,35,FALSE,0,0,"",7.5,15
1993,9,reg,Indianapolis Colts,New England Patriots,IND,9,6,3,7,15,35.5,FALSE,1,0,DOME,4,20.5
1993,9,reg,Los Angeles Raiders,San Diego Chargers,OAK,23,30,7,4,53,34.5,FALSE,0,0,"",3,18.5
1993,9,reg,Miami Dolphins,Kansas City Chiefs,KC,30,10,20,1,40,36,FALSE,0,0,"",19,4
1993,9,reg,Minnesota Vikings,Detroit Lions,MIN,27,30,3,4,57,35,FALSE,1,0,DOME,1,22
1993,9,reg,New York Giants,New York Jets,NYG,6,10,4,6.5,16,37,FALSE,0,0,"",2.5,21
1993,9,reg,Philadelphia Eagles,Dallas Cowboys,DAL,10,23,13,10.5,33,38.5,FALSE,0,0,"",2.5,5.5
1993,9,reg,Phoenix Cardinals,New Orleans Saints,NO,17,20,3,3,37,38,FALSE,0,0,"",0,1
1993,9,reg,San Francisco 49ers,Los Angeles Rams,SF,40,17,23,13,57,43.5,FALSE,0,0,"",10,13.5
1993,9,reg,Buffalo Bills,Washington Redskins,BUF,24,10,14,9,34,40.5,FALSE,0,0,"",5,6.5
1993,10,reg,Chicago Bears,Los Angeles Raiders,OAK,14,16,2,2,30,33.5,FALSE,0,0,"",0,3.5
1993,10,reg,Cincinnati Bengals,Pittsburgh Steelers,PIT,16,24,8,9.5,40,35.5,FALSE,0,0,"",1.5,4.5
1993,10,reg,Cleveland Browns,Denver Broncos,CLE,14,29,15,2.5,43,37,FALSE,0,0,"",12.5,6
1993,10,reg,Dallas Cowboys,New York Giants,DAL,31,9,22,10,40,37,FALSE,0,0,"",12,3
1993,10,reg,Detroit Lions,Tampa Bay Buccaneers,DET,23,0,23,12,23,40,FALSE,1,0,DOME,11,17
1993,10,reg,Houston Oilers,Seattle Seahawks,TEN,24,14,10,9,38,37.5,FALSE,1,0,DOME,1,0.5
1993,10,reg,Minnesota Vikings,San Diego Chargers,MIN,17,30,13,4,47,36,FALSE,1,0,DOME,9,11
1993,10,reg,New England Patriots,Buffalo Bills,BUF,10,13,3,9.5,23,37,FALSE,0,0,"",6.5,14
1993,10,reg,New York Jets,Miami Dolphins,MIA,27,10,17,1.5,37,38.5,FALSE,0,0,"",15.5,1.5
1993,10,reg,Phoenix Cardinals,Philadelphia Eagles,ARI,16,3,13,2,19,36,FALSE,0,0,"",11,17
1993,10,reg,Washington Redskins,Indianapolis Colts,WAS,30,24,6,6.5,54,38,FALSE,0,0,"",0.5,16
1993,10,reg,Kansas City Chiefs,Green Bay Packers,KC,23,16,7,4,39,37,FALSE,0,0,"",3,2
1993,11,reg,Cincinnati Bengals,Houston Oilers,TEN,3,38,35,8,41,37,FALSE,0,0,"",27,4
1993,11,reg,Dallas Cowboys,Phoenix Cardinals,DAL,20,15,5,12.5,35,38,FALSE,0,0,"",7.5,3
1993,11,reg,Denver Broncos,Minnesota Vikings,DEN,23,26,3,7,49,38,FALSE,0,0,"",4,11
1993,11,reg,Indianapolis Colts,New York Jets,NYJ,17,31,14,4.5,48,37.5,FALSE,1,0,DOME,9.5,10.5
1993,11,reg,Los Angeles Raiders,Kansas City Chiefs,OAK,20,31,11,3,51,36.5,FALSE,0,0,"",8,14.5
1993,11,reg,Los Angeles Rams,Atlanta Falcons,LAR,0,13,13,3,13,43,FALSE,0,0,"",10,30
1993,11,reg,New Orleans Saints,Green Bay Packers,NO,17,19,2,6,36,37.5,FALSE,1,0,DOME,4,1.5
1993,11,reg,New York Giants,Washington Redskins,NYG,20,6,14,7.5,26,37,FALSE,0,0,"",6.5,11
1993,11,reg,Philadelphia Eagles,Miami Dolphins,MIA,14,19,5,6,33,36.5,FALSE,0,0,"",1,3.5
1993,11,reg,San Diego Chargers,Chicago Bears,LAC,13,16,3,8.5,29,34.5,FALSE,0,0,"",5.5,5.5
1993,11,reg,Seattle Seahawks,Cleveland Browns,SEA,22,5,17,3,27,34,FALSE,1,0,DOME,14,7
1993,11,reg,Tampa Bay Buccaneers,San Francisco 49ers,SF,21,45,24,14.5,66,42,FALSE,0,0,"",9.5,24
1993,11,reg,Pittsburgh Steelers,Buffalo Bills,PIT,23,0,23,3,23,40,FALSE,0,0,"",20,17
1993,12,reg,Atlanta Falcons,Dallas Cowboys,DAL,27,14,13,10,41,41.5,FALSE,1,0,DOME,3,0.5
1993,12,reg,Buffalo Bills,Indianapolis Colts,BUF,23,9,14,13,32,37,FALSE,0,0,"",1,5
1993,12,reg,Cleveland Browns,Houston Oilers,TEN,20,27,7,4.5,47,36,FALSE,0,0,"",2.5,11
1993,12,reg,Denver Broncos,Pittsburgh Steelers,DEN,37,13,24,3,50,37.5,FALSE,0,0,"",21,12.5
1993,12,reg,Green Bay Packers,Detroit Lions,GB,26,17,9,3.5,43,36.5,FALSE,0,0,"",5.5,6.5
1993,12,reg,Kansas City Chiefs,Chicago Bears,KC,17,19,2,10,36,35,FALSE,0,0,"",8,1
1993,12,reg,Los Angeles Rams,Washington Redskins,LAR,10,6,4,2,16,37.5,FALSE,0,0,"",2,21.5
1993,12,reg,Miami Dolphins,New England Patriots,MIA,17,13,4,8,30,34.5,FALSE,0,0,"",4,4.5
1993,12,reg,New York Jets,Cincinnati Bengals,NYJ,17,12,5,15.5,29,37.5,FALSE,0,0,"",10.5,8.5
1993,12,reg,Philadelphia Eagles,New York Giants,NYG,3,7,4,5,10,34.5,FALSE,0,0,"",1,24.5
1993,12,reg,San Diego Chargers,Los Angeles Raiders,LAC,7,12,5,3.5,19,36.5,FALSE,0,0,"",1.5,17.5
1993,12,reg,Tampa Bay Buccaneers,Minnesota Vikings,MIN,23,10,13,8,33,38,FALSE,0,0,"",5,5
1993,12,reg,San Francisco 49ers,New Orleans Saints,SF,42,7,35,8,49,41.5,FALSE,0,0,"",27,7.5
1993,13,reg,Dallas Cowboys,Miami Dolphins,DAL,14,16,2,10,30,37,FALSE,0,0,"",8,7
1993,13,reg,Detroit Lions,Chicago Bears,DET,6,10,4,7,16,36,FALSE,1,0,DOME,3,20
1993,13,reg,Atlanta Falcons,Cleveland Browns,ATL,17,14,3,6.5,31,39,FALSE,1,0,DOME,3.5,8
1993,13,reg,Cincinnati Bengals,Los Angeles Raiders,OAK,16,10,6,9,26,35.5,FALSE,0,0,"",3,9.5
1993,13,reg,Green Bay Packers,Tampa Bay Buccaneers,GB,13,10,3,12.5,23,37.5,FALSE,0,0,"",9.5,14.5
1993,13,reg,Houston Oilers,Pittsburgh Steelers,TEN,23,3,20,3.5,26,39.5,FALSE,1,0,DOME,16.5,13.5
1993,13,reg,Kansas City Chiefs,Buffalo Bills,KC,23,7,16,3,30,37,FALSE,0,0,"",13,7
1993,13,reg,Los Angeles Rams,San Francisco 49ers,SF,10,35,25,13,45,43,FALSE,0,0,"",12,2
1993,13,reg,Minnesota Vikings,New Orleans Saints,MIN,14,17,3,2.5,31,37,FALSE,1,0,DOME,0.5,6
1993,13,reg,New England Patriots,New York Jets,NYJ,0,6,6,4,6,35,FALSE,0,0,"",2,29
1993,13,reg,New York Giants,Phoenix Cardinals,NYG,19,17,2,7,36,35.5,FALSE,0,0,"",5,0.5
1993,13,reg,Seattle Seahawks,Denver Broncos,DEN,9,17,8,3,26,37,FALSE,1,0,DOME,5,11
1993,13,reg,Washington Redskins,Philadelphia Eagles,WAS,14,17,3,2.5,31,34.5,FALSE,0,0,"",0.5,3.5
1993,13,reg,Indianapolis Colts,San Diego Chargers,LAC,0,31,31,2,31,37,FALSE,1,0,DOME,29,6
1993,14,reg,Buffalo Bills,Los Angeles Raiders,BUF,24,25,1,7,49,34,FALSE,0,0,"",6,15
1993,14,reg,Chicago Bears,Green Bay Packers,CHI,30,17,13,1.5,47,32,FALSE,0,0,"",11.5,15
1993,14,reg,Cleveland Browns,New Orleans Saints,NO,17,13,4,4,30,33,FALSE,0,0,"",0,3
1993,14,reg,Detroit Lions,Minnesota Vikings,DET,0,13,13,3,13,35.5,FALSE,1,0,DOME,10,22.5
1993,14,reg,Houston Oilers,Atlanta Falcons,TEN,33,17,16,7.5,50,42,FALSE,1,0,DOME,8.5,8
1993,14,reg,Miami Dolphins,New York Giants,MIA,14,19,5,3.5,33,36,FALSE,0,0,"",1.5,3
1993,14,reg,New York Jets,Indianapolis Colts,NYJ,6,9,3,10.5,15,35,FALSE,0,0,"",7.5,20
1993,14,reg,Phoenix Cardinals,Los Angeles Rams,ARI,38,10,28,7,48,37,FALSE,0,0,"",21,11
1993,14,reg,Pittsburgh Steelers,New England Patriots,PIT,17,14,3,11,31,34,FALSE,0,0,"",8,3
1993,14,reg,San Diego Chargers,Denver Broncos,LAC,13,10,3,3,23,37.5,FALSE,0,0,"",0,14.5
1993,14,reg,San Francisco 49ers,Cincinnati Bengals,SF,21,8,13,24,29,44,FALSE,0,0,"",11,15
1993,14,reg,Seattle Seahawks,Kansas City Chiefs,KC,16,31,15,7,47,35.5,FALSE,1,0,DOME,8,11.5
1993,14,reg,Tampa Bay Buccaneers,Washington Redskins,TB,17,23,6,2.5,40,36.6,FALSE,0,0,"",3.5,3.4
1993,14,reg,Dallas Cowboys,Philadelphia Eagles,DAL,23,17,6,16,40,37,FALSE,0,0,"",10,3
1993,15,reg,Atlanta Falcons,San Francisco 49ers,SF,27,24,3,8,51,48,FALSE,1,0,DOME,5,3
1993,15,reg,Washington Redskins,New York Jets,NYJ,0,3,3,3,3,34.5,FALSE,0,0,"",0,31.5
1993,15,reg,Denver Broncos,Kansas City Chiefs,DEN,27,21,6,1,48,37,FALSE,0,0,"",5,11
1993,15,reg,Houston Oilers,Cleveland Browns,TEN,19,17,2,10,36,39.5,FALSE,1,0,DOME,8,3.5
1993,15,reg,Los Angeles Raiders,Seattle Seahawks,OAK,27,23,4,8.5,50,36,FALSE,0,0,"",4.5,14
1993,15,reg,Minnesota Vikings,Dallas Cowboys,DAL,20,37,17,7,57,37,FALSE,1,0,DOME,10,20
1993,15,reg,New England Patriots,Cincinnati Bengals,NE,7,2,5,5.5,9,31,FALSE,0,0,"",0.5,22
1993,15,reg,New Orleans Saints,Los Angeles Rams,NO,20,23,3,14,43,36.5,FALSE,1,0,DOME,11,6.5
1993,15,reg,New York Giants,Indianapolis Colts,NYG,20,6,14,11,26,33,FALSE,0,0,"",3,7
1993,15,reg,Philadelphia Eagles,Buffalo Bills,BUF,7,10,3,4,17,33.5,FALSE,0,0,"",1,16.5
1993,15,reg,Phoenix Cardinals,Detroit Lions,ARI,14,21,7,7,35,35,FALSE,0,0,"",0,0
1993,15,reg,San Diego Chargers,Green Bay Packers,LAC,13,20,7,3,33,35.5,FALSE,0,0,"",4,2.5
1993,15,reg,Tampa Bay Buccaneers,Chicago Bears,CHI,13,10,3,5,23,34,FALSE,0,0,"",2,11
1993,15,reg,Miami Dolphins,Pittsburgh Steelers,MIA,20,21,1,3.5,41,36.5,FALSE,0,0,"",2.5,4.5
1993,16,reg,Chicago Bears,Denver Broncos,DEN,3,13,10,1.5,16,33,FALSE,0,0,"",8.5,17
1993,16,reg,New York Jets,Dallas Cowboys,DAL,7,28,21,7,35,36.5,FALSE,0,0,"",14,1.5
1993,16,reg,Cincinnati Bengals,Los Angeles Rams,LAR,15,3,12,1,18,32.5,FALSE,0,0,"",11,14.5
1993,16,reg,Cleveland Browns,New England Patriots,CLE,17,20,3,5.5,37,31,FALSE,0,0,"",2.5,6
1993,16,reg,Detroit Lions,San Francisco 49ers,SF,17,55,38,8,72,41,FALSE,1,0,DOME,30,31
1993,16,reg,Green Bay Packers,Minnesota Vikings,GB,17,21,4,6.5,38,33.5,FALSE,0,0,"",2.5,4.5
1993,16,reg,Indianapolis Colts,Philadelphia Eagles,PHI,10,20,10,1.5,30,32.5,FALSE,1,0,DOME,8.5,2.5
1993,16,reg,Kansas City Chiefs,San Diego Chargers,KC,28,24,4,8.5,52,36,FALSE,0,0,"",4.5,16
1993,16,reg,Los Angeles Raiders,Tampa Bay Buccaneers,OAK,27,20,7,9.5,47,37,FALSE,0,0,"",2.5,10
1993,16,reg,Miami Dolphins,Buffalo Bills,MIA,34,47,13,3.5,81,36,FALSE,0,0,"",9.5,45
1993,16,reg,Pittsburgh Steelers,Houston Oilers,PIT,17,26,9,3.5,43,36,FALSE,0,0,"",5.5,7
1993,16,reg,Seattle Seahawks,Phoenix Cardinals,SEA,27,30,3,2,57,35.5,FALSE,1,0,DOME,1,21.5
1993,16,reg,Washington Redskins,Atlanta Falcons,ATL,30,17,13,3,47,37,FALSE,0,0,"",10,10
1993,16,reg,New Orleans Saints,New York Giants,NO,14,24,10,1,38,35.5,FALSE,1,0,DOME,9,2.5
1993,17,reg,San Francisco 49ers,Houston Oilers,SF,7,10,3,7.5,17,47,FALSE,0,0,"",4.5,30
1993,17,reg,Buffalo Bills,New York Jets,BUF,16,14,2,7,30,31,FALSE,0,0,"",5,1
1993,17,reg,Chicago Bears,Detroit Lions,CHI,14,20,6,3,34,28,FALSE,0,0,"",3,6
1993,17,reg,Cincinnati Bengals,Atlanta Falcons,ATL,21,17,4,3.5,38,34,FALSE,0,0,"",0.5,4
1993,17,reg,Dallas Cowboys,Washington Redskins,DAL,38,3,35,17,41,38,FALSE,0,0,"",18,3
1993,17,reg,Denver Broncos,Tampa Bay Buccaneers,DEN,10,17,7,13.5,27,38,FALSE,0,0,"",6.5,11
1993,17,reg,Green Bay Packers,Los Angeles Raiders,GB,28,0,28,3,28,32.5,FALSE,0,0,"",25,4.5
1993,17,reg,Los Angeles Rams,Cleveland Browns,CLE,14,42,28,2,56,35,FALSE,0,0,"",26,21
1993,17,reg,Minnesota Vikings,Kansas City Chiefs,KC,30,10,20,3,40,37,FALSE,1,0,DOME,17,3
1993,17,reg,New England Patriots,Indianapolis Colts,NE,38,0,38,6,38,28,FALSE,0,0,"",32,10
1993,17,reg,Philadelphia Eagles,New Orleans Saints,PHI,37,26,11,3,63,29.5,FALSE,0,0,"",8,33.5
1993,17,reg,Phoenix Cardinals,New York Giants,NYG,17,6,11,3,23,35,FALSE,0,0,"",8,12
1993,17,reg,Seattle Seahawks,Pittsburgh Steelers,PIT,16,6,10,3,22,36,FALSE,1,0,DOME,7,14
1993,17,reg,San Diego Chargers,Miami Dolphins,LAC,45,20,25,1,65,38,FALSE,0,0,"",24,27
1993,18,reg,Washington Redskins,Minnesota Vikings,MIN,9,14,5,7,23,33,FALSE,0,0,"",2,10
1993,18,reg,Atlanta Falcons,Phoenix Cardinals,ATL,10,27,17,2,37,41,FALSE,1,0,DOME,15,4
1993,18,reg,Detroit Lions,Green Bay Packers,GB,30,20,10,1,50,37,FALSE,1,0,DOME,9,13
1993,18,reg,Houston Oilers,New York Jets,TEN,24,0,24,5.5,24,38.5,FALSE,1,0,DOME,18.5,14.5
1993,18,reg,Indianapolis Colts,Buffalo Bills,BUF,10,30,20,11,40,36,FALSE,1,0,DOME,9,4
1993,18,reg,Kansas City Chiefs,Seattle Seahawks,KC,34,24,10,8.5,58,34,FALSE,0,0,"",1.5,24
1993,18,reg,Los Angeles Raiders,Denver Broncos,OAK,33,30,3,3,63,38.5,FALSE,0,0,"",0,24.5
1993,18,reg,Los Angeles Rams,Chicago Bears,CHI,20,6,14,3,26,33,FALSE,0,0,"",11,7
1993,18,reg,New England Patriots,Miami Dolphins,PICK,33,27,6,0,60,34,FALSE,0,0,"",6,26
1993,18,reg,New Orleans Saints,Cincinnati Bengals,NO,20,13,7,6,33,34,FALSE,1,0,DOME,1,1
1993,18,reg,New York Giants,Dallas Cowboys,DAL,13,16,3,6.5,29,35,FALSE,0,0,"",3.5,6
1993,18,reg,Pittsburgh Steelers,Cleveland Browns,PIT,16,9,7,5,25,33,FALSE,0,0,"",2,8
1993,18,reg,Tampa Bay Buccaneers,San Diego Chargers,PICK,17,32,15,0,49,38,FALSE,0,0,"",15,11
1993,18,reg,San Francisco 49ers,Philadelphia Eagles,SF,34,37,3,10.5,71,41,FALSE,0,0,"",7.5,30
1993,Wildcard,post,Detroit Lions,Green Bay Packers,DET,24,28,4,1.5,52,38.5,FALSE,1,0,DOME,2.5,13.5
1993,Wildcard,post,Kansas City Chiefs,Pittsburgh Steelers,KC,27,24,3,7.5,51,36,FALSE,0,0,"",4.5,15
1993,Wildcard,post,Los Angeles Raiders,Denver Broncos,OAK,42,24,18,2,66,41,FALSE,0,0,"",16,25
1993,Wildcard,post,New York Giants,Minnesota Vikings,NYG,17,10,7,6.5,27,33,FALSE,0,0,"",0.5,6
1993,Division,post,Buffalo Bills,Los Angeles Raiders,BUF,29,23,6,7,52,33.5,FALSE,0,0,"",1,18.5
1993,Division,post,San Francisco 49ers,New York Giants,SF,44,3,41,8,47,41.5,FALSE,0,0,"",33,5.5
1993,Division,post,Dallas Cowboys,Green Bay Packers,DAL,27,17,10,13.5,44,42,FALSE,0,0,"",3.5,2
1993,Division,post,Houston Oilers,Kansas City Chiefs,TEN,20,28,8,7,48,41.5,FALSE,1,0,DOME,1,6.5
1993,Conference,post,Buffalo Bills,Kansas City Chiefs,BUF,30,13,17,3,43,39,FALSE,0,0,"",14,4
1993,Conference,post,Dallas Cowboys,San Francisco 49ers,DAL,38,21,17,3,59,48,FALSE,0,0,"",14,11
1993,Superbowl,post,Dallas Cowboys,Buffalo Bills,DAL,30,13,17,10.5,43,50.5,TRUE,1,0,DOME,6.5,7.5
1994,1,reg,Buffalo Bills,New York Jets,BUF,3,23,20,7,26,41,FALSE,0,0,"",13,15
1994,1,reg,Chicago Bears,Tampa Bay Buccaneers,CHI,21,9,12,6,30,35.5,FALSE,0,0,"",6,5.5
1994,1,reg,Cincinnati Bengals,Cleveland Browns,CLE,20,28,8,4,48,36,FALSE,0,0,"",4,12
1994,1,reg,Denver Broncos,San Diego Chargers,DEN,34,37,3,7,71,45,FALSE,0,0,"",4,26
1994,1,reg,Detroit Lions,Atlanta Falcons,DET,31,28,3,5,59,45,FALSE,1,0,DOME,2,14
1994,1,reg,Green Bay Packers,Minnesota Vikings,GB,16,10,6,3.5,26,38,FALSE,0,0,"",2.5,12
1994,1,reg,Indianapolis Colts,Houston Oilers,TEN,45,21,24,3,66,37.5,FALSE,1,0,DOME,21,28.5
1994,1,reg,Los Angeles Rams,Arizona Cardinals,ARI,14,12,2,6.5,26,36,FALSE,0,0,"",4.5,10
1994,1,reg,Miami Dolphins,New England Patriots,MIA,39,35,4,5,74,39,FALSE,0,0,"",1,35
1994,1,reg,New Orleans Saints,Kansas City Chiefs,KC,17,30,13,3,47,39,FALSE,1,0,DOME,10,8
1994,1,reg,New York Giants,Philadelphia Eagles,NYG,28,23,5,3,51,37,FALSE,0,0,"",2,14
1994,1,reg,Pittsburgh Steelers,Dallas Cowboys,DAL,9,26,17,5.5,35,39.5,FALSE,0,0,"",11.5,4.5
1994,1,reg,Washington Redskins,Seattle Seahawks,WAS,7,28,21,1.5,35,36,FALSE,0,0,"",19.5,1
1994,1,reg,San Francisco 49ers,Los Angeles Raiders,SF,44,14,30,7,58,45.5,FALSE,0,0,"",23,12.5
1994,2,reg,Arizona Cardinals,New York Giants,ARI,17,20,3,3.5,37,35.5,FALSE,0,0,"",0.5,1.5
1994,2,reg,Atlanta Falcons,Los Angeles Rams,ATL,31,13,18,8.5,44,43.5,FALSE,1,0,DOME,9.5,0.5
1994,2,reg,Cleveland Browns,Pittsburgh Steelers,CLE,10,17,7,2.5,27,38,FALSE,0,0,"",4.5,11
1994,2,reg,Dallas Cowboys,Houston Oilers,DAL,20,17,3,14.5,37,43.5,FALSE,0,0,"",11.5,6.5
1994,2,reg,Green Bay Packers,Miami Dolphins,GB,14,24,10,3,38,43,FALSE,0,0,"",7,5
1994,2,reg,Kansas City Chiefs,San Francisco 49ers,SF,24,17,7,3,41,46.5,FALSE,0,0,"",4,5.5
1994,2,reg,Los Angeles Raiders,Seattle Seahawks,OAK,9,38,29,6.5,47,42.5,FALSE,0,0,"",22.5,4.5
1994,2,reg,Minnesota Vikings,Detroit Lions,MIN,10,3,7,4.5,13,42.5,FALSE,1,0,DOME,2.5,29.5
1994,2,reg,New England Patriots,Buffalo Bills,NE,35,38,3,2.5,73,41,FALSE,0,0,"",0.5,32
1994,2,reg,New Orleans Saints,Washington Redskins,NO,24,38,14,8,62,38,FALSE,1,0,DOME,6,24
1994,2,reg,New York Jets,Denver Broncos,NYJ,25,22,3,3,47,46,FALSE,0,0,"",0,1
1994,2,reg,San Diego Chargers,Cincinnati Bengals,LAC,27,10,17,9,37,42,FALSE,0,0,"",8,5
1994,2,reg,Tampa Bay Buccaneers,Indianapolis Colts,TB,24,10,14,2,34,37.5,FALSE,0,0,"",12,3.5
1994,2,reg,Philadelphia Eagles,Chicago Bears,PHI,30,22,8,3.5,52,37.5,FALSE,0,0,"",4.5,14.5
1994,3,reg,Atlanta Falcons,Kansas City Chiefs,KC,10,30,20,2.5,40,46.5,FALSE,1,0,DOME,17.5,6.5
1994,3,reg,Chicago Bears,Minnesota Vikings,PICK,14,42,28,0,56,36,FALSE,0,0,"",28,20
1994,3,reg,Cincinnati Bengals,New England Patriots,NE,28,31,3,5.5,59,43,FALSE,0,0,"",2.5,16
1994,3,reg,Cleveland Browns,Arizona Cardinals,CLE,32,0,32,3,32,35.5,FALSE,0,0,"",29,3.5
1994,3,reg,Denver Broncos,Los Angeles Raiders,DEN,16,48,32,4.5,64,50.5,FALSE,0,0,"",27.5,13.5
1994,3,reg,Houston Oilers,Buffalo Bills,TEN,7,15,8,2.5,22,44,FALSE,1,0,DOME,5.5,22
1994,3,reg,Los Angeles Rams,San Francisco 49ers,SF,19,34,15,13.5,53,45,FALSE,0,0,"",1.5,8
1994,3,reg,Miami Dolphins,New York Jets,MIA,28,14,14,3.5,42,45,FALSE,0,0,"",10.5,3
1994,3,reg,New York Giants,Washington Redskins,NYG,31,23,8,7,54,39.5,FALSE,0,0,"",1,14.5
1994,3,reg,Philadelphia Eagles,Green Bay Packers,PHI,13,7,6,3.5,20,42,FALSE,0,0,"",2.5,22
1994,3,reg,Pittsburgh Steelers,Indianapolis Colts,PIT,31,21,10,8,52,38,FALSE,0,0,"",2,14
1994,3,reg,Seattle Seahawks,San Diego Chargers,SEA,10,24,14,3.5,34,40.5,FALSE,0,0,"",10.5,6.5
1994,3,reg,Tampa Bay Buccaneers,New Orleans Saints,TB,7,9,2,3.5,16,38.5,FALSE,0,0,"",1.5,22.5
1994,3,reg,Dallas Cowboys,Detroit Lions,DAL,17,20,3,13,37,44.5,FALSE,0,0,"",10,7.5
1994,4,reg,Detroit Lions,New England Patriots,DET,17,23,6,3,40,48,FALSE,1,0,DOME,3,8
1994,4,reg,Green Bay Packers,Tampa Bay Buccaneers,GB,30,3,27,7,33,37,FALSE,0,0,"",20,4
1994,4,reg,Houston Oilers,Cincinnati Bengals,TEN,20,13,7,8.5,33,41,FALSE,1,0,DOME,1.5,8
1994,4,reg,Indianapolis Colts,Cleveland Browns,CLE,14,21,7,1.5,35,39.5,FALSE,1,0,DOME,5.5,4.5
1994,4,reg,Kansas City Chiefs,Los Angeles Rams,KC,0,16,16,14.5,16,44.5,FALSE,0,0,"",1.5,28.5
1994,4,reg,Los Angeles Raiders,San Diego Chargers,OAK,24,26,2,3.5,50,47,FALSE,0,0,"",1.5,3
1994,4,reg,Minnesota Vikings,Miami Dolphins,MIN,38,35,3,3.5,73,44,FALSE,1,0,DOME,0.5,29
1994,4,reg,New York Jets,Chicago Bears,NYJ,7,19,12,7.5,26,38.5,FALSE,0,0,"",4.5,12.5
1994,4,reg,San Francisco 49ers,New Orleans Saints,SF,24,13,11,15,37,45,FALSE,0,0,"",4,8
1994,4,reg,Seattle Seahawks,Pittsburgh Steelers,PIT,30,13,17,1,43,38.5,FALSE,0,0,"",16,4.5
1994,4,reg,Washington Redskins,Atlanta Falcons,ATL,20,27,7,1,47,48,FALSE,0,0,"",6,1
1994,4,reg,Buffalo Bills,Denver Broncos,BUF,27,20,7,6.5,47,49,FALSE,0,0,"",0.5,2
1994,5,reg,Arizona Cardinals,Minnesota Vikings,MIN,17,7,10,2.5,24,36,FALSE,0,0,"",7.5,12
1994,5,reg,Chicago Bears,Buffalo Bills,BUF,20,13,7,2,33,38.5,FALSE,0,0,"",5,5.5
1994,5,reg,Cincinnati Bengals,Miami Dolphins,MIA,7,23,16,8,30,44.5,FALSE,0,0,"",8,14.5
1994,5,reg,Cleveland Browns,New York Jets,CLE,27,7,20,3.5,34,36,FALSE,0,0,"",16.5,2
1994,5,reg,Indianapolis Colts,Seattle Seahawks,SEA,17,15,2,2.5,32,38,FALSE,1,0,DOME,0.5,6
1994,5,reg,Los Angeles Rams,Atlanta Falcons,ATL,5,8,3,1.5,13,44,FALSE,0,0,"",1.5,31
1994,5,reg,New England Patriots,Green Bay Packers,NE,17,16,1,3,33,44.5,FALSE,0,0,"",2,11.5
1994,5,reg,New Orleans Saints,New York Giants,NYG,27,22,5,2,49,40,FALSE,1,0,DOME,3,9
1994,5,reg,San Francisco 49ers,Philadelphia Eagles,SF,8,40,32,9,48,45,FALSE,0,0,"",23,3
1994,5,reg,Tampa Bay Buccaneers,Detroit Lions,DET,24,14,10,3,38,38.5,FALSE,0,0,"",7,0.5
1994,5,reg,Washington Redskins,Dallas Cowboys,DAL,7,34,27,11.5,41,45,FALSE,0,0,"",15.5,4
1994,5,reg,Pittsburgh Steelers,Houston Oilers,PIT,30,14,16,8,44,39,FALSE,0,0,"",8,5
1994,6,reg,Atlanta Falcons,Tampa Bay Buccaneers,ATL,34,13,21,7,47,41,FALSE,1,0,DOME,14,6
1994,6,reg,Buffalo Bills,Miami Dolphins,BUF,21,11,10,2.5,32,44,FALSE,0,0,"",7.5,12
1994,6,reg,Chicago Bears,New Orleans Saints,CHI,17,7,10,3.5,24,37,FALSE,0,0,"",6.5,13
1994,6,reg,Dallas Cowboys,Arizona Cardinals,DAL,38,3,35,12.5,41,37.5,FALSE,0,0,"",22.5,3.5
1994,6,reg,Detroit Lions,San Francisco 49ers,SF,21,27,6,4.5,48,44,FALSE,1,0,DOME,1.5,4
1994,6,reg,Green Bay Packers,Los Angeles Rams,GB,24,17,7,8.5,41,35,FALSE,0,0,"",1.5,6
1994,6,reg,New England Patriots,Los Angeles Raiders,NE,17,21,4,3,38,48,FALSE,0,0,"",1,10
1994,6,reg,New York Jets,Indianapolis Colts,NYJ,16,6,10,5.5,22,36.5,FALSE,0,0,"",4.5,14.5
1994,6,reg,Philadelphia Eagles,Washington Redskins,PHI,21,17,4,13,38,42,FALSE,0,0,"",9,4
1994,6,reg,San Diego Chargers,Kansas City Chiefs,LAC,20,6,14,1.5,26,43,FALSE,0,0,"",12.5,17
1994,6,reg,Seattle Seahawks,Denver Broncos,SEA,9,16,7,3.5,25,44.5,FALSE,0,0,"",3.5,19.5
1994,6,reg,New York Giants,Minnesota Vikings,NYG,10,27,17,2.5,37,40,FALSE,0,0,"",14.5,3
1994,7,reg,Houston Oilers,Cleveland Browns,CLE,8,11,3,2,19,37,FALSE,1,0,DOME,1,18
1994,7,reg,Atlanta Falcons,San Francisco 49ers,SF,3,42,39,5,45,46.5,FALSE,1,0,DOME,34,1.5
1994,7,reg,Buffalo Bills,Indianapolis Colts,BUF,17,27,10,9.5,44,38,FALSE,0,0,"",0.5,6
1994,7,reg,Dallas Cowboys,Philadelphia Eagles,DAL,24,13,11,8.5,37,42,FALSE,0,0,"",2.5,5
1994,7,reg,Los Angeles Rams,New York Giants,NYG,17,10,7,1.5,27,36.5,FALSE,0,0,"",5.5,9.5
1994,7,reg,Miami Dolphins,Los Angeles Raiders,MIA,20,17,3,3.5,37,46,FALSE,0,0,"",0.5,9
1994,7,reg,New Orleans Saints,San Diego Chargers,LAC,22,36,14,3,58,39,FALSE,1,0,DOME,11,19
1994,7,reg,New York Jets,New England Patriots,NYJ,24,17,7,2,41,41,FALSE,0,0,"",5,0
1994,7,reg,Pittsburgh Steelers,Cincinnati Bengals,PIT,14,10,4,13.5,24,39,FALSE,0,0,"",9.5,15
1994,7,reg,Washington Redskins,Arizona Cardinals,ARI,16,19,3,1,35,35,FALSE,0,0,"",2,0
1994,7,reg,Denver Broncos,Kansas City Chiefs,DEN,28,31,3,1.5,59,43,FALSE,0,0,"",1.5,16
1994,8,reg,Minnesota Vikings,Green Bay Packers,MIN,13,10,3,5,23,37,FALSE,1,0,DOME,2,14
1994,8,reg,Arizona Cardinals,Dallas Cowboys,DAL,21,28,7,8.5,49,36,FALSE,0,0,"",1.5,13
1994,8,reg,Cleveland Browns,Cincinnati Bengals,CLE,37,13,24,10.5,50,34.5,FALSE,0,0,"",13.5,15.5
1994,8,reg,Detroit Lions,Chicago Bears,DET,21,16,5,4,37,37,FALSE,1,0,DOME,1,0
1994,8,reg,Indianapolis Colts,Washington Redskins,IND,27,41,14,7,68,37,FALSE,1,0,DOME,7,31
1994,8,reg,Kansas City Chiefs,Seattle Seahawks,KC,38,23,15,6,61,37,FALSE,0,0,"",9,24
1994,8,reg,Los Angeles Raiders,Atlanta Falcons,OAK,30,17,13,4.5,47,44.5,FALSE,0,0,"",8.5,2.5
1994,8,reg,New Orleans Saints,Los Angeles Rams,NO,37,34,3,3.5,71,36.5,FALSE,1,0,DOME,0.5,34.5
1994,8,reg,New York Giants,Pittsburgh Steelers,NYG,6,10,4,1,16,36.5,FALSE,0,0,"",3,20.5
1994,8,reg,San Diego Chargers,Denver Broncos,LAC,15,20,5,6.5,35,44.5,FALSE,0,0,"",1.5,9.5
1994,8,reg,San Francisco 49ers,Tampa Bay Buccaneers,SF,41,16,25,15.5,57,43,FALSE,0,0,"",9.5,14
1994,8,reg,Philadelphia Eagles,Houston Oilers,PHI,21,6,15,11,27,37.5,FALSE,0,0,"",4,10.5
1994,9,reg,Arizona Cardinals,Pittsburgh Steelers,ARI,20,17,3,2,37,35,FALSE,0,0,"",1,2
1994,9,reg,Buffalo Bills,Kansas City Chiefs,BUF,44,10,34,2.5,54,40,FALSE,0,0,"",31.5,14
1994,9,reg,Cincinnati Bengals,Dallas Cowboys,DAL,20,23,3,15,43,38,FALSE,0,0,"",12,5
1994,9,reg,Denver Broncos,Cleveland Browns,DEN,26,14,12,3,40,40,FALSE,0,0,"",9,0
1994,9,reg,Indianapolis Colts,New York Jets,NYJ,28,25,3,1,53,36,FALSE,1,0,DOME,2,17
1994,9,reg,Los Angeles Raiders,Houston Oilers,OAK,17,14,3,9.5,31,39,FALSE,0,0,"",6.5,8
1994,9,reg,New England Patriots,Miami Dolphins,NE,3,23,20,1,26,43.5,FALSE,0,0,"",19,17.5
1994,9,reg,New York Giants,Detroit Lions,NYG,25,28,3,1,53,34.5,FALSE,0,0,"",2,18.5
1994,9,reg,San Diego Chargers,Seattle Seahawks,LAC,35,15,20,6.5,50,37,FALSE,0,0,"",13.5,13
1994,9,reg,Tampa Bay Buccaneers,Minnesota Vikings,MIN,13,36,23,6.5,49,36.5,FALSE,0,0,"",16.5,12.5
1994,9,reg,Washington Redskins,Philadelphia Eagles,PHI,29,31,2,6,60,40,FALSE,0,0,"",4,20
1994,9,reg,Chicago Bears,Green Bay Packers,CHI,6,33,27,1.5,39,34,FALSE,0,0,"",25.5,5
1994,10,reg,Atlanta Falcons,San Diego Chargers,ATL,10,9,1,2.5,19,40.5,FALSE,1,0,DOME,1.5,21.5
1994,10,reg,Cleveland Browns,New England Patriots,CLE,13,6,7,3,19,37,FALSE,0,0,"",4,18
1994,10,reg,Green Bay Packers,Detroit Lions,GB,38,30,8,5.5,68,35.5,FALSE,0,0,"",2.5,32.5
1994,10,reg,Houston Oilers,Pittsburgh Steelers,PIT,9,12,3,3,21,34.5,FALSE,1,0,DOME,0,13.5
1994,10,reg,Kansas City Chiefs,Los Angeles Raiders,KC,13,3,10,3.5,16,41.5,FALSE,0,0,"",6.5,25.5
1994,10,reg,Los Angeles Rams,Denver Broncos,DEN,27,21,6,3,48,39,FALSE,0,0,"",3,9
1994,10,reg,Miami Dolphins,Indianapolis Colts,MIA,22,21,1,9.5,43,40,FALSE,0,0,"",8.5,3
1994,10,reg,Minnesota Vikings,New Orleans Saints,MIN,21,20,1,9.5,41,38.5,FALSE,1,0,DOME,8.5,2.5
1994,10,reg,New York Jets,Buffalo Bills,BUF,22,17,5,2.5,39,37.5,FALSE,0,0,"",2.5,1.5
1994,10,reg,Philadelphia Eagles,Arizona Cardinals,PHI,17,7,10,6.5,24,35.5,FALSE,0,0,"",3.5,11.5
1994,10,reg,Seattle Seahawks,Cincinnati Bengals,SEA,17,20,3,7.5,37,36,FALSE,1,0,DOME,4.5,1
1994,10,reg,Tampa Bay Buccaneers,Chicago Bears,CHI,6,20,14,3,26,35,FALSE,0,0,"",11,9
1994,10,reg,Washington Redskins,San Francisco 49ers,SF,22,37,15,10,59,44.5,FALSE,0,0,"",5,14.5
1994,10,reg,Dallas Cowboys,New York Giants,DAL,38,10,28,13.5,48,38,FALSE,0,0,"",14.5,10
1994,11,reg,Cincinnati Bengals,Houston Oilers,CIN,34,31,3,1,65,34,FALSE,0,0,"",2,31
1994,11,reg,Denver Broncos,Seattle Seahawks,DEN,17,10,7,7,27,41,FALSE,0,0,"",0,14
1994,11,reg,Detroit Lions,Tampa Bay Buccaneers,DET,14,9,5,10,23,37,FALSE,1,0,DOME,5,14
1994,11,reg,Green Bay Packers,New York Jets,GB,17,10,7,7,27,36,FALSE,0,0,"",0,9
1994,11,reg,Kansas City Chiefs,San Diego Chargers,KC,13,14,1,3,27,37.5,FALSE,0,0,"",2,10.5
1994,11,reg,Los Angeles Rams,Los Angeles Raiders,OAK,17,20,3,3,37,37.5,FALSE,0,0,"",0,0.5
1994,11,reg,Miami Dolphins,Chicago Bears,MIA,14,17,3,7,31,38,FALSE,0,0,"",4,7
1994,11,reg,New England Patriots,Minnesota Vikings,MIN,26,20,6,2.5,46,37,FALSE,0,0,"",3.5,9
1994,11,reg,New Orleans Saints,Atlanta Falcons,NO,33,32,1,2.5,65,43.5,FALSE,1,0,DOME,1.5,21.5
1994,11,reg,New York Giants,Arizona Cardinals,NYG,9,10,1,1,19,34.5,FALSE,0,0,"",0,15.5
1994,11,reg,Philadelphia Eagles,Cleveland Browns,PHI,7,26,19,6.5,33,35,FALSE,0,0,"",12.5,2
1994,11,reg,San Francisco 49ers,Dallas Cowboys,SF,21,14,7,3,35,44,FALSE,0,0,"",4,9
1994,11,reg,Pittsburgh Steelers,Buffalo Bills,PIT,23,10,13,1.5,33,37,FALSE,0,0,"",11.5,4
1994,12,reg,Arizona Cardinals,Philadelphia Eagles,PHI,12,6,6,3.5,18,33,FALSE,0,0,"",2.5,15
1994,12,reg,Buffalo Bills,Green Bay Packers,BUF,29,20,9,3,49,36,FALSE,0,0,"",6,13
1994,12,reg,Chicago Bears,Detroit Lions,CHI,20,10,10,3,30,34.5,FALSE,0,0,"",7,4.5
1994,12,reg,Cincinnati Bengals,Indianapolis Colts,IND,13,17,4,1,30,39.5,FALSE,0,0,"",3,9.5
1994,12,reg,Dallas Cowboys,Washington Redskins,DAL,31,7,24,15.5,38,43.5,FALSE,0,0,"",8.5,5.5
1994,12,reg,Denver Broncos,Atlanta Falcons,DEN,32,28,4,6,60,44,FALSE,0,0,"",2,16
1994,12,reg,Kansas City Chiefs,Cleveland Browns,KC,20,13,7,4,33,34.5,FALSE,0,0,"",3,1.5
1994,12,reg,Los Angeles Raiders,New Orleans Saints,OAK,24,19,5,6.5,43,39,FALSE,0,0,"",1.5,4
1994,12,reg,Minnesota Vikings,New York Jets,MIN,21,31,10,7,52,37.5,FALSE,1,0,DOME,3,14.5
1994,12,reg,New England Patriots,San Diego Chargers,LAC,23,17,6,2.5,40,37.5,FALSE,0,0,"",3.5,2.5
1994,12,reg,Pittsburgh Steelers,Miami Dolphins,PIT,16,13,3,2.5,29,36.5,FALSE,0,0,"",0.5,7.5
1994,12,reg,San Francisco 49ers,Los Angeles Rams,SF,31,27,4,14,58,43,FALSE,0,0,"",10,15
1994,12,reg,Seattle Seahawks,Tampa Bay Buccaneers,SEA,22,21,1,7,43,36,FALSE,1,0,DOME,6,7
1994,12,reg,Houston Oilers,New York Giants,TEN,10,13,3,3,23,35,FALSE,1,0,DOME,0,12
1994,13,reg,Dallas Cowboys,Green Bay Packers,DAL,42,31,11,6,73,35,FALSE,0,0,"",5,38
1994,13,reg,Detroit Lions,Buffalo Bills,BUF,35,21,14,1.5,56,39,FALSE,1,0,DOME,12.5,17
1994,13,reg,Arizona Cardinals,Chicago Bears,ARI,16,19,3,3,35,31,FALSE,0,0,"",0,4
1994,13,reg,Atlanta Falcons,Philadelphia Eagles,PHI,28,21,7,1.5,49,42,FALSE,1,0,DOME,5.5,7
1994,13,reg,Cleveland Browns,Houston Oilers,CLE,34,10,24,8,44,33,FALSE,0,0,"",16,11
1994,13,reg,Denver Broncos,Cincinnati Bengals,DEN,15,13,2,8.5,28,43.5,FALSE,0,0,"",6.5,15.5
1994,13,reg,Indianapolis Colts,New England Patriots,IND,10,12,2,1,22,40,FALSE,1,0,DOME,1,18
1994,13,reg,Los Angeles Raiders,Pittsburgh Steelers,OAK,3,21,18,3.5,24,36,FALSE,0,0,"",14.5,12
1994,13,reg,Minnesota Vikings,Tampa Bay Buccaneers,MIN,17,20,3,13.5,37,40,FALSE,1,0,DOME,10.5,3
1994,13,reg,New York Jets,Miami Dolphins,NYJ,24,28,4,1.5,52,37.5,FALSE,0,0,"",2.5,14.5
1994,13,reg,San Diego Chargers,Los Angeles Rams,LAC,31,17,14,7,48,37.5,FALSE,0,0,"",7,10.5
1994,13,reg,Seattle Seahawks,Kansas City Chiefs,KC,10,9,1,3.5,19,36.5,FALSE,1,0,DOME,2.5,17.5
1994,13,reg,Washington Redskins,New York Giants,WAS,19,21,2,3,40,36.5,FALSE,0,0,"",1,3.5
1994,13,reg,New Orleans Saints,San Francisco 49ers,SF,14,35,21,8.5,49,46.5,FALSE,1,0,DOME,12.5,2.5
1994,14,reg,Minnesota Vikings,Chicago Bears,MIN,33,27,6,5.5,60,36,FALSE,1,0,DOME,0.5,24
1994,14,reg,Cincinnati Bengals,Pittsburgh Steelers,PIT,15,38,23,6,53,35,FALSE,0,0,"",17,18
1994,14,reg,Cleveland Browns,New York Giants,CLE,13,16,3,7,29,33,FALSE,0,0,"",4,4
1994,14,reg,Detroit Lions,Green Bay Packers,DET,34,31,3,1.5,65,38.5,FALSE,1,0,DOME,1.5,26.5
1994,14,reg,Houston Oilers,Arizona Cardinals,ARI,12,30,18,3,42,32,FALSE,1,0,DOME,15,10
1994,14,reg,Kansas City Chiefs,Denver Broncos,KC,17,20,3,3.5,37,38,FALSE,0,0,"",0.5,1
1994,14,reg,Los Angeles Rams,New Orleans Saints,LAR,15,31,16,3,46,41.5,FALSE,0,0,"",13,4.5
1994,14,reg,Miami Dolphins,Buffalo Bills,MIA,31,42,11,4,73,42,FALSE,0,0,"",7,31
1994,14,reg,New England Patriots,New York Jets,NE,24,13,11,2.5,37,37,FALSE,0,0,"",8.5,0
1994,14,reg,Philadelphia Eagles,Dallas Cowboys,DAL,19,31,12,2.5,50,37,FALSE,0,0,"",9.5,13
1994,14,reg,San Francisco 49ers,Atlanta Falcons,SF,50,14,36,13,64,48,FALSE,0,0,"",23,16
1994,14,reg,Seattle Seahawks,Indianapolis Colts,SEA,19,31,12,3,50,36.5,FALSE,1,0,DOME,9,13.5
1994,14,reg,Tampa Bay Buccaneers,Washington Redskins,TB,26,21,5,2.5,47,38,FALSE,0,0,"",2.5,9
1994,14,reg,San Diego Chargers,Los Angeles Raiders,LAC,17,24,7,4,41,37.5,FALSE,0,0,"",3,3.5
1994,15,reg,Dallas Cowboys,Cleveland Browns,DAL,14,19,5,10.5,33,38,FALSE,0,0,"",5.5,5
1994,15,reg,New York Jets,Detroit Lions,NYJ,7,18,11,3,25,37.5,FALSE,0,0,"",8,12.5
1994,15,reg,Arizona Cardinals,Washington Redskins,ARI,17,15,2,7.5,32,34.5,FALSE,0,0,"",5.5,2.5
1994,15,reg,Atlanta Falcons,New Orleans Saints,ATL,20,29,9,4,49,46,FALSE,1,0,DOME,5,3
1994,15,reg,Buffalo Bills,Minnesota Vikings,BUF,17,21,4,3.5,38,40,FALSE,0,0,"",0.5,2
1994,15,reg,Green Bay Packers,Chicago Bears,GB,40,3,37,4,43,35,FALSE,0,0,"",33,8
1994,15,reg,Houston Oilers,Seattle Seahawks,TEN,14,16,2,3,30,33,FALSE,1,0,DOME,1,3
1994,15,reg,Los Angeles Raiders,Denver Broncos,OAK,23,13,10,5,36,41.5,FALSE,0,0,"",5,5.5
1994,15,reg,New England Patriots,Indianapolis Colts,NE,28,13,15,6,41,37,FALSE,0,0,"",9,4
1994,15,reg,New York Giants,Cincinnati Bengals,NYG,27,20,7,5.5,47,35,FALSE,0,0,"",1.5,12
1994,15,reg,Pittsburgh Steelers,Philadelphia Eagles,PIT,14,3,11,6,17,35,FALSE,0,0,"",5,18
1994,15,reg,San Diego Chargers,San Francisco 49ers,SF,15,38,23,9,53,45.5,FALSE,0,0,"",14,7.5
1994,15,reg,Tampa Bay Buccaneers,Los Angeles Rams,TB,24,14,10,2.5,38,40,FALSE,0,0,"",7.5,2
1994,15,reg,Miami Dolphins,Kansas City Chiefs,MIA,45,28,17,4.5,73,39.5,FALSE,0,0,"",12.5,33.5
1994,16,reg,Detroit Lions,Minnesota Vikings,DET,41,19,22,1.5,60,42,FALSE,1,0,DOME,20.5,18
1994,16,reg,San Francisco 49ers,Denver Broncos,SF,42,19,23,15,61,47.5,FALSE,0,0,"",8,13.5
1994,16,reg,Arizona Cardinals,Cincinnati Bengals,ARI,28,7,21,7,35,34.5,FALSE,0,0,"",14,0.5
1994,16,reg,Buffalo Bills,New England Patriots,BUF,17,41,24,1,58,37,FALSE,0,0,"",23,21
1994,16,reg,Chicago Bears,Los Angeles Rams,CHI,27,13,14,7,40,33.5,FALSE,0,0,"",7,6.5
1994,16,reg,Green Bay Packers,Atlanta Falcons,GB,21,17,4,7.5,38,39.5,FALSE,0,0,"",3.5,1.5
1994,16,reg,Indianapolis Colts,Miami Dolphins,MIA,10,6,4,3.5,16,42,FALSE,1,0,DOME,0.5,26
1994,16,reg,Kansas City Chiefs,Houston Oilers,KC,31,9,22,9.5,40,34,FALSE,0,0,"",12.5,6
1994,16,reg,New York Jets,San Diego Chargers,LAC,6,21,15,2,27,37,FALSE,0,0,"",13,10
1994,16,reg,Philadelphia Eagles,New York Giants,PHI,13,16,3,4.5,29,35,FALSE,0,0,"",1.5,6
1994,16,reg,Pittsburgh Steelers,Cleveland Browns,PIT,17,7,10,3.5,24,32.5,FALSE,0,0,"",6.5,8.5
1994,16,reg,Seattle Seahawks,Los Angeles Raiders,OAK,16,17,1,6,33,36,FALSE,1,0,DOME,5,3
1994,16,reg,Washington Redskins,Tampa Bay Buccaneers,WAS,14,17,3,2,31,39,FALSE,0,0,"",1,8
1994,16,reg,New Orleans Saints,Dallas Cowboys,DAL,16,24,8,10,40,45.5,FALSE,1,0,DOME,2,5.5
1994,17,reg,Atlanta Falcons,Arizona Cardinals,ARI,10,6,4,3,16,38,FALSE,1,0,DOME,1,22
1994,17,reg,Chicago Bears,New England Patriots,NE,3,13,10,1,16,36.5,FALSE,0,0,"",9,20.5
1994,17,reg,Cincinnati Bengals,Philadelphia Eagles,PICK,33,30,3,0,63,35.5,FALSE,0,0,"",3,27.5
1994,17,reg,Cleveland Browns,Seattle Seahawks,CLE,35,9,26,10.5,44,34,FALSE,0,0,"",15.5,10
1994,17,reg,Denver Broncos,New Orleans Saints,DEN,28,30,2,4.5,58,45,FALSE,0,0,"",2.5,13
1994,17,reg,Houston Oilers,New York Jets,NYJ,24,10,14,1.5,34,34,FALSE,1,0,DOME,12.5,0
1994,17,reg,Indianapolis Colts,Buffalo Bills,IND,10,9,1,3,19,41,FALSE,1,0,DOME,2,22
1994,17,reg,Los Angeles Raiders,Kansas City Chiefs,OAK,9,19,10,3.5,28,37.5,FALSE,0,0,"",6.5,9.5
1994,17,reg,Los Angeles Rams,Washington Redskins,LAR,21,24,3,3.5,45,40.5,FALSE,0,0,"",0.5,4.5
1994,17,reg,New York Giants,Dallas Cowboys,DAL,15,10,5,3,25,36,FALSE,0,0,"",2,11
1994,17,reg,San Diego Chargers,Pittsburgh Steelers,LAC,37,34,3,3.5,71,35,FALSE,0,0,"",0.5,36
1994,17,reg,Tampa Bay Buccaneers,Green Bay Packers,GB,19,34,15,4.5,53,41,FALSE,0,0,"",10.5,12
1994,17,reg,Miami Dolphins,Detroit Lions,MIA,27,20,7,3.5,47,45.5,FALSE,0,0,"",3.5,1.5
1994,17,reg,Minnesota Vikings,San Francisco 49ers,SF,21,14,7,6.5,35,48,FALSE,1,0,DOME,0.5,13
1994,Wildcard,post,Green Bay Packers,Detroit Lions,GB,16,12,4,4.5,28,40,FALSE,0,0,"",0.5,12
1994,Wildcard,post,Miami Dolphins,Kansas City Chiefs,MIA,27,17,10,3,44,45,FALSE,0,0,"",7,1
1994,Wildcard,post,Cleveland Browns,New England Patriots,CLE,20,13,7,3,33,35.5,FALSE,0,0,"",4,2.5
1994,Wildcard,post,Minnesota Vikings,Chicago Bears,MIN,18,35,17,6,53,38,FALSE,1,0,DOME,11,15
1994,Division,post,Pittsburgh Steelers,Cleveland Browns,PIT,29,9,20,3.5,38,32.5,FALSE,0,0,"",16.5,5.5
1994,Division,post,San Francisco 49ers,Chicago Bears,SF,44,15,29,15.5,59,46.5,FALSE,0,0,"",13.5,12.5
1994,Division,post,Dallas Cowboys,Green Bay Packers,DAL,35,9,26,10,44,43,FALSE,0,0,"",16,1
1994,Division,post,San Diego Chargers,Miami Dolphins,LAC,22,21,1,3,43,46,FALSE,0,0,"",2,3
1994,Conference,post,Pittsburgh Steelers,San Diego Chargers,PIT,13,17,4,6,30,35,FALSE,0,0,"",2,5
1994,Conference,post,San Francisco 49ers,Dallas Cowboys,SF,38,28,10,7,66,48,FALSE,0,0,"",3,18
1994,Superbowl,post,San Francisco 49ers,San Diego Chargers,SF,49,26,23,18.5,75,53.5,TRUE,0,0,"",4.5,21.5
1995,1,reg,Atlanta Falcons,Carolina Panthers,ATL,23,20,3,8.5,43,40.5,FALSE,1,0,DOME,5.5,2.5
1995,1,reg,Chicago Bears,Minnesota Vikings,CHI,31,14,17,2.5,45,38.5,FALSE,0,0,"",14.5,6.5
1995,1,reg,Denver Broncos,Buffalo Bills,DEN,22,7,15,6,29,44,FALSE,0,0,"",9,15
1995,1,reg,Green Bay Packers,St. Louis Rams,GB,14,17,3,6.5,31,38,FALSE,0,0,"",3.5,7
1995,1,reg,Indianapolis Colts,Cincinnati Bengals,IND,21,24,3,6.5,45,39,FALSE,1,0,DOME,3.5,6
1995,1,reg,Jacksonville Jaguars,Houston Oilers,TEN,3,10,7,4,13,35,FALSE,0,0,"",3,22
1995,1,reg,Miami Dolphins,New York Jets,MIA,52,14,38,9,66,38.5,FALSE,0,0,"",29,27.5
1995,1,reg,New England Patriots,Cleveland Browns,NE,17,14,3,3,31,38,FALSE,0,0,"",0,7
1995,1,reg,New Orleans Saints,San Francisco 49ers,SF,22,24,2,8.5,46,46,FALSE,1,0,DOME,6.5,0
1995,1,reg,Oakland Raiders,San Diego Chargers,OAK,17,7,10,4,24,40,FALSE,0,0,"",6,16
1995,1,reg,Philadelphia Eagles,Tampa Bay Buccaneers,PHI,6,21,15,7,27,39,FALSE,0,0,"",8,12
1995,1,reg,Pittsburgh Steelers,Detroit Lions,PIT,23,20,3,5.5,43,37,FALSE,0,0,"",2.5,6
1995,1,reg,Seattle Seahawks,Kansas City Chiefs,PICK,10,34,24,0,44,36.5,FALSE,1,0,DOME,24,7.5
1995,1,reg,Washington Redskins,Arizona Cardinals,ARI,27,7,20,3,34,34.5,FALSE,0,0,"",17,0.5
1995,1,reg,New York Giants,Dallas Cowboys,DAL,0,35,35,5.5,35,38,FALSE,0,0,"",29.5,3
1995,2,reg,Arizona Cardinals,Philadelphia Eagles,ARI,19,31,12,3,50,35.5,FALSE,0,0,"",9,14.5
1995,2,reg,Buffalo Bills,Carolina Panthers,BUF,31,9,22,9,40,38,FALSE,0,0,"",13,2
1995,2,reg,Cincinnati Bengals,Jacksonville Jaguars,CIN,24,17,7,8,41,37,FALSE,0,0,"",1,4
1995,2,reg,Cleveland Browns,Tampa Bay Buccaneers,CLE,22,6,16,7.5,28,37,FALSE,0,0,"",8.5,9
1995,2,reg,Dallas Cowboys,Denver Broncos,DAL,31,21,10,10,52,43,FALSE,0,0,"",0,9
1995,2,reg,Houston Oilers,Pittsburgh Steelers,PIT,17,34,17,5,51,33.5,FALSE,1,0,DOME,12,17.5
1995,2,reg,Kansas City Chiefs,New York Giants,KC,20,17,3,5.5,37,37,FALSE,0,0,"",2.5,0
1995,2,reg,Minnesota Vikings,Detroit Lions,MIN,20,10,10,3,30,41.5,FALSE,1,0,DOME,7,11.5
1995,2,reg,New England Patriots,Miami Dolphins,MIA,3,20,17,1,23,46,FALSE,0,0,"",16,23
1995,2,reg,New York Jets,Indianapolis Colts,IND,24,27,3,2,51,37,FALSE,0,0,"",1,14
1995,2,reg,San Diego Chargers,Seattle Seahawks,LAC,14,10,4,8,24,37.5,FALSE,0,0,"",4,13.5
1995,2,reg,San Francisco 49ers,Atlanta Falcons,SF,41,10,31,13,51,48.5,FALSE,0,0,"",18,2.5
1995,2,reg,St. Louis Rams,New Orleans Saints,LAR,17,13,4,2.5,30,41,FALSE,0,0,"",1.5,11
1995,2,reg,Washington Redskins,Oakland Raiders,OAK,8,20,12,4.5,28,39,FALSE,0,0,"",7.5,11
1995,2,reg,Chicago Bears,Green Bay Packers,CHI,24,27,3,3,51,38.5,FALSE,0,0,"",0,12.5
1995,3,reg,Buffalo Bills,Indianapolis Colts,BUF,20,14,6,4,34,40,FALSE,0,0,"",2,6
1995,3,reg,Carolina Panthers,St. Louis Rams,LAR,10,31,21,3,41,36.5,FALSE,0,0,"",18,4.5
1995,3,reg,Denver Broncos,Washington Redskins,DEN,38,31,7,9,69,42.5,FALSE,0,0,"",2,26.5
1995,3,reg,Detroit Lions,Arizona Cardinals,DET,17,20,3,6.5,37,37,FALSE,1,0,DOME,3.5,0
1995,3,reg,Green Bay Packers,New York Giants,GB,14,6,8,5.5,20,37.5,FALSE,0,0,"",2.5,17.5
1995,3,reg,Houston Oilers,Cleveland Browns,CLE,7,14,7,8,21,33.5,FALSE,1,0,DOME,1,12.5
1995,3,reg,Kansas City Chiefs,Oakland Raiders,KC,23,17,6,2,40,39,FALSE,0,0,"",4,1
1995,3,reg,Minnesota Vikings,Dallas Cowboys,DAL,17,23,6,8,40,42,FALSE,1,0,DOME,2,2
1995,3,reg,New Orleans Saints,Atlanta Falcons,NO,24,27,3,3,51,46.5,FALSE,1,0,DOME,0,4.5
1995,3,reg,New York Jets,Jacksonville Jaguars,NYJ,27,10,17,7,37,36,FALSE,0,0,"",10,1
1995,3,reg,Philadelphia Eagles,San Diego Chargers,PHI,21,27,6,2,48,37.5,FALSE,0,0,"",4,10.5
1995,3,reg,San Francisco 49ers,New England Patriots,SF,28,3,25,11.5,31,48,FALSE,0,0,"",13.5,17
1995,3,reg,Seattle Seahawks,Cincinnati Bengals,SEA,24,21,3,4,45,37.5,FALSE,1,0,DOME,1,7.5
1995,3,reg,Tampa Bay Buccaneers,Chicago Bears,CHI,6,25,19,2,31,37.5,FALSE,0,0,"",17,6.5
1995,3,reg,Miami Dolphins,Pittsburgh Steelers,MIA,23,10,13,7,33,40,FALSE,0,0,"",6,7
1995,4,reg,Atlanta Falcons,New York Jets,ATL,13,3,10,4.5,16,43,FALSE,1,0,DOME,5.5,27
1995,4,reg,Cincinnati Bengals,Houston Oilers,CIN,28,38,10,6,66,36.5,FALSE,0,0,"",4,29.5
1995,4,reg,Cleveland Browns,Kansas City Chiefs,CLE,35,17,18,3.5,52,37,FALSE,0,0,"",14.5,15
1995,4,reg,Dallas Cowboys,Arizona Cardinals,DAL,34,20,14,14.5,54,39,FALSE,0,0,"",0.5,15
1995,4,reg,Jacksonville Jaguars,Green Bay Packers,GB,14,24,10,10.5,38,37,FALSE,0,0,"",0.5,1
1995,4,reg,New York Giants,New Orleans Saints,NYG,45,29,16,3,74,38,FALSE,0,0,"",13,36
1995,4,reg,Oakland Raiders,Philadelphia Eagles,OAK,48,17,31,7,65,39,FALSE,0,0,"",24,26
1995,4,reg,Pittsburgh Steelers,Minnesota Vikings,PIT,24,44,20,5.5,68,37,FALSE,0,0,"",14.5,31
1995,4,reg,San Diego Chargers,Denver Broncos,LAC,17,6,11,3.5,23,42.5,FALSE,0,0,"",7.5,19.5
1995,4,reg,St. Louis Rams,Chicago Bears,LAR,34,28,6,1.5,62,37.5,FALSE,0,0,"",4.5,24.5
1995,4,reg,Tampa Bay Buccaneers,Washington Redskins,TB,14,6,8,3,20,40,FALSE,0,0,"",5,20
1995,4,reg,Detroit Lions,San Francisco 49ers,SF,27,24,3,11,51,48,FALSE,1,0,DOME,8,3
1995,5,reg,Arizona Cardinals,Kansas City Chiefs,KC,3,24,21,1.5,27,37,FALSE,0,0,"",19.5,10
1995,5,reg,Atlanta Falcons,New England Patriots,ATL,30,17,13,3,47,40,FALSE,1,0,DOME,10,7
1995,5,reg,Carolina Panthers,Tampa Bay Buccaneers,TB,13,20,7,5.5,33,35,FALSE,0,0,"",1.5,2
1995,5,reg,Cincinnati Bengals,Miami Dolphins,MIA,23,26,3,10.5,49,45.5,FALSE,0,0,"",7.5,3.5
1995,5,reg,Houston Oilers,Jacksonville Jaguars,TEN,16,17,1,9.5,33,34.5,FALSE,1,0,DOME,8.5,1.5
1995,5,reg,Indianapolis Colts,St. Louis Rams,IND,21,18,3,3,39,40,FALSE,1,0,DOME,0,1
1995,5,reg,New Orleans Saints,Philadelphia Eagles,NO,10,15,5,1.5,25,45,FALSE,1,0,DOME,3.5,20
1995,5,reg,New York Jets,Oakland Raiders,OAK,10,47,37,7.5,57,38.5,FALSE,0,0,"",29.5,18.5
1995,5,reg,Pittsburgh Steelers,San Diego Chargers,PIT,31,16,15,2,47,37,FALSE,0,0,"",13,10
1995,5,reg,San Francisco 49ers,New York Giants,SF,20,6,14,15,26,45.5,FALSE,0,0,"",1,19.5
1995,5,reg,Seattle Seahawks,Denver Broncos,DEN,27,10,17,3,37,41.5,FALSE,1,0,DOME,14,4.5
1995,5,reg,Washington Redskins,Dallas Cowboys,DAL,27,23,4,13,50,44.5,FALSE,0,0,"",9,5.5
1995,5,reg,Cleveland Browns,Buffalo Bills,CLE,19,22,3,7,41,36.5,FALSE,0,0,"",4,4.5
1995,6,reg,Buffalo Bills,New York Jets,BUF,29,10,19,9.5,39,38,FALSE,0,0,"",9.5,1
1995,6,reg,Chicago Bears,Carolina Panthers,CHI,31,27,4,13.5,58,36.5,FALSE,0,0,"",9.5,21.5
1995,6,reg,Dallas Cowboys,Green Bay Packers,DAL,34,24,10,9.5,58,42,FALSE,0,0,"",0.5,16
1995,6,reg,Detroit Lions,Cleveland Browns,CLE,38,20,18,1.5,58,39,FALSE,1,0,DOME,16.5,19
1995,6,reg,Jacksonville Jaguars,Pittsburgh Steelers,PIT,20,16,4,10.5,36,36.5,FALSE,0,0,"",6.5,0.5
1995,6,reg,Miami Dolphins,Indianapolis Colts,MIA,24,27,3,10,51,44,FALSE,0,0,"",7,7
1995,6,reg,Minnesota Vikings,Houston Oilers,MIN,23,17,6,10,40,37,FALSE,1,0,DOME,4,3
1995,6,reg,New England Patriots,Denver Broncos,NE,3,37,34,3.5,40,43,FALSE,0,0,"",30.5,3
1995,6,reg,New York Giants,Arizona Cardinals,NYG,27,21,6,4,48,36,FALSE,0,0,"",2,12
1995,6,reg,Oakland Raiders,Seattle Seahawks,OAK,34,14,20,9.5,48,39,FALSE,0,0,"",10.5,9
1995,6,reg,Philadelphia Eagles,Washington Redskins,PHI,37,34,3,3,71,41,FALSE,0,0,"",0,30
1995,6,reg,Tampa Bay Buccaneers,Cincinnati Bengals,TB,19,16,3,3.5,35,39,FALSE,0,0,"",0.5,4
1995,6,reg,Kansas City Chiefs,San Diego Chargers,KC,29,23,6,3.5,52,38,FALSE,0,0,"",2.5,14
1995,7,reg,St. Louis Rams,Atlanta Falcons,LAR,21,19,2,3,40,43,FALSE,0,0,"",1,3
1995,7,reg,Arizona Cardinals,Washington Redskins,ARI,24,20,4,2.5,44,40,FALSE,0,0,"",1.5,4
1995,7,reg,Buffalo Bills,Seattle Seahawks,BUF,27,21,6,7.5,48,38,FALSE,0,0,"",1.5,10
1995,7,reg,Carolina Panthers,New York Jets,NYJ,26,15,11,1.5,41,37,FALSE,0,0,"",9.5,4
1995,7,reg,Green Bay Packers,Detroit Lions,GB,30,21,9,3.5,51,40,FALSE,0,0,"",5.5,11
1995,7,reg,Indianapolis Colts,San Francisco 49ers,SF,18,17,1,10,35,46.5,FALSE,1,0,DOME,9,11.5
1995,7,reg,Jacksonville Jaguars,Chicago Bears,CHI,27,30,3,7.5,57,37,FALSE,0,0,"",4.5,20
1995,7,reg,Kansas City Chiefs,New England Patriots,KC,31,26,5,7,57,38,FALSE,0,0,"",2,19
1995,7,reg,New Orleans Saints,Miami Dolphins,MIA,33,30,3,6.5,63,44,FALSE,1,0,DOME,3.5,19
1995,7,reg,New York Giants,Philadelphia Eagles,NYG,14,17,3,3,31,39,FALSE,0,0,"",0,8
1995,7,reg,San Diego Chargers,Dallas Cowboys,DAL,9,23,14,7,32,43,FALSE,0,0,"",7,11
1995,7,reg,Tampa Bay Buccaneers,Minnesota Vikings,MIN,20,17,3,2,37,36.5,FALSE,0,0,"",1,0.5
1995,7,reg,Denver Broncos,Oakland Raiders,OAK,27,0,27,3,27,45.5,FALSE,0,0,"",24,18.5
1995,8,reg,Pittsburgh Steelers,Cincinnati Bengals,PIT,9,27,18,8,36,40,FALSE,0,0,"",10,4
1995,8,reg,Carolina Panthers,New Orleans Saints,NO,20,3,17,3.5,23,40.5,FALSE,0,0,"",13.5,17.5
1995,8,reg,Chicago Bears,Houston Oilers,CHI,35,32,3,7,67,40,FALSE,0,0,"",4,27
1995,8,reg,Cleveland Browns,Jacksonville Jaguars,CLE,15,23,8,13.5,38,37,FALSE,0,0,"",5.5,1
1995,8,reg,Denver Broncos,Kansas City Chiefs,DEN,7,21,14,3,28,40,FALSE,0,0,"",11,12
1995,8,reg,Green Bay Packers,Minnesota Vikings,GB,38,21,17,4,59,40,FALSE,0,0,"",13,19
1995,8,reg,New York Jets,Miami Dolphins,MIA,17,16,1,9,33,42,FALSE,0,0,"",8,9
1995,8,reg,Oakland Raiders,Indianapolis Colts,OAK,30,17,13,4,47,40,FALSE,0,0,"",9,7
1995,8,reg,Seattle Seahawks,San Diego Chargers,LAC,25,35,10,3,60,39,FALSE,1,0,DOME,7,21
1995,8,reg,St. Louis Rams,San Francisco 49ers,SF,10,44,34,3.5,54,40,FALSE,0,0,"",30.5,14
1995,8,reg,Tampa Bay Buccaneers,Atlanta Falcons,TB,21,24,3,3,45,40,FALSE,0,0,"",0,5
1995,8,reg,Washington Redskins,Detroit Lions,DET,36,30,6,1,66,43,FALSE,0,0,"",5,23
1995,8,reg,New England Patriots,Buffalo Bills,PICK,27,14,13,0,41,40,FALSE,0,0,"",13,1
1995,9,reg,Arizona Cardinals,Seattle Seahawks,ARI,20,14,6,4,34,40,FALSE,0,0,"",2,6
1995,9,reg,Atlanta Falcons,Dallas Cowboys,DAL,13,28,15,10,41,46,FALSE,1,0,DOME,5,5
1995,9,reg,Cincinnati Bengals,Cleveland Browns,CLE,26,29,3,2,55,40,FALSE,0,0,"",1,15
1995,9,reg,Detroit Lions,Green Bay Packers,DET,24,16,8,2.5,40,45,FALSE,1,0,DOME,5.5,5
1995,9,reg,Houston Oilers,Tampa Bay Buccaneers,TB,19,7,12,1,26,37,FALSE,1,0,DOME,11,11
1995,9,reg,Indianapolis Colts,New York Jets,IND,17,10,7,10.5,27,40,FALSE,1,0,DOME,3.5,13
1995,9,reg,Miami Dolphins,Buffalo Bills,MIA,23,6,17,6,29,43,FALSE,0,0,"",11,14
1995,9,reg,New England Patriots,Carolina Panthers,NE,17,20,3,8,37,38.5,FALSE,0,0,"",5,1.5
1995,9,reg,Philadelphia Eagles,St. Louis Rams,PHI,20,9,11,3.5,29,40,FALSE,0,0,"",7.5,11
1995,9,reg,Pittsburgh Steelers,Jacksonville Jaguars,PIT,24,7,17,10,31,38,FALSE,0,0,"",7,7
1995,9,reg,San Francisco 49ers,New Orleans Saints,SF,7,11,4,14,18,44.5,FALSE,0,0,"",10,26.5
1995,9,reg,Washington Redskins,New York Giants,WAS,15,24,9,3,39,41.5,FALSE,0,0,"",6,2.5
1995,9,reg,Minnesota Vikings,Chicago Bears,MIN,6,14,8,3.5,20,44.5,FALSE,1,0,DOME,4.5,24.5
1995,10,reg,Atlanta Falcons,Detroit Lions,ATL,34,22,12,1,56,46,FALSE,1,0,DOME,11,10
1995,10,reg,Chicago Bears,Pittsburgh Steelers,CHI,34,37,3,2.5,71,42,FALSE,0,0,"",0.5,29
1995,10,reg,Cincinnati Bengals,Oakland Raiders,OAK,17,20,3,6.5,37,45,FALSE,0,0,"",3.5,8
1995,10,reg,Cleveland Browns,Houston Oilers,CLE,10,37,27,7,47,39,FALSE,0,0,"",20,8
1995,10,reg,Denver Broncos,Arizona Cardinals,DEN,38,6,32,8,44,40.5,FALSE,0,0,"",24,3.5
1995,10,reg,Indianapolis Colts,Buffalo Bills,IND,10,16,6,4,26,37.5,FALSE,1,0,DOME,2,11.5
1995,10,reg,Kansas City Chiefs,Washington Redskins,KC,24,3,21,8.5,27,43,FALSE,0,0,"",12.5,16
1995,10,reg,Minnesota Vikings,Green Bay Packers,GB,27,24,3,1,51,43.5,FALSE,1,0,DOME,2,7.5
1995,10,reg,New Orleans Saints,St. Louis Rams,NO,19,10,9,1.5,29,41.5,FALSE,1,0,DOME,7.5,12.5
1995,10,reg,New York Jets,New England Patriots,NE,7,20,13,2.5,27,38,FALSE,0,0,"",10.5,11
1995,10,reg,San Diego Chargers,Miami Dolphins,LAC,14,24,10,1.5,38,43,FALSE,0,0,"",8.5,5
1995,10,reg,San Francisco 49ers,Carolina Panthers,SF,7,13,6,14,20,40,FALSE,0,0,"",8,20
1995,10,reg,Seattle Seahawks,New York Giants,PICK,30,28,2,0,58,37.5,FALSE,1,0,DOME,2,20.5
1995,10,reg,Dallas Cowboys,Philadelphia Eagles,DAL,34,12,22,14.5,46,43.5,FALSE,0,0,"",7.5,2.5
1995,11,reg,Arizona Cardinals,Minnesota Vikings,MIN,24,30,6,2,54,40,FALSE,0,0,"",4,14
1995,11,reg,Buffalo Bills,Atlanta Falcons,BUF,23,17,6,3.5,40,39,FALSE,0,0,"",2.5,1
1995,11,reg,Dallas Cowboys,San Francisco 49ers,DAL,20,38,18,13.5,58,42,FALSE,0,0,"",4.5,16
1995,11,reg,Detroit Lions,Tampa Bay Buccaneers,DET,27,24,3,5.5,51,41,FALSE,1,0,DOME,2.5,10
1995,11,reg,Green Bay Packers,Chicago Bears,GB,35,28,7,3,63,40.5,FALSE,0,0,"",4,22.5
1995,11,reg,Houston Oilers,Cincinnati Bengals,TEN,25,32,7,3.5,57,41,FALSE,1,0,DOME,3.5,16
1995,11,reg,Jacksonville Jaguars,Seattle Seahawks,SEA,30,47,17,2,77,38,FALSE,0,0,"",15,39
1995,11,reg,Miami Dolphins,New England Patriots,MIA,17,34,17,8.5,51,42,FALSE,0,0,"",8.5,9
1995,11,reg,New Orleans Saints,Indianapolis Colts,NO,17,14,3,1.5,31,40,FALSE,1,0,DOME,1.5,9
1995,11,reg,New York Giants,Oakland Raiders,OAK,13,17,4,6.5,30,40,FALSE,0,0,"",2.5,10
1995,11,reg,Philadelphia Eagles,Denver Broncos,DEN,31,13,18,1,44,39,FALSE,0,0,"",17,5
1995,11,reg,San Diego Chargers,Kansas City Chiefs,LAC,7,22,15,1,29,38,FALSE,0,0,"",14,9
1995,11,reg,St. Louis Rams,Carolina Panthers,LAR,28,17,11,6.5,45,37.5,FALSE,1,0,DOME,4.5,7.5
1995,11,reg,Pittsburgh Steelers,Cleveland Browns,PIT,20,3,17,6,23,39,FALSE,0,0,"",11,16
1995,12,reg,Atlanta Falcons,St. Louis Rams,ATL,31,6,25,3.5,37,44,FALSE,1,0,DOME,21.5,7
1995,12,reg,Carolina Panthers,Arizona Cardinals,PICK,27,7,20,0,34,38.5,FALSE,0,0,"",20,4.5
1995,12,reg,Chicago Bears,Detroit Lions,CHI,17,24,7,3,41,43.5,FALSE,0,0,"",4,2.5
1995,12,reg,Cincinnati Bengals,Pittsburgh Steelers,PIT,31,49,18,2.5,80,42.5,FALSE,0,0,"",15.5,37.5
1995,12,reg,Cleveland Browns,Green Bay Packers,GB,20,31,11,2.5,51,41,FALSE,0,0,"",8.5,10
1995,12,reg,Denver Broncos,San Diego Chargers,DEN,30,27,3,3.5,57,40,FALSE,0,0,"",0.5,17
1995,12,reg,Kansas City Chiefs,Houston Oilers,KC,20,13,7,9.5,33,39,FALSE,0,0,"",2.5,6
1995,12,reg,Minnesota Vikings,New Orleans Saints,MIN,43,24,19,5.5,67,40.5,FALSE,1,0,DOME,13.5,26.5
1995,12,reg,New England Patriots,Indianapolis Colts,NE,10,24,14,3.5,34,37.5,FALSE,0,0,"",10.5,3.5
1995,12,reg,New York Jets,Buffalo Bills,BUF,26,28,2,6.5,54,37,FALSE,0,0,"",4.5,17
1995,12,reg,Oakland Raiders,Dallas Cowboys,DAL,21,34,13,3,55,44,FALSE,0,0,"",10,11
1995,12,reg,Philadelphia Eagles,New York Giants,PHI,28,19,9,4,47,37,FALSE,0,0,"",5,10
1995,12,reg,Tampa Bay Buccaneers,Jacksonville Jaguars,TB,17,16,1,7,33,37,FALSE,0,0,"",6,4
1995,12,reg,Washington Redskins,Seattle Seahawks,WAS,20,27,7,3.5,47,43,FALSE,0,0,"",3.5,4
1995,12,reg,Miami Dolphins,San Francisco 49ers,MIA,20,44,24,2,64,44,FALSE,0,0,"",22,20
1995,13,reg,Dallas Cowboys,Kansas City Chiefs,DAL,24,12,12,10.5,36,43,FALSE,0,0,"",1.5,7
1995,13,reg,Detroit Lions,Minnesota Vikings,DET,44,38,6,3,82,46,FALSE,1,0,DOME,3,36
1995,13,reg,Arizona Cardinals,Atlanta Falcons,ATL,40,37,3,3.5,77,42,FALSE,0,0,"",0.5,35
1995,13,reg,Buffalo Bills,New England Patriots,BUF,25,35,10,6,60,38.5,FALSE,0,0,"",4,21.5
1995,13,reg,Cleveland Browns,Pittsburgh Steelers,PIT,17,20,3,6,37,39.5,FALSE,0,0,"",3,2.5
1995,13,reg,Green Bay Packers,Tampa Bay Buccaneers,GB,35,13,22,9,48,38.5,FALSE,0,0,"",13,9.5
1995,13,reg,Houston Oilers,Denver Broncos,DEN,42,33,9,3,75,42,FALSE,1,0,DOME,6,33
1995,13,reg,Indianapolis Colts,Miami Dolphins,MIA,36,28,8,2.5,64,43,FALSE,1,0,DOME,5.5,21
1995,13,reg,Jacksonville Jaguars,Cincinnati Bengals,CIN,13,17,4,2.5,30,43,FALSE,0,0,"",1.5,13
1995,13,reg,New Orleans Saints,Carolina Panthers,NO,34,26,8,5,60,40,FALSE,1,0,DOME,3,20
1995,13,reg,New York Giants,Chicago Bears,CHI,24,27,3,2.5,51,42,FALSE,0,0,"",0.5,9
1995,13,reg,San Francisco 49ers,St. Louis Rams,SF,41,13,28,14.5,54,44,FALSE,0,0,"",13.5,10
1995,13,reg,Seattle Seahawks,New York Jets,SEA,10,16,6,7,26,41.5,FALSE,1,0,DOME,1,15.5
1995,13,reg,Washington Redskins,Philadelphia Eagles,PHI,7,14,7,3,21,43,FALSE,0,0,"",4,22
1995,13,reg,San Diego Chargers,Oakland Raiders,OAK,12,6,6,1,18,39,FALSE,0,0,"",5,21
1995,14,reg,Arizona Cardinals,New York Giants,ARI,6,10,4,1.5,16,41,FALSE,0,0,"",2.5,25
1995,14,reg,Carolina Panthers,Indianapolis Colts,IND,13,10,3,4.5,23,38.5,FALSE,0,0,"",1.5,15.5
1995,14,reg,Dallas Cowboys,Washington Redskins,DAL,17,24,7,17,41,46,FALSE,0,0,"",10,5
1995,14,reg,Denver Broncos,Jacksonville Jaguars,DEN,31,23,8,11,54,42.5,FALSE,0,0,"",3,11.5
1995,14,reg,Green Bay Packers,Cincinnati Bengals,GB,24,10,14,10.5,34,45.5,FALSE,0,0,"",3.5,11.5
1995,14,reg,Miami Dolphins,Atlanta Falcons,MIA,21,20,1,4.5,41,48,FALSE,0,0,"",3.5,7
1995,14,reg,Minnesota Vikings,Tampa Bay Buccaneers,MIN,31,17,14,8,48,43.5,FALSE,1,0,DOME,6,4.5
1995,14,reg,New England Patriots,New Orleans Saints,NE,17,31,14,4.5,48,41.5,FALSE,0,0,"",9.5,6.5
1995,14,reg,New York Jets,St. Louis Rams,LAR,20,23,3,1.5,43,38,FALSE,0,0,"",1.5,5
1995,14,reg,Oakland Raiders,Kansas City Chiefs,OAK,23,29,6,1,52,40,FALSE,0,0,"",5,12
1995,14,reg,Pittsburgh Steelers,Houston Oilers,PIT,21,7,14,8,28,42,FALSE,0,0,"",6,14
1995,14,reg,San Diego Chargers,Cleveland Browns,LAC,31,13,18,6.5,44,40,FALSE,0,0,"",11.5,4
1995,14,reg,San Francisco 49ers,Buffalo Bills,SF,27,17,10,13.5,44,46,FALSE,0,0,"",3.5,2
1995,14,reg,Seattle Seahawks,Philadelphia Eagles,PHI,26,14,12,3,40,40.5,FALSE,1,0,DOME,9,0.5
1995,14,reg,Detroit Lions,Chicago Bears,DET,27,7,20,3,34,48.5,FALSE,1,0,DOME,17,14.5
1995,15,reg,Minnesota Vikings,Cleveland Browns,MIN,27,11,16,9.5,38,44,FALSE,1,0,DOME,6.5,6
1995,15,reg,San Diego Chargers,Arizona Cardinals,LAC,28,25,3,8.5,53,39,FALSE,0,0,"",5.5,14
1995,15,reg,Atlanta Falcons,New Orleans Saints,ATL,19,14,5,5,33,47,FALSE,1,0,DOME,0,14
1995,15,reg,Carolina Panthers,San Francisco 49ers,SF,10,31,21,14.5,41,43.5,FALSE,0,0,"",6.5,2.5
1995,15,reg,Cincinnati Bengals,Chicago Bears,CHI,16,10,6,2.5,26,46.5,FALSE,0,0,"",3.5,20.5
1995,15,reg,Denver Broncos,Seattle Seahawks,DEN,27,31,4,7,58,43.5,FALSE,0,0,"",3,14.5
1995,15,reg,Houston Oilers,Detroit Lions,DET,17,24,7,2.5,41,44.5,FALSE,1,0,DOME,4.5,3.5
1995,15,reg,Jacksonville Jaguars,Indianapolis Colts,IND,31,41,10,5,72,37.5,FALSE,0,0,"",5,34.5
1995,15,reg,New England Patriots,New York Jets,NE,31,28,3,7,59,39,FALSE,0,0,"",4,20
1995,15,reg,New York Giants,Washington Redskins,NYG,20,13,7,3,33,41,FALSE,0,0,"",4,8
1995,15,reg,Oakland Raiders,Pittsburgh Steelers,OAK,10,29,19,1,39,39,FALSE,0,0,"",18,0
1995,15,reg,Philadelphia Eagles,Dallas Cowboys,DAL,20,17,3,9,37,43,FALSE,0,0,"",6,6
1995,15,reg,St. Louis Rams,Buffalo Bills,BUF,27,45,18,2.5,72,41,FALSE,1,0,DOME,15.5,31
1995,15,reg,Tampa Bay Buccaneers,Green Bay Packers,GB,13,10,3,7,23,43,FALSE,0,0,"",4,20
1995,15,reg,Miami Dolphins,Kansas City Chiefs,MIA,13,6,7,3,19,43,FALSE,0,0,"",4,24
1995,16,reg,New Orleans Saints,Green Bay Packers,GB,23,34,11,5,57,46,FALSE,1,0,DOME,6,11
1995,16,reg,Pittsburgh Steelers,New England Patriots,PIT,41,27,14,9.5,68,40,FALSE,0,0,"",4.5,28
1995,16,reg,Buffalo Bills,Miami Dolphins,BUF,23,20,3,3.5,43,40,FALSE,0,0,"",0.5,3
1995,16,reg,Carolina Panthers,Atlanta Falcons,ATL,21,17,4,4,38,41,FALSE,0,0,"",0,3
1995,16,reg,Chicago Bears,Tampa Bay Buccaneers,CHI,31,10,21,7.5,41,38.5,FALSE,0,0,"",13.5,2.5
1995,16,reg,Cleveland Browns,Cincinnati Bengals,CIN,26,10,16,2,36,39,FALSE,0,0,"",14,3
1995,16,reg,Dallas Cowboys,New York Giants,DAL,21,20,1,15,41,41.5,FALSE,0,0,"",14,0.5
1995,16,reg,Detroit Lions,Jacksonville Jaguars,DET,44,0,44,13,44,46.5,FALSE,1,0,DOME,31,2.5
1995,16,reg,Houston Oilers,New York Jets,TEN,23,6,17,5,29,40,FALSE,1,0,DOME,12,11
1995,16,reg,Indianapolis Colts,San Diego Chargers,IND,24,27,3,3,51,41,FALSE,1,0,DOME,0,10
1995,16,reg,Kansas City Chiefs,Denver Broncos,KC,20,17,3,6.5,37,40.5,FALSE,0,0,"",3.5,3.5
1995,16,reg,Philadelphia Eagles,Arizona Cardinals,PHI,21,20,1,9,41,38.5,FALSE,0,0,"",8,2.5
1995,16,reg,Seattle Seahawks,Oakland Raiders,OAK,44,10,34,2.5,54,42,FALSE,1,0,DOME,31.5,12
1995,16,reg,St. Louis Rams,Washington Redskins,LAR,23,35,12,3.5,58,43,FALSE,1,0,DOME,8.5,15
1995,16,reg,San Francisco 49ers,Minnesota Vikings,SF,37,30,7,13.5,67,48,FALSE,0,0,"",6.5,19
1995,17,reg,Indianapolis Colts,New England Patriots,IND,10,7,3,6,17,42.5,FALSE,1,0,DOME,3,25.5
1995,17,reg,New York Giants,San Diego Chargers,LAC,17,27,10,4.5,44,38.5,FALSE,0,0,"",5.5,5.5
1995,17,reg,Tampa Bay Buccaneers,Detroit Lions,DET,10,37,27,7,47,42,FALSE,0,0,"",20,5
1995,17,reg,Atlanta Falcons,San Francisco 49ers,SF,28,27,1,10,55,49,FALSE,1,0,DOME,9,6
1995,17,reg,Buffalo Bills,Houston Oilers,BUF,17,28,11,4.5,45,37,FALSE,0,0,"",6.5,8
1995,17,reg,Chicago Bears,Philadelphia Eagles,CHI,20,14,6,3,34,40.5,FALSE,0,0,"",3,6.5
1995,17,reg,Cincinnati Bengals,Minnesota Vikings,MIN,27,24,3,5,51,44,FALSE,0,0,"",2,7
1995,17,reg,Green Bay Packers,Pittsburgh Steelers,GB,24,19,5,3.5,43,42,FALSE,0,0,"",1.5,1
1995,17,reg,Jacksonville Jaguars,Cleveland Browns,CLE,24,21,3,4,45,39.5,FALSE,0,0,"",1,5.5
1995,17,reg,Kansas City Chiefs,Seattle Seahawks,KC,26,3,23,6.5,29,40,FALSE,0,0,"",16.5,11
1995,17,reg,New York Jets,New Orleans Saints,NO,0,12,12,2.5,12,39.5,FALSE,0,0,"",9.5,27.5
1995,17,reg,Oakland Raiders,Denver Broncos,OAK,28,31,3,5,59,41,FALSE,0,0,"",2,18
1995,17,reg,St. Louis Rams,Miami Dolphins,MIA,22,41,19,6,63,45,FALSE,1,0,DOME,13,18
1995,17,reg,Washington Redskins,Carolina Panthers,WAS,20,17,3,4.5,37,40.5,FALSE,0,0,"",1.5,3.5
1995,17,reg,Arizona Cardinals,Dallas Cowboys,DAL,13,37,24,8.5,50,41.5,FALSE,0,0,"",15.5,8.5
1995,Wildcard,post,Buffalo Bills,Miami Dolphins,BUF,37,22,15,3.5,59,42.5,FALSE,0,0,"",11.5,16.5
1995,Wildcard,post,Philadelphia Eagles,Detroit Lions,DET,58,37,21,3,95,42,FALSE,0,0,"",18,53
1995,Wildcard,post,Green Bay Packers,Atlanta Falcons,GB,37,20,17,9.5,57,44,FALSE,0,0,"",7.5,13
1995,Wildcard,post,San Diego Chargers,Indianapolis Colts,LAC,20,35,15,5.5,55,40,FALSE,0,0,"",9.5,15
1995,Division,post,Pittsburgh Steelers,Buffalo Bills,PIT,40,21,19,6,61,42,FALSE,0,0,"",13,19
1995,Division,post,San Francisco 49ers,Green Bay Packers,SF,17,27,10,9.5,44,52,FALSE,0,0,"",0.5,8
1995,Division,post,Dallas Cowboys,Philadelphia Eagles,DAL,30,11,19,13.5,41,45.5,FALSE,0,0,"",5.5,4.5
1995,Division,post,Kansas City Chiefs,Indianapolis Colts,KC,7,10,3,8,17,41.5,FALSE,0,0,"",5,24.5
1995,Conference,post,Dallas Cowboys,Green Bay Packers,DAL,38,27,11,9,65,50.5,FALSE,0,0,"",2,14.5
1995,Conference,post,Pittsburgh Steelers,Indianapolis Colts,PIT,20,16,4,11,36,43,FALSE,0,0,"",7,7
1995,Superbowl,post,Dallas Cowboys,Pittsburgh Steelers,DAL,27,17,10,13.5,44,51,TRUE,0,0,"",3.5,7
1996,1,reg,Baltimore Ravens,Oakland Raiders,BAL,19,14,5,1,33,40,FALSE,0,0,"",4,7
1996,1,reg,Carolina Panthers,Atlanta Falcons,ATL,29,6,23,3,35,41,FALSE,0,0,"",20,6
1996,1,reg,Denver Broncos,New York Jets,DEN,31,6,25,8,37,42,FALSE,0,0,"",17,5
1996,1,reg,Houston Oilers,Kansas City Chiefs,KC,19,20,1,4,39,38,FALSE,1,0,DOME,3,1
1996,1,reg,Indianapolis Colts,Arizona Cardinals,IND,20,13,7,8.5,33,38,FALSE,1,0,DOME,1.5,5
1996,1,reg,Jacksonville Jaguars,Pittsburgh Steelers,PIT,24,9,15,4.5,33,38,FALSE,0,0,"",10.5,5
1996,1,reg,Miami Dolphins,New England Patriots,MIA,24,10,14,3,34,43.5,FALSE,0,0,"",11,9.5
1996,1,reg,Minnesota Vikings,Detroit Lions,MIN,17,13,4,2.5,30,46,FALSE,1,0,DOME,1.5,16
1996,1,reg,New York Giants,Buffalo Bills,BUF,20,23,3,3.5,43,39.5,FALSE,0,0,"",0.5,3.5
1996,1,reg,San Diego Chargers,Seattle Seahawks,LAC,29,7,22,4.5,36,39,FALSE,0,0,"",17.5,3
1996,1,reg,San Francisco 49ers,New Orleans Saints,SF,27,11,16,12,38,45,FALSE,0,0,"",4,7
1996,1,reg,St. Louis Rams,Cincinnati Bengals,LAR,26,16,10,3,42,44,FALSE,1,0,DOME,7,2
1996,1,reg,Tampa Bay Buccaneers,Green Bay Packers,GB,3,34,31,6,37,39.5,FALSE,0,0,"",25,2.5
1996,1,reg,Washington Redskins,Philadelphia Eagles,WAS,14,17,3,1.5,31,40.5,FALSE,0,0,"",1.5,9.5
1996,1,reg,Chicago Bears,Dallas Cowboys,DAL,22,6,16,2.5,28,43,FALSE,0,0,"",13.5,15
1996,2,reg,Arizona Cardinals,Miami Dolphins,MIA,10,38,28,6,48,39,FALSE,0,0,"",22,9
1996,2,reg,Atlanta Falcons,Minnesota Vikings,ATL,17,23,6,4,40,46,FALSE,1,0,DOME,2,6
1996,2,reg,Buffalo Bills,New England Patriots,BUF,17,10,7,4.5,27,41.5,FALSE,0,0,"",2.5,14.5
1996,2,reg,Dallas Cowboys,New York Giants,DAL,27,0,27,10,27,38,FALSE,0,0,"",17,11
1996,2,reg,Detroit Lions,Tampa Bay Buccaneers,DET,21,6,15,11,27,42,FALSE,1,0,DOME,4,15
1996,2,reg,Jacksonville Jaguars,Houston Oilers,JAX,27,34,7,2.5,61,39,FALSE,0,0,"",4.5,22
1996,2,reg,Kansas City Chiefs,Oakland Raiders,KC,19,3,16,6.5,22,38,FALSE,0,0,"",9.5,16
1996,2,reg,New Orleans Saints,Carolina Panthers,NO,20,22,2,3,42,40.5,FALSE,1,0,DOME,1,1.5
1996,2,reg,New York Jets,Indianapolis Colts,IND,7,21,14,4.5,28,38,FALSE,0,0,"",9.5,10
1996,2,reg,Pittsburgh Steelers,Baltimore Ravens,PIT,31,17,14,4,48,37.5,FALSE,0,0,"",10,10.5
1996,2,reg,San Diego Chargers,Cincinnati Bengals,LAC,27,14,13,6.5,41,41,FALSE,0,0,"",6.5,0
1996,2,reg,San Francisco 49ers,St. Louis Rams,SF,34,0,34,12.5,34,44,FALSE,0,0,"",21.5,10
1996,2,reg,Seattle Seahawks,Denver Broncos,DEN,20,30,10,2,50,41.5,FALSE,1,0,DOME,8,8.5
1996,2,reg,Washington Redskins,Chicago Bears,PICK,10,3,7,0,13,43.5,FALSE,0,0,"",7,30.5
1996,2,reg,Green Bay Packers,Philadelphia Eagles,GB,39,13,26,7.5,52,40,FALSE,0,0,"",18.5,12
1996,3,reg,Chicago Bears,Minnesota Vikings,CHI,14,20,6,3.5,34,42.5,FALSE,0,0,"",2.5,8.5
1996,3,reg,Cincinnati Bengals,New Orleans Saints,CIN,30,15,15,3,45,42.5,FALSE,0,0,"",12,2.5
1996,3,reg,Dallas Cowboys,Indianapolis Colts,DAL,24,25,1,9.5,49,38.5,FALSE,0,0,"",8.5,10.5
1996,3,reg,Denver Broncos,Tampa Bay Buccaneers,DEN,27,23,4,13,50,40.5,FALSE,0,0,"",9,9.5
1996,3,reg,Green Bay Packers,San Diego Chargers,GB,42,10,32,8.5,52,44,FALSE,0,0,"",23.5,8
1996,3,reg,Houston Oilers,Baltimore Ravens,TEN,29,13,16,3.5,42,40,FALSE,1,0,DOME,12.5,2
1996,3,reg,Miami Dolphins,New York Jets,MIA,36,27,9,12.5,63,39.5,FALSE,0,0,"",3.5,23.5
1996,3,reg,New England Patriots,Arizona Cardinals,NE,31,0,31,10,31,39.5,FALSE,0,0,"",21,8.5
1996,3,reg,New York Giants,Washington Redskins,WAS,10,31,21,1,41,38.5,FALSE,0,0,"",20,2.5
1996,3,reg,Oakland Raiders,Jacksonville Jaguars,OAK,17,3,14,6.5,20,39,FALSE,0,0,"",7.5,19
1996,3,reg,Philadelphia Eagles,Detroit Lions,PHI,24,17,7,1.5,41,42.5,FALSE,0,0,"",5.5,1.5
1996,3,reg,Seattle Seahawks,Kansas City Chiefs,KC,17,35,18,3.5,52,38.5,FALSE,1,0,DOME,14.5,13.5
1996,3,reg,Pittsburgh Steelers,Buffalo Bills,PIT,24,6,18,2,30,40,FALSE,0,0,"",16,10
1996,4,reg,Atlanta Falcons,Philadelphia Eagles,ATL,18,33,15,2,51,43,FALSE,1,0,DOME,13,8
1996,4,reg,Buffalo Bills,Dallas Cowboys,DAL,10,7,3,2.5,17,42,FALSE,0,0,"",0.5,25
1996,4,reg,Carolina Panthers,San Francisco 49ers,SF,23,7,16,9,30,42,FALSE,0,0,"",7,12
1996,4,reg,Detroit Lions,Chicago Bears,DET,35,16,19,4.5,51,42,FALSE,1,0,DOME,14.5,9
1996,4,reg,Kansas City Chiefs,Denver Broncos,KC,17,14,3,5,31,40.5,FALSE,0,0,"",2,9.5
1996,4,reg,Minnesota Vikings,Green Bay Packers,GB,30,21,9,6.5,51,44.5,FALSE,1,0,DOME,2.5,6.5
1996,4,reg,New England Patriots,Jacksonville Jaguars,NE,28,25,3,8,53,39,FALSE,0,0,"",5,14
1996,4,reg,New Orleans Saints,Arizona Cardinals,NO,14,28,14,7.5,42,39,FALSE,1,0,DOME,6.5,3
1996,4,reg,New York Jets,New York Giants,NYJ,6,13,7,2,19,37,FALSE,0,0,"",5,18
1996,4,reg,Oakland Raiders,San Diego Chargers,OAK,34,40,6,3,74,38.5,FALSE,0,0,"",3,35.5
1996,4,reg,St. Louis Rams,Washington Redskins,LAR,10,17,7,2,27,40.5,FALSE,1,0,DOME,5,13.5
1996,4,reg,Tampa Bay Buccaneers,Seattle Seahawks,SEA,13,17,4,2,30,38,FALSE,0,0,"",2,8
1996,4,reg,Indianapolis Colts,Miami Dolphins,IND,10,6,4,2.5,16,42,FALSE,1,0,DOME,1.5,26
1996,5,reg,Arizona Cardinals,St. Louis Rams,ARI,31,28,3,1,59,38.5,FALSE,0,0,"",2,20.5
1996,5,reg,Baltimore Ravens,New Orleans Saints,BAL,17,10,7,6,27,41,FALSE,0,0,"",1,14
1996,5,reg,Chicago Bears,Oakland Raiders,CHI,19,17,2,2,36,38,FALSE,0,0,"",0,2
1996,5,reg,Cincinnati Bengals,Denver Broncos,DEN,10,14,4,3,24,43,FALSE,0,0,"",1,19
1996,5,reg,Jacksonville Jaguars,Carolina Panthers,CAR,24,14,10,2.5,38,39,FALSE,0,0,"",7.5,1
1996,5,reg,New York Giants,Minnesota Vikings,MIN,15,10,5,5.5,25,38,FALSE,0,0,"",0.5,13
1996,5,reg,Pittsburgh Steelers,Houston Oilers,PIT,30,16,14,5.5,46,39,FALSE,0,0,"",8.5,7
1996,5,reg,San Diego Chargers,Kansas City Chiefs,LAC,22,19,3,2,41,38.5,FALSE,0,0,"",1,2.5
1996,5,reg,San Francisco 49ers,Atlanta Falcons,SF,39,17,22,13,56,43,FALSE,0,0,"",9,13
1996,5,reg,Seattle Seahawks,Green Bay Packers,GB,10,31,21,9.5,41,43,FALSE,1,0,DOME,11.5,2
1996,5,reg,Tampa Bay Buccaneers,Detroit Lions,DET,0,27,27,6.5,27,40,FALSE,0,0,"",20.5,13
1996,5,reg,Washington Redskins,New York Jets,WAS,31,16,15,8.5,47,38.5,FALSE,0,0,"",6.5,8.5
1996,5,reg,Philadelphia Eagles,Dallas Cowboys,PHI,19,23,4,2.5,42,38,FALSE,0,0,"",1.5,4
1996,6,reg,Baltimore Ravens,New England Patriots,NE,38,46,8,2,84,39,FALSE,0,0,"",6,45
1996,6,reg,Buffalo Bills,Indianapolis Colts,BUF,16,13,3,3.5,29,38,FALSE,0,0,"",0.5,9
1996,6,reg,Chicago Bears,Green Bay Packers,GB,6,37,31,7.5,43,42,FALSE,0,0,"",23.5,1
1996,6,reg,Cincinnati Bengals,Houston Oilers,CIN,27,30,3,1,57,42,FALSE,0,0,"",2,15
1996,6,reg,Denver Broncos,San Diego Chargers,DEN,28,17,11,3.5,45,42,FALSE,0,0,"",7.5,3
1996,6,reg,Detroit Lions,Atlanta Falcons,DET,28,24,4,10,52,44,FALSE,1,0,DOME,6,8
1996,6,reg,Miami Dolphins,Seattle Seahawks,MIA,15,22,7,7.5,37,39,FALSE,0,0,"",0.5,2
1996,6,reg,Minnesota Vikings,Carolina Panthers,MIN,14,12,2,6,26,39.5,FALSE,1,0,DOME,4,13.5
1996,6,reg,New Orleans Saints,Jacksonville Jaguars,NO,17,13,4,2,30,40.5,FALSE,1,0,DOME,2,10.5
1996,6,reg,New York Jets,Oakland Raiders,OAK,13,34,21,3.5,47,38,FALSE,0,0,"",17.5,9
1996,6,reg,St. Louis Rams,San Francisco 49ers,SF,11,28,17,10.5,39,43,FALSE,1,0,DOME,6.5,4
1996,6,reg,Kansas City Chiefs,Pittsburgh Steelers,KC,7,17,10,4,24,38,FALSE,0,0,"",6,14
1996,7,reg,Atlanta Falcons,Houston Oilers,ATL,13,23,10,1.5,36,44.5,FALSE,1,0,DOME,8.5,8.5
1996,7,reg,Buffalo Bills,Miami Dolphins,BUF,7,21,14,6.5,28,36.5,FALSE,0,0,"",7.5,8.5
1996,7,reg,Carolina Panthers,St. Louis Rams,CAR,45,13,32,7,58,38.5,FALSE,0,0,"",25,19.5
1996,7,reg,Dallas Cowboys,Arizona Cardinals,DAL,17,3,14,14.5,20,41,FALSE,0,0,"",0.5,21
1996,7,reg,Indianapolis Colts,Baltimore Ravens,IND,26,21,5,9,47,39,FALSE,1,0,DOME,4,8
1996,7,reg,Jacksonville Jaguars,New York Jets,JAX,21,17,4,7.5,38,38.5,FALSE,0,0,"",3.5,0.5
1996,7,reg,New England Patriots,Washington Redskins,NE,22,27,5,4.5,49,41,FALSE,0,0,"",0.5,8
1996,7,reg,New Orleans Saints,Chicago Bears,NO,27,24,3,1,51,40,FALSE,1,0,DOME,2,11
1996,7,reg,New York Giants,Philadelphia Eagles,PHI,10,19,9,3,29,36.5,FALSE,0,0,"",6,7.5
1996,7,reg,Oakland Raiders,Detroit Lions,OAK,37,21,16,1,58,41.5,FALSE,0,0,"",15,16.5
1996,7,reg,Pittsburgh Steelers,Cincinnati Bengals,PIT,20,10,10,10,30,41,FALSE,0,0,"",0,11
1996,7,reg,Tampa Bay Buccaneers,Minnesota Vikings,MIN,24,13,11,6.5,37,37.5,FALSE,0,0,"",4.5,0.5
1996,7,reg,Green Bay Packers,San Francisco 49ers,GB,23,20,3,5.5,43,45.5,FALSE,0,0,"",2.5,2.5
1996,8,reg,Kansas City Chiefs,Seattle Seahawks,KC,34,16,18,9,50,39,FALSE,0,0,"",9,11
1996,8,reg,Arizona Cardinals,Tampa Bay Buccaneers,ARI,13,9,4,3,22,36,FALSE,0,0,"",1,14
1996,8,reg,Carolina Panthers,New Orleans Saints,CAR,19,7,12,7,26,39.5,FALSE,0,0,"",5,13.5
1996,8,reg,Dallas Cowboys,Atlanta Falcons,DAL,32,28,4,15,60,43,FALSE,0,0,"",11,17
1996,8,reg,Denver Broncos,Baltimore Ravens,DEN,45,34,11,11,79,44,FALSE,0,0,"",0,35
1996,8,reg,Houston Oilers,Pittsburgh Steelers,PIT,23,13,10,1,36,39,FALSE,1,0,DOME,9,3
1996,8,reg,Indianapolis Colts,New England Patriots,IND,9,27,18,3.5,36,41.5,FALSE,1,0,DOME,14.5,5.5
1996,8,reg,New York Jets,Buffalo Bills,BUF,22,25,3,7,47,37.5,FALSE,0,0,"",4,9.5
1996,8,reg,Philadelphia Eagles,Miami Dolphins,PHI,35,28,7,2.5,63,37,FALSE,0,0,"",4.5,26
1996,8,reg,San Francisco 49ers,Cincinnati Bengals,SF,28,21,7,14.5,49,43,FALSE,0,0,"",7.5,6
1996,8,reg,St. Louis Rams,Jacksonville Jaguars,PICK,17,14,3,0,31,40,FALSE,1,0,DOME,3,9
1996,8,reg,Washington Redskins,New York Giants,WAS,31,21,10,7.5,52,37.5,FALSE,0,0,"",2.5,14.5
1996,8,reg,San Diego Chargers,Oakland Raiders,LAC,14,23,9,3.5,37,41,FALSE,0,0,"",5.5,4
1996,9,reg,Arizona Cardinals,New York Jets,ARI,21,31,10,4.5,52,36.5,FALSE,0,0,"",5.5,15.5
1996,9,reg,Atlanta Falcons,Pittsburgh Steelers,PIT,17,20,3,6,37,41,FALSE,1,0,DOME,3,4
1996,9,reg,Baltimore Ravens,St. Louis Rams,BAL,37,31,6,6,68,43,FALSE,0,0,"",0,25
1996,9,reg,Cincinnati Bengals,Jacksonville Jaguars,CIN,28,21,7,2.5,49,41,FALSE,0,0,"",4.5,8
1996,9,reg,Denver Broncos,Kansas City Chiefs,DEN,34,7,27,3,41,41.5,FALSE,0,0,"",24,0.5
1996,9,reg,Detroit Lions,New York Giants,DET,7,35,28,10,42,41,FALSE,1,0,DOME,18,1
1996,9,reg,Green Bay Packers,Tampa Bay Buccaneers,GB,13,7,6,17.5,20,42,FALSE,0,0,"",11.5,22
1996,9,reg,Houston Oilers,San Francisco 49ers,SF,9,10,1,6,19,41,FALSE,1,0,DOME,5,22
1996,9,reg,Miami Dolphins,Dallas Cowboys,DAL,10,29,19,3,39,41,FALSE,0,0,"",16,2
1996,9,reg,New England Patriots,Buffalo Bills,NE,28,25,3,4,53,39.5,FALSE,0,0,"",1,13.5
1996,9,reg,Philadelphia Eagles,Carolina Panthers,PHI,20,9,11,4,29,37.5,FALSE,0,0,"",7,8.5
1996,9,reg,Seattle Seahawks,San Diego Chargers,LAC,32,13,19,3.5,45,42,FALSE,1,0,DOME,15.5,3
1996,9,reg,Washington Redskins,Indianapolis Colts,WAS,31,16,15,3,47,39,FALSE,0,0,"",12,8
1996,9,reg,Minnesota Vikings,Chicago Bears,MIN,13,15,2,6.5,28,39.5,FALSE,1,0,DOME,4.5,11.5
1996,10,reg,Atlanta Falcons,Carolina Panthers,CAR,20,17,3,1.5,37,41.5,FALSE,1,0,DOME,1.5,4.5
1996,10,reg,Baltimore Ravens,Cincinnati Bengals,BAL,21,24,3,3.5,45,45,FALSE,0,0,"",0.5,0
1996,10,reg,Buffalo Bills,Washington Redskins,BUF,38,13,25,3,51,39.5,FALSE,0,0,"",22,11.5
1996,10,reg,Chicago Bears,Tampa Bay Buccaneers,CHI,13,10,3,6.5,23,36,FALSE,0,0,"",3.5,13
1996,10,reg,Dallas Cowboys,Philadelphia Eagles,DAL,21,31,10,8.5,52,40.5,FALSE,0,0,"",1.5,11.5
1996,10,reg,Green Bay Packers,Detroit Lions,GB,28,18,10,11,46,44,FALSE,0,0,"",1,2
1996,10,reg,Indianapolis Colts,San Diego Chargers,IND,19,26,7,6,45,41,FALSE,1,0,DOME,1,4
1996,10,reg,Minnesota Vikings,Kansas City Chiefs,KC,6,21,15,1.5,27,38,FALSE,1,0,DOME,13.5,11
1996,10,reg,New England Patriots,Miami Dolphins,NE,42,23,19,4,65,43,FALSE,0,0,"",15,22
1996,10,reg,New Orleans Saints,San Francisco 49ers,SF,17,24,7,8.5,41,41,FALSE,1,0,DOME,1.5,0
1996,10,reg,New York Giants,Arizona Cardinals,NYG,16,8,8,5.5,24,37,FALSE,0,0,"",2.5,13
1996,10,reg,Pittsburgh Steelers,St. Louis Rams,PIT,42,6,36,13,48,40,FALSE,0,0,"",23,8
1996,10,reg,Seattle Seahawks,Houston Oilers,PICK,23,16,7,0,39,40.5,FALSE,1,0,DOME,7,1.5
1996,10,reg,Oakland Raiders,Denver Broncos,OAK,21,22,1,2,43,44.5,FALSE,0,0,"",1,1.5
1996,11,reg,Carolina Panthers,New York Giants,CAR,27,17,10,4.5,44,36,FALSE,0,0,"",5.5,8
1996,11,reg,Cincinnati Bengals,Pittsburgh Steelers,PIT,34,24,10,4,58,41.5,FALSE,0,0,"",6,16.5
1996,11,reg,Denver Broncos,Chicago Bears,DEN,17,12,5,10.5,29,42,FALSE,0,0,"",5.5,13
1996,11,reg,Jacksonville Jaguars,Baltimore Ravens,JAX,30,27,3,3.5,57,44.5,FALSE,0,0,"",0.5,12.5
1996,11,reg,Kansas City Chiefs,Green Bay Packers,GB,27,20,7,3,47,41,FALSE,0,0,"",4,6
1996,11,reg,Miami Dolphins,Indianapolis Colts,MIA,37,13,24,3.5,50,41.5,FALSE,0,0,"",20.5,8.5
1996,11,reg,New Orleans Saints,Houston Oilers,TEN,14,31,17,3.5,45,40.5,FALSE,1,0,DOME,13.5,4.5
1996,11,reg,New York Jets,New England Patriots,NE,27,31,4,6.5,58,42,FALSE,0,0,"",2.5,16
1996,11,reg,Philadelphia Eagles,Buffalo Bills,PHI,17,24,7,3.5,41,39,FALSE,0,0,"",3.5,2
1996,11,reg,San Francisco 49ers,Dallas Cowboys,SF,17,20,3,3.5,37,42.5,FALSE,0,0,"",0.5,5.5
1996,11,reg,Seattle Seahawks,Minnesota Vikings,SEA,42,23,19,2,65,39,FALSE,1,0,DOME,17,26
1996,11,reg,St. Louis Rams,Atlanta Falcons,ATL,59,16,43,1.5,75,42.5,FALSE,1,0,DOME,41.5,32.5
1996,11,reg,Tampa Bay Buccaneers,Oakland Raiders,OAK,20,17,3,5.5,37,37,FALSE,0,0,"",2.5,0
1996,11,reg,Washington Redskins,Arizona Cardinals,WAS,34,37,3,10.5,71,40,FALSE,0,0,"",7.5,31
1996,11,reg,San Diego Chargers,Detroit Lions,LAC,27,21,6,3.5,48,44,FALSE,0,0,"",2.5,4
1996,12,reg,Arizona Cardinals,New York Giants,ARI,31,23,8,1.5,54,36,FALSE,0,0,"",6.5,18
1996,12,reg,Atlanta Falcons,New Orleans Saints,ATL,17,15,2,4,32,44,FALSE,1,0,DOME,2,12
1996,12,reg,Buffalo Bills,Cincinnati Bengals,BUF,31,17,14,7,48,42,FALSE,0,0,"",7,6
1996,12,reg,Detroit Lions,Seattle Seahawks,DET,17,16,1,4.5,33,45,FALSE,1,0,DOME,3.5,12
1996,12,reg,Houston Oilers,Miami Dolphins,TEN,20,23,3,3.5,43,42,FALSE,1,0,DOME,0.5,1
1996,12,reg,Indianapolis Colts,New York Jets,IND,34,29,5,6,63,40,FALSE,1,0,DOME,1,23
1996,12,reg,Kansas City Chiefs,Chicago Bears,KC,14,10,4,8.5,24,36,FALSE,0,0,"",4.5,12
1996,12,reg,New England Patriots,Denver Broncos,NE,8,34,26,2.5,42,45.5,FALSE,0,0,"",23.5,3.5
1996,12,reg,Oakland Raiders,Minnesota Vikings,OAK,13,16,3,6.5,29,41,FALSE,0,0,"",3.5,12
1996,12,reg,Philadelphia Eagles,Washington Redskins,PHI,21,26,5,6,47,41,FALSE,0,0,"",1,6
1996,12,reg,Pittsburgh Steelers,Jacksonville Jaguars,PIT,28,3,25,11,31,41,FALSE,0,0,"",14,10
1996,12,reg,San Diego Chargers,Tampa Bay Buccaneers,LAC,17,25,8,7,42,37.5,FALSE,0,0,"",1,4.5
1996,12,reg,San Francisco 49ers,Baltimore Ravens,SF,38,20,18,12,58,45,FALSE,0,0,"",6,13
1996,12,reg,St. Louis Rams,Carolina Panthers,CAR,10,20,10,3,30,41,FALSE,1,0,DOME,7,11
1996,12,reg,Dallas Cowboys,Green Bay Packers,DAL,21,6,15,4,27,43,FALSE,0,0,"",11,16
1996,13,reg,Arizona Cardinals,Philadelphia Eagles,PHI,36,30,6,3.5,66,41,FALSE,0,0,"",2.5,25
1996,13,reg,Baltimore Ravens,Jacksonville Jaguars,BAL,25,28,3,4,53,46,FALSE,0,0,"",1,7
1996,13,reg,Buffalo Bills,New York Jets,BUF,35,10,25,9.5,45,42,FALSE,0,0,"",15.5,3
1996,13,reg,Chicago Bears,Detroit Lions,CHI,31,14,17,3,45,39,FALSE,0,0,"",14,6
1996,13,reg,Cincinnati Bengals,Atlanta Falcons,CIN,41,31,10,6,72,44,FALSE,0,0,"",4,28
1996,13,reg,Houston Oilers,Carolina Panthers,TEN,6,31,25,4.5,37,39.5,FALSE,1,0,DOME,20.5,2.5
1996,13,reg,Kansas City Chiefs,San Diego Chargers,KC,14,28,14,5.5,42,39,FALSE,0,0,"",8.5,3
1996,13,reg,Minnesota Vikings,Denver Broncos,DEN,17,21,4,5.5,38,43,FALSE,1,0,DOME,1.5,5
1996,13,reg,New England Patriots,Indianapolis Colts,NE,27,13,14,6,40,44,FALSE,0,0,"",8,4
1996,13,reg,New York Giants,Dallas Cowboys,DAL,20,6,14,9,26,38,FALSE,0,0,"",5,12
1996,13,reg,Seattle Seahawks,Oakland Raiders,SEA,21,27,6,2,48,41,FALSE,1,0,DOME,4,7
1996,13,reg,St. Louis Rams,Green Bay Packers,GB,9,24,15,9.5,33,43,FALSE,1,0,DOME,5.5,10
1996,13,reg,Tampa Bay Buccaneers,New Orleans Saints,TB,13,7,6,5.5,20,38,FALSE,0,0,"",0.5,18
1996,13,reg,Washington Redskins,San Francisco 49ers,SF,16,19,3,3.5,35,44,FALSE,0,0,"",0.5,9
1996,13,reg,Miami Dolphins,Pittsburgh Steelers,MIA,17,24,7,2.5,41,42,FALSE,0,0,"",4.5,1
1996,14,reg,Dallas Cowboys,Washington Redskins,DAL,21,10,11,9,31,43.5,FALSE,0,0,"",2,12.5
1996,14,reg,Detroit Lions,Kansas City Chiefs,KC,24,28,4,2,52,42,FALSE,1,0,DOME,2,10
1996,14,reg,Baltimore Ravens,Pittsburgh Steelers,PIT,31,17,14,6.5,48,43,FALSE,0,0,"",7.5,5
1996,14,reg,Carolina Panthers,Tampa Bay Buccaneers,CAR,24,0,24,6,24,36.5,FALSE,0,0,"",18,12.5
1996,14,reg,Denver Broncos,Seattle Seahawks,DEN,34,7,27,10.5,41,43,FALSE,0,0,"",16.5,2
1996,14,reg,Green Bay Packers,Chicago Bears,GB,28,17,11,10,45,39.5,FALSE,0,0,"",1,5.5
1996,14,reg,Indianapolis Colts,Buffalo Bills,BUF,13,10,3,3,23,38,FALSE,1,0,DOME,0,15
1996,14,reg,Jacksonville Jaguars,Cincinnati Bengals,JAX,30,27,3,3,57,45,FALSE,0,0,"",0,12
1996,14,reg,Minnesota Vikings,Arizona Cardinals,MIN,41,17,24,4.5,58,42,FALSE,1,0,DOME,19.5,16
1996,14,reg,New Orleans Saints,St. Louis Rams,NO,10,26,16,3,36,42,FALSE,1,0,DOME,13,6
1996,14,reg,New York Jets,Houston Oilers,TEN,10,35,25,3,45,41,FALSE,0,0,"",22,4
1996,14,reg,Oakland Raiders,Miami Dolphins,OAK,17,7,10,2,24,43.5,FALSE,0,0,"",8,19.5
1996,14,reg,Philadelphia Eagles,New York Giants,PHI,24,0,24,6.5,24,39.5,FALSE,0,0,"",17.5,15.5
1996,14,reg,San Diego Chargers,New England Patriots,LAC,7,45,38,2,52,45,FALSE,0,0,"",36,7
1996,14,reg,Atlanta Falcons,San Francisco 49ers,SF,10,34,24,9.5,44,44,FALSE,1,0,DOME,14.5,0
1996,15,reg,Indianapolis Colts,Philadelphia Eagles,PHI,37,10,27,4,47,38,FALSE,1,0,DOME,23,9
1996,15,reg,Arizona Cardinals,Dallas Cowboys,DAL,6,10,4,10,16,42.5,FALSE,0,0,"",6,26.5
1996,15,reg,Chicago Bears,St. Louis Rams,CHI,35,9,26,6.5,44,37,FALSE,0,0,"",19.5,7
1996,15,reg,Cincinnati Bengals,Baltimore Ravens,CIN,21,14,7,3,35,47,FALSE,0,0,"",4,12
1996,15,reg,Detroit Lions,Minnesota Vikings,DET,22,24,2,2.5,46,44,FALSE,1,0,DOME,0.5,2
1996,15,reg,Green Bay Packers,Denver Broncos,GB,41,6,35,9,47,39,FALSE,0,0,"",26,8
1996,15,reg,Houston Oilers,Jacksonville Jaguars,TEN,17,23,6,6,40,42.5,FALSE,1,0,DOME,0,2.5
1996,15,reg,Miami Dolphins,New York Giants,MIA,7,17,10,7,24,38.5,FALSE,0,0,"",3,14.5
1996,15,reg,New England Patriots,New York Jets,NE,34,10,24,13,44,43.5,FALSE,0,0,"",11,0.5
1996,15,reg,New Orleans Saints,Atlanta Falcons,NO,15,31,16,2,46,41,FALSE,1,0,DOME,14,5
1996,15,reg,Pittsburgh Steelers,San Diego Chargers,PIT,16,3,13,9.5,19,40,FALSE,0,0,"",3.5,21
1996,15,reg,San Francisco 49ers,Carolina Panthers,SF,24,30,6,9,54,40,FALSE,0,0,"",3,14
1996,15,reg,Seattle Seahawks,Buffalo Bills,BUF,26,18,8,4,44,41.5,FALSE,1,0,DOME,4,2.5
1996,15,reg,Tampa Bay Buccaneers,Washington Redskins,WAS,24,10,14,3,34,38,FALSE,0,0,"",11,4
1996,15,reg,Oakland Raiders,Kansas City Chiefs,OAK,26,7,19,2,33,40,FALSE,0,0,"",17,7
1996,16,reg,Chicago Bears,San Diego Chargers,CHI,27,14,13,3,41,36.5,FALSE,0,0,"",10,4.5
1996,16,reg,New York Jets,Philadelphia Eagles,PHI,20,21,1,7,41,39,FALSE,0,0,"",6,2
1996,16,reg,Arizona Cardinals,Washington Redskins,WAS,27,26,1,3,53,40.5,FALSE,0,0,"",2,12.5
1996,16,reg,Atlanta Falcons,St. Louis Rams,ATL,27,34,7,5.5,61,44,FALSE,1,0,DOME,1.5,17
1996,16,reg,Carolina Panthers,Baltimore Ravens,CAR,27,16,11,7.5,43,43,FALSE,0,0,"",3.5,0
1996,16,reg,Dallas Cowboys,New England Patriots,DAL,12,6,6,5.5,18,43.5,FALSE,0,0,"",0.5,25.5
1996,16,reg,Denver Broncos,Oakland Raiders,DEN,24,19,5,7,43,41,FALSE,0,0,"",2,2
1996,16,reg,Detroit Lions,Green Bay Packers,GB,3,31,28,8,34,47,FALSE,1,0,DOME,20,13
1996,16,reg,Houston Oilers,Cincinnati Bengals,TEN,13,21,8,4,34,44,FALSE,1,0,DOME,4,10
1996,16,reg,Jacksonville Jaguars,Seattle Seahawks,JAX,20,13,7,5,33,43,FALSE,0,0,"",2,10
1996,16,reg,Kansas City Chiefs,Indianapolis Colts,KC,19,24,5,7,43,37,FALSE,0,0,"",2,6
1996,16,reg,Minnesota Vikings,Tampa Bay Buccaneers,MIN,21,10,11,6,31,36.5,FALSE,1,0,DOME,5,5.5
1996,16,reg,New York Giants,New Orleans Saints,NYG,3,17,14,7,20,36,FALSE,0,0,"",7,16
1996,16,reg,Pittsburgh Steelers,San Francisco 49ers,SF,15,25,10,2.5,40,39,FALSE,0,0,"",7.5,1
1996,16,reg,Miami Dolphins,Buffalo Bills,BUF,16,14,2,1,30,41.5,FALSE,0,0,"",1,11.5
1996,17,reg,New York Giants,New England Patriots,NE,22,23,1,8.5,45,39.5,FALSE,0,0,"",7.5,5.5
1996,17,reg,St. Louis Rams,New Orleans Saints,LAR,14,13,1,5,27,42,FALSE,1,0,DOME,4,15
1996,17,reg,Baltimore Ravens,Houston Oilers,BAL,21,24,3,3,45,45.5,FALSE,0,0,"",0,0.5
1996,17,reg,Buffalo Bills,Kansas City Chiefs,BUF,20,9,11,5,29,36.5,FALSE,0,0,"",6,7.5
1996,17,reg,Carolina Panthers,Pittsburgh Steelers,CAR,18,14,4,5.5,32,36,FALSE,0,0,"",1.5,4
1996,17,reg,Cincinnati Bengals,Indianapolis Colts,IND,31,24,7,1.5,55,42,FALSE,0,0,"",5.5,13
1996,17,reg,Green Bay Packers,Minnesota Vikings,GB,38,10,28,11,48,39,FALSE,0,0,"",17,9
1996,17,reg,Jacksonville Jaguars,Atlanta Falcons,JAX,19,17,2,8.5,36,45,FALSE,0,0,"",6.5,9
1996,17,reg,New York Jets,Miami Dolphins,MIA,28,31,3,3.5,59,37,FALSE,0,0,"",0.5,22
1996,17,reg,Oakland Raiders,Seattle Seahawks,OAK,21,28,7,4,49,41,FALSE,0,0,"",3,8
1996,17,reg,Philadelphia Eagles,Arizona Cardinals,PHI,29,19,10,5.5,48,40,FALSE,0,0,"",4.5,8
1996,17,reg,San Diego Chargers,Denver Broncos,DEN,16,10,6,1.5,26,40.5,FALSE,0,0,"",4.5,14.5
1996,17,reg,Tampa Bay Buccaneers,Chicago Bears,TB,34,19,15,2.5,53,36,FALSE,0,0,"",12.5,17
1996,17,reg,Washington Redskins,Dallas Cowboys,DAL,37,10,27,1,47,37,FALSE,0,0,"",26,10
1996,17,reg,San Francisco 49ers,Detroit Lions,SF,24,14,10,12.5,38,44,FALSE,0,0,"",2.5,6
1996,Wildcard,post,Buffalo Bills,Jacksonville Jaguars,BUF,27,30,3,8.5,57,38,FALSE,0,0,"",5.5,19
1996,Wildcard,post,Dallas Cowboys,Minnesota Vikings,DAL,40,15,25,10,55,40,FALSE,0,0,"",15,15
1996,Wildcard,post,Pittsburgh Steelers,Indianapolis Colts,PIT,42,14,28,8,56,37,FALSE,0,0,"",20,19
1996,Wildcard,post,San Francisco 49ers,Philadelphia Eagles,SF,14,0,14,10.5,14,42,FALSE,0,0,"",3.5,28
1996,Division,post,Denver Broncos,Jacksonville Jaguars,DEN,27,30,3,12.5,57,43.5,FALSE,0,0,"",9.5,13.5
1996,Division,post,Green Bay Packers,San Francisco 49ers,GB,35,14,21,5,49,41.5,FALSE,0,0,"",16,7.5
1996,Division,post,Carolina Panthers,Dallas Cowboys,DAL,26,17,9,3.5,43,37.5,FALSE,0,0,"",5.5,5.5
1996,Division,post,New England Patriots,Pittsburgh Steelers,NE,28,3,25,3,31,41.5,FALSE,0,0,"",22,10.5
1996,Conference,post,Green Bay Packers,Carolina Panthers,GB,30,13,17,12,43,39,FALSE,0,0,"",5,4
1996,Conference,post,New England Patriots,Jacksonville Jaguars,NE,20,6,14,7.5,26,44,FALSE,0,0,"",6.5,18
1996,Superbowl,post,Green Bay Packers,New England Patriots,GB,35,21,14,14,56,49,TRUE,1,0,DOME,0,7
1997,1,reg,Baltimore Ravens,Jacksonville Jaguars,JAX,27,28,1,3,55,43,FALSE,0,0,"",2,12
1997,1,reg,Buffalo Bills,Minnesota Vikings,BUF,13,34,21,2.5,47,37,FALSE,0,0,"",18.5,10
1997,1,reg,Carolina Panthers,Washington Redskins,CAR,10,24,14,3.5,34,38,FALSE,0,0,"",10.5,4
1997,1,reg,Cincinnati Bengals,Arizona Cardinals,CIN,24,21,3,7.5,45,42.5,FALSE,0,0,"",4.5,2.5
1997,1,reg,Denver Broncos,Kansas City Chiefs,DEN,19,3,16,6.5,22,41.5,FALSE,0,0,"",9.5,19.5
1997,1,reg,Detroit Lions,Atlanta Falcons,DET,28,17,11,7.5,45,41.5,FALSE,1,0,DOME,3.5,3.5
1997,1,reg,Miami Dolphins,Indianapolis Colts,MIA,16,10,6,6,26,40,FALSE,0,0,"",0,14
1997,1,reg,New England Patriots,San Diego Chargers,NE,41,7,34,6.5,48,42.5,FALSE,0,0,"",27.5,5.5
1997,1,reg,New York Giants,Philadelphia Eagles,PHI,31,17,14,3,48,38,FALSE,0,0,"",11,10
1997,1,reg,Pittsburgh Steelers,Dallas Cowboys,DAL,7,37,30,1,44,39.5,FALSE,0,0,"",29,4.5
1997,1,reg,Seattle Seahawks,New York Jets,SEA,3,41,38,6.5,44,42,FALSE,1,0,DOME,31.5,2
1997,1,reg,St. Louis Rams,New Orleans Saints,LAR,38,24,14,4.5,62,38.5,FALSE,1,0,DOME,9.5,23.5
1997,1,reg,Tampa Bay Buccaneers,San Francisco 49ers,SF,13,6,7,6.5,19,37,FALSE,0,0,"",0.5,18
1997,1,reg,Tennessee Oilers,Oakland Raiders,OAK,24,21,3,3,45,39.5,FALSE,0,0,"",0,5.5
1997,1,reg,Green Bay Packers,Chicago Bears,GB,38,24,14,14,62,42,FALSE,0,0,"",0,20
1997,2,reg,Arizona Cardinals,Dallas Cowboys,DAL,25,22,3,9.5,47,41.5,FALSE,0,0,"",6.5,5.5
1997,2,reg,Atlanta Falcons,Carolina Panthers,CAR,6,9,3,3.5,15,38.5,FALSE,1,0,DOME,0.5,23.5
1997,2,reg,Baltimore Ravens,Cincinnati Bengals,CIN,23,10,13,1.5,33,47,FALSE,0,0,"",11.5,14
1997,2,reg,Chicago Bears,Minnesota Vikings,MIN,24,27,3,1,51,42,FALSE,0,0,"",2,9
1997,2,reg,Detroit Lions,Tampa Bay Buccaneers,DET,17,24,7,5,41,40,FALSE,1,0,DOME,2,1
1997,2,reg,Indianapolis Colts,New England Patriots,NE,6,31,25,4.5,37,43,FALSE,1,0,DOME,20.5,6
1997,2,reg,Jacksonville Jaguars,New York Giants,JAX,40,13,27,5.5,53,42,FALSE,0,0,"",21.5,11
1997,2,reg,Miami Dolphins,Tennessee Oilers,MIA,16,13,3,6.5,29,40,FALSE,0,0,"",3.5,11
1997,2,reg,New Orleans Saints,San Diego Chargers,NO,6,20,14,2,26,40,FALSE,1,0,DOME,12,14
1997,2,reg,New York Jets,Buffalo Bills,NYJ,22,28,6,4.5,50,41,FALSE,0,0,"",1.5,9
1997,2,reg,Philadelphia Eagles,Green Bay Packers,GB,10,9,1,7.5,19,43,FALSE,0,0,"",6.5,24
1997,2,reg,Pittsburgh Steelers,Washington Redskins,PIT,14,13,1,3.5,27,40.5,FALSE,0,0,"",2.5,13.5
1997,2,reg,Seattle Seahawks,Denver Broncos,DEN,14,35,21,4.5,49,42,FALSE,1,0,DOME,16.5,7
1997,2,reg,St. Louis Rams,San Francisco 49ers,SF,12,15,3,5,27,40.5,FALSE,1,0,DOME,2,13.5
1997,2,reg,Oakland Raiders,Kansas City Chiefs,OAK,27,28,1,4.5,55,40.5,FALSE,0,0,"",3.5,14.5
1997,3,reg,Atlanta Falcons,Oakland Raiders,OAK,31,36,5,2.5,67,40,FALSE,1,0,DOME,2.5,27
1997,3,reg,Chicago Bears,Detroit Lions,CHI,7,32,25,2.5,39,41,FALSE,0,0,"",22.5,2
1997,3,reg,Denver Broncos,St. Louis Rams,DEN,35,14,21,13,49,43,FALSE,0,0,"",8,6
1997,3,reg,Green Bay Packers,Miami Dolphins,GB,23,18,5,11,41,41,FALSE,0,0,"",6,0
1997,3,reg,Indianapolis Colts,Seattle Seahawks,IND,3,31,28,2.5,34,40,FALSE,1,0,DOME,25.5,6
1997,3,reg,Kansas City Chiefs,Buffalo Bills,KC,22,16,6,4.5,38,40,FALSE,0,0,"",1.5,2
1997,3,reg,Minnesota Vikings,Tampa Bay Buccaneers,MIN,14,28,14,4.5,42,38,FALSE,1,0,DOME,9.5,4
1997,3,reg,New England Patriots,New York Jets,NE,27,24,3,10,51,44.5,FALSE,0,0,"",7,6.5
1997,3,reg,New York Giants,Baltimore Ravens,NYG,23,24,1,2.5,47,44,FALSE,0,0,"",1.5,3
1997,3,reg,San Diego Chargers,Carolina Panthers,PICK,7,26,19,0,33,36.5,FALSE,0,0,"",19,3.5
1997,3,reg,San Francisco 49ers,New Orleans Saints,SF,33,7,26,8,40,36.5,FALSE,0,0,"",18,3.5
1997,3,reg,Washington Redskins,Arizona Cardinals,WAS,19,13,6,8,32,41,FALSE,0,0,"",2,9
1997,3,reg,Dallas Cowboys,Philadelphia Eagles,DAL,21,20,1,9,41,41.5,FALSE,0,0,"",8,0.5
1997,4,reg,Buffalo Bills,Indianapolis Colts,BUF,37,35,2,6,72,37.5,FALSE,0,0,"",4,34.5
1997,4,reg,Carolina Panthers,Kansas City Chiefs,CAR,14,35,21,4.5,49,37.5,FALSE,0,0,"",16.5,11.5
1997,4,reg,Denver Broncos,Cincinnati Bengals,DEN,38,20,18,12,58,45,FALSE,0,0,"",6,13
1997,4,reg,Green Bay Packers,Minnesota Vikings,GB,38,32,6,11,70,43.5,FALSE,0,0,"",5,26.5
1997,4,reg,New England Patriots,Chicago Bears,NE,31,3,28,13,34,45,FALSE,0,0,"",15,11
1997,4,reg,New Orleans Saints,Detroit Lions,DET,35,17,18,5.5,52,39.5,FALSE,1,0,DOME,12.5,12.5
1997,4,reg,New York Jets,Oakland Raiders,PICK,23,22,1,0,45,45,FALSE,0,0,"",1,0
1997,4,reg,San Francisco 49ers,Atlanta Falcons,SF,34,7,27,15,41,38.5,FALSE,0,0,"",12,2.5
1997,4,reg,Seattle Seahawks,San Diego Chargers,SEA,26,22,4,4.5,48,41,FALSE,1,0,DOME,0.5,7
1997,4,reg,St. Louis Rams,New York Giants,LAR,13,3,10,3.5,16,42,FALSE,1,0,DOME,6.5,26
1997,4,reg,Tampa Bay Buccaneers,Miami Dolphins,TB,31,21,10,3.5,52,36.5,FALSE,0,0,"",6.5,15.5
1997,4,reg,Tennessee Oilers,Baltimore Ravens,TEN,10,36,26,4.5,46,43.5,FALSE,0,0,"",21.5,2.5
1997,4,reg,Jacksonville Jaguars,Pittsburgh Steelers,JAX,30,21,9,3,51,40.5,FALSE,0,0,"",6,10.5
1997,5,reg,Atlanta Falcons,Denver Broncos,DEN,21,29,8,11,50,42,FALSE,1,0,DOME,3,8
1997,5,reg,Cincinnati Bengals,New York Jets,CIN,14,31,17,4,45,45.5,FALSE,0,0,"",13,0.5
1997,5,reg,Dallas Cowboys,Chicago Bears,DAL,27,3,24,14,30,41.5,FALSE,0,0,"",10,11.5
1997,5,reg,Detroit Lions,Green Bay Packers,GB,26,15,11,7.5,41,44.5,FALSE,1,0,DOME,3.5,3.5
1997,5,reg,Kansas City Chiefs,Seattle Seahawks,KC,20,17,3,4.5,37,40.5,FALSE,0,0,"",1.5,3.5
1997,5,reg,Minnesota Vikings,Philadelphia Eagles,MIN,28,19,9,2.5,47,43,FALSE,1,0,DOME,6.5,4
1997,5,reg,New York Giants,New Orleans Saints,NYG,14,9,5,5,23,39.5,FALSE,0,0,"",0,16.5
1997,5,reg,Oakland Raiders,St. Louis Rams,OAK,35,17,18,7,52,43.5,FALSE,0,0,"",11,8.5
1997,5,reg,Pittsburgh Steelers,Tennessee Oilers,PIT,37,24,13,6,61,41,FALSE,0,0,"",7,20
1997,5,reg,San Diego Chargers,Baltimore Ravens,LAC,21,17,4,1.5,38,44.5,FALSE,0,0,"",2.5,6.5
1997,5,reg,Tampa Bay Buccaneers,Arizona Cardinals,TB,19,18,1,7.5,37,38,FALSE,0,0,"",6.5,1
1997,5,reg,Washington Redskins,Jacksonville Jaguars,WAS,24,12,12,1,36,43.5,FALSE,0,0,"",11,7.5
1997,5,reg,Carolina Panthers,San Francisco 49ers,SF,21,34,13,3.5,55,39,FALSE,0,0,"",9.5,16
1997,6,reg,Arizona Cardinals,Minnesota Vikings,MIN,19,20,1,1,39,41,FALSE,0,0,"",0,2
1997,6,reg,Baltimore Ravens,Pittsburgh Steelers,PIT,34,42,8,2,76,43.5,FALSE,0,0,"",6,32.5
1997,6,reg,Buffalo Bills,Detroit Lions,BUF,22,13,9,3.5,35,41,FALSE,0,0,"",5.5,6
1997,6,reg,Chicago Bears,New Orleans Saints,CHI,17,20,3,3,37,38,FALSE,0,0,"",0,1
1997,6,reg,Green Bay Packers,Tampa Bay Buccaneers,GB,21,16,5,7,37,39.5,FALSE,0,0,"",2,2.5
1997,6,reg,Indianapolis Colts,New York Jets,NYJ,12,16,4,3,28,42,FALSE,1,0,DOME,1,14
1997,6,reg,Jacksonville Jaguars,Cincinnati Bengals,JAX,21,13,8,7,34,45,FALSE,0,0,"",1,11
1997,6,reg,Miami Dolphins,Kansas City Chiefs,MIA,17,14,3,3,31,40,FALSE,0,0,"",0,9
1997,6,reg,New York Giants,Dallas Cowboys,DAL,20,17,3,7.5,37,39,FALSE,0,0,"",4.5,2
1997,6,reg,Oakland Raiders,San Diego Chargers,OAK,10,25,15,7,35,45,FALSE,0,0,"",8,10
1997,6,reg,Philadelphia Eagles,Washington Redskins,PHI,24,10,14,3.5,34,41.5,FALSE,0,0,"",10.5,7.5
1997,6,reg,Seattle Seahawks,Tennessee Oilers,SEA,16,13,3,5.5,29,42.5,FALSE,1,0,DOME,2.5,13.5
1997,6,reg,Denver Broncos,New England Patriots,DEN,34,13,21,4,47,45,FALSE,0,0,"",17,2
1997,7,reg,Arizona Cardinals,New York Giants,ARI,13,27,14,3.5,40,38.5,FALSE,0,0,"",10.5,1.5
1997,7,reg,Chicago Bears,Green Bay Packers,GB,23,24,1,11.5,47,41,FALSE,0,0,"",10.5,6
1997,7,reg,Jacksonville Jaguars,Philadelphia Eagles,JAX,38,21,17,3,59,42,FALSE,0,0,"",14,17
1997,7,reg,Minnesota Vikings,Carolina Panthers,MIN,21,14,7,4,35,41,FALSE,1,0,DOME,3,6
1997,7,reg,New England Patriots,Buffalo Bills,NE,33,6,27,9,39,42,FALSE,0,0,"",18,3
1997,7,reg,New Orleans Saints,Atlanta Falcons,NO,17,23,6,2,40,38,FALSE,1,0,DOME,4,2
1997,7,reg,New York Jets,Miami Dolphins,NYJ,20,31,11,3.5,51,42.5,FALSE,0,0,"",7.5,8.5
1997,7,reg,Pittsburgh Steelers,Indianapolis Colts,PIT,24,22,2,10.5,46,41,FALSE,0,0,"",8.5,5
1997,7,reg,San Francisco 49ers,St. Louis Rams,SF,30,10,20,14,40,41,FALSE,0,0,"",6,1
1997,7,reg,Tampa Bay Buccaneers,Detroit Lions,TB,9,27,18,5.5,36,39,FALSE,0,0,"",12.5,3
1997,7,reg,Tennessee Oilers,Cincinnati Bengals,TEN,30,7,23,2.5,37,42.5,FALSE,0,0,"",20.5,5.5
1997,7,reg,Washington Redskins,Dallas Cowboys,DAL,21,16,5,3,37,39.5,FALSE,0,0,"",2,2.5
1997,8,reg,Kansas City Chiefs,San Diego Chargers,KC,31,3,28,5.5,34,41,FALSE,0,0,"",22.5,7
1997,8,reg,Atlanta Falcons,San Francisco 49ers,SF,28,35,7,10.5,63,40.5,FALSE,1,0,DOME,3.5,22.5
1997,8,reg,Baltimore Ravens,Miami Dolphins,MIA,13,24,11,1,37,44,FALSE,0,0,"",10,7
1997,8,reg,Cincinnati Bengals,Pittsburgh Steelers,PIT,10,26,16,5,36,43,FALSE,0,0,"",11,7
1997,8,reg,Dallas Cowboys,Jacksonville Jaguars,DAL,26,22,4,4.5,48,43,FALSE,0,0,"",0.5,5
1997,8,reg,Detroit Lions,New York Giants,DET,20,26,6,6.5,46,39,FALSE,1,0,DOME,0.5,7
1997,8,reg,New Orleans Saints,Carolina Panthers,CAR,0,13,13,4.5,13,37,FALSE,1,0,DOME,8.5,24
1997,8,reg,New York Jets,New England Patriots,NE,24,19,5,3,43,45,FALSE,0,0,"",2,2
1997,8,reg,Oakland Raiders,Denver Broncos,DEN,28,25,3,5.5,53,46,FALSE,0,0,"",2.5,7
1997,8,reg,Philadelphia Eagles,Arizona Cardinals,PHI,13,10,3,8.5,23,38,FALSE,0,0,"",5.5,15
1997,8,reg,St. Louis Rams,Seattle Seahawks,SEA,9,17,8,1.5,26,40,FALSE,1,0,DOME,6.5,14
1997,8,reg,Tennessee Oilers,Washington Redskins,WAS,28,14,14,2,42,41,FALSE,0,0,"",12,1
1997,8,reg,Indianapolis Colts,Buffalo Bills,BUF,6,9,3,2.5,15,38.5,FALSE,1,0,DOME,0.5,23.5
1997,9,reg,Arizona Cardinals,Tennessee Oilers,ARI,14,41,27,2,55,38,FALSE,0,0,"",25,17
1997,9,reg,Buffalo Bills,Denver Broncos,DEN,20,23,3,7,43,43,FALSE,0,0,"",4,0
1997,9,reg,Carolina Panthers,Atlanta Falcons,CAR,21,12,9,8.5,33,38,FALSE,0,0,"",0.5,5
1997,9,reg,New Orleans Saints,San Francisco 49ers,SF,0,23,23,13.5,23,39,FALSE,1,0,DOME,9.5,16
1997,9,reg,New York Giants,Cincinnati Bengals,NYG,29,27,2,6,56,40.5,FALSE,0,0,"",4,15.5
1997,9,reg,Philadelphia Eagles,Dallas Cowboys,DAL,13,12,1,1,25,41,FALSE,0,0,"",0,16
1997,9,reg,Pittsburgh Steelers,Jacksonville Jaguars,PIT,23,17,6,3,40,44.5,FALSE,0,0,"",3,4.5
1997,9,reg,San Diego Chargers,Indianapolis Colts,LAC,35,19,16,5.5,54,38,FALSE,0,0,"",10.5,16
1997,9,reg,Seattle Seahawks,Oakland Raiders,SEA,45,34,11,1.5,79,44,FALSE,1,0,DOME,9.5,35
1997,9,reg,St. Louis Rams,Kansas City Chiefs,KC,20,28,8,5.5,48,39,FALSE,1,0,DOME,2.5,9
1997,9,reg,Tampa Bay Buccaneers,Minnesota Vikings,TB,6,10,4,2.5,16,40,FALSE,0,0,"",1.5,24
1997,9,reg,Washington Redskins,Baltimore Ravens,WAS,17,20,3,6.5,37,44.5,FALSE,0,0,"",3.5,7.5
1997,9,reg,Miami Dolphins,Chicago Bears,MIA,33,36,3,9.5,69,40,FALSE,0,0,"",6.5,29
1997,9,reg,New England Patriots,Green Bay Packers,NE,10,28,18,1,38,45,FALSE,0,0,"",17,7
1997,10,reg,Arizona Cardinals,Philadelphia Eagles,PHI,31,21,10,4.5,52,37,FALSE,0,0,"",5.5,15
1997,10,reg,Atlanta Falcons,St. Louis Rams,ATL,34,31,3,3,65,40.5,FALSE,1,0,DOME,0,24.5
1997,10,reg,Buffalo Bills,Miami Dolphins,BUF,9,6,3,2,15,40.5,FALSE,0,0,"",1,25.5
1997,10,reg,Carolina Panthers,Oakland Raiders,CAR,38,14,24,2.5,52,43,FALSE,0,0,"",21.5,9
1997,10,reg,Chicago Bears,Washington Redskins,WAS,8,31,23,3,39,40,FALSE,0,0,"",20,1
1997,10,reg,Cincinnati Bengals,San Diego Chargers,LAC,38,31,7,1.5,69,43,FALSE,0,0,"",5.5,26
1997,10,reg,Denver Broncos,Seattle Seahawks,DEN,30,27,3,9.5,57,44,FALSE,0,0,"",6.5,13
1997,10,reg,Green Bay Packers,Detroit Lions,GB,20,10,10,10,30,43,FALSE,0,0,"",0,13
1997,10,reg,Indianapolis Colts,Tampa Bay Buccaneers,TB,28,31,3,4.5,59,37,FALSE,1,0,DOME,1.5,22
1997,10,reg,Minnesota Vikings,New England Patriots,MIN,23,18,5,1,41,44,FALSE,1,0,DOME,4,3
1997,10,reg,New York Jets,Baltimore Ravens,NYJ,19,16,3,5.5,35,46,FALSE,0,0,"",2.5,11
1997,10,reg,San Francisco 49ers,Dallas Cowboys,SF,17,10,7,7,27,41,FALSE,0,0,"",0,14
1997,10,reg,Tennessee Oilers,Jacksonville Jaguars,JAX,24,30,6,1,54,43.5,FALSE,0,0,"",5,10.5
1997,10,reg,Kansas City Chiefs,Pittsburgh Steelers,KC,13,10,3,3,23,41.5,FALSE,0,0,"",0,18.5
1997,11,reg,Atlanta Falcons,Tampa Bay Buccaneers,TB,10,31,21,3,41,40,FALSE,1,0,DOME,18,1
1997,11,reg,Buffalo Bills,New England Patriots,NE,10,31,21,3,41,41.5,FALSE,0,0,"",18,0.5
1997,11,reg,Dallas Cowboys,Arizona Cardinals,DAL,24,6,18,8.5,30,38.5,FALSE,0,0,"",9.5,8.5
1997,11,reg,Denver Broncos,Carolina Panthers,DEN,34,0,34,8,34,42,FALSE,0,0,"",26,8
1997,11,reg,Green Bay Packers,St. Louis Rams,GB,17,7,10,15,24,42.5,FALSE,0,0,"",5,18.5
1997,11,reg,Indianapolis Colts,Cincinnati Bengals,CIN,13,28,15,2.5,41,40.5,FALSE,1,0,DOME,12.5,0.5
1997,11,reg,Jacksonville Jaguars,Kansas City Chiefs,JAX,24,10,14,5,34,42,FALSE,0,0,"",9,8
1997,11,reg,Miami Dolphins,New York Jets,MIA,24,17,7,2.5,41,43,FALSE,0,0,"",4.5,2
1997,11,reg,Minnesota Vikings,Chicago Bears,MIN,29,22,7,9,51,42.5,FALSE,1,0,DOME,2,8.5
1997,11,reg,Oakland Raiders,New Orleans Saints,OAK,10,13,3,9.5,23,43,FALSE,0,0,"",6.5,20
1997,11,reg,Pittsburgh Steelers,Baltimore Ravens,PIT,37,0,37,6.5,37,45,FALSE,0,0,"",30.5,8
1997,11,reg,San Diego Chargers,Seattle Seahawks,SEA,31,37,6,3,68,41.5,FALSE,0,0,"",3,26.5
1997,11,reg,Tennessee Oilers,New York Giants,TEN,10,6,4,2.5,16,39,FALSE,0,0,"",1.5,23
1997,11,reg,Washington Redskins,Detroit Lions,WAS,30,7,23,4,37,41,FALSE,0,0,"",19,4
1997,11,reg,Philadelphia Eagles,San Francisco 49ers,SF,12,24,12,3.5,36,39.5,FALSE,0,0,"",8.5,3.5
1997,12,reg,Baltimore Ravens,Philadelphia Eagles,BAL,10,10,0,2.5,20,41,FALSE,0,0,"",2.5,21
1997,12,reg,Chicago Bears,New York Jets,NYJ,15,23,8,3,38,41,FALSE,0,0,"",5,3
1997,12,reg,Dallas Cowboys,Washington Redskins,DAL,17,14,3,5.5,31,38.5,FALSE,0,0,"",2.5,7.5
1997,12,reg,Detroit Lions,Minnesota Vikings,MIN,38,15,23,1,53,43,FALSE,1,0,DOME,22,10
1997,12,reg,Indianapolis Colts,Green Bay Packers,GB,41,38,3,13,79,39.5,FALSE,1,0,DOME,10,39.5
1997,12,reg,Jacksonville Jaguars,Tennessee Oilers,JAX,17,9,8,6,26,42.5,FALSE,0,0,"",2,16.5
1997,12,reg,Kansas City Chiefs,Denver Broncos,DEN,24,22,2,3,46,40,FALSE,0,0,"",1,6
1997,12,reg,New Orleans Saints,Seattle Seahawks,SEA,20,17,3,6,37,39,FALSE,1,0,DOME,3,2
1997,12,reg,New York Giants,Arizona Cardinals,NYG,19,10,9,5.5,29,37,FALSE,0,0,"",3.5,8
1997,12,reg,Pittsburgh Steelers,Cincinnati Bengals,PIT,20,3,17,9.5,23,43,FALSE,0,0,"",7.5,20
1997,12,reg,San Diego Chargers,Oakland Raiders,PICK,13,38,25,0,51,44,FALSE,0,0,"",25,7
1997,12,reg,San Francisco 49ers,Carolina Panthers,SF,27,19,8,10,46,38.5,FALSE,0,0,"",2,7.5
1997,12,reg,St. Louis Rams,Atlanta Falcons,LAR,21,27,6,3.5,48,42.5,FALSE,1,0,DOME,2.5,5.5
1997,12,reg,Tampa Bay Buccaneers,New England Patriots,NE,27,7,20,2,34,41,FALSE,0,0,"",18,7
1997,12,reg,Miami Dolphins,Buffalo Bills,MIA,30,13,17,6,43,38.5,FALSE,0,0,"",11,4.5
1997,13,reg,Atlanta Falcons,New Orleans Saints,ATL,20,3,17,4.5,23,38,FALSE,1,0,DOME,12.5,15
1997,13,reg,Baltimore Ravens,Arizona Cardinals,BAL,13,16,3,4,29,40,FALSE,0,0,"",1,11
1997,13,reg,Chicago Bears,Tampa Bay Buccaneers,TB,13,7,6,5.5,20,36.5,FALSE,0,0,"",0.5,16.5
1997,13,reg,Cincinnati Bengals,Jacksonville Jaguars,JAX,31,26,5,6,57,40.5,FALSE,0,0,"",1,16.5
1997,13,reg,Detroit Lions,Indianapolis Colts,DET,32,10,22,8.5,42,42.5,FALSE,1,0,DOME,13.5,0.5
1997,13,reg,Green Bay Packers,Dallas Cowboys,GB,45,17,28,7,62,38,FALSE,0,0,"",21,24
1997,13,reg,New England Patriots,Miami Dolphins,NE,27,24,3,4,51,39,FALSE,0,0,"",1,12
1997,13,reg,New York Jets,Minnesota Vikings,NYJ,23,21,2,3,44,42.5,FALSE,0,0,"",1,1.5
1997,13,reg,Philadelphia Eagles,Pittsburgh Steelers,PIT,23,20,3,3,43,37,FALSE,0,0,"",0,6
1997,13,reg,San Francisco 49ers,San Diego Chargers,SF,17,10,7,14,27,40,FALSE,0,0,"",7,13
1997,13,reg,Seattle Seahawks,Kansas City Chiefs,SEA,14,19,5,3,33,41,FALSE,1,0,DOME,2,8
1997,13,reg,St. Louis Rams,Carolina Panthers,CAR,10,16,6,3,26,39,FALSE,1,0,DOME,3,13
1997,13,reg,Tennessee Oilers,Buffalo Bills,TEN,31,14,17,3.5,45,37,FALSE,0,0,"",13.5,8
1997,13,reg,Washington Redskins,New York Giants,WAS,7,7,0,5.5,14,36,FALSE,0,0,"",5.5,22
1997,13,reg,Denver Broncos,Oakland Raiders,DEN,31,3,28,8.5,34,45.5,FALSE,0,0,"",19.5,11.5
1997,14,reg,Dallas Cowboys,Tennessee Oilers,DAL,14,27,13,6.5,41,38.5,FALSE,0,0,"",6.5,2.5
1997,14,reg,Detroit Lions,Chicago Bears,DET,55,20,35,8,75,43,FALSE,1,0,DOME,27,32
1997,14,reg,Arizona Cardinals,Pittsburgh Steelers,PIT,20,26,6,5.5,46,38,FALSE,0,0,"",0.5,8
1997,14,reg,Buffalo Bills,New York Jets,NYJ,20,10,10,2.5,30,38.5,FALSE,0,0,"",7.5,8.5
1997,14,reg,Carolina Panthers,New Orleans Saints,CAR,13,16,3,9,29,36,FALSE,0,0,"",6,7
1997,14,reg,Jacksonville Jaguars,Baltimore Ravens,JAX,29,27,2,8,56,43.5,FALSE,0,0,"",6,12.5
1997,14,reg,Kansas City Chiefs,San Francisco 49ers,SF,44,9,35,4.5,53,37,FALSE,0,0,"",30.5,16
1997,14,reg,New England Patriots,Indianapolis Colts,NE,20,17,3,11.5,37,40,FALSE,0,0,"",8.5,3
1997,14,reg,New York Giants,Tampa Bay Buccaneers,NYG,8,20,12,1,28,35,FALSE,0,0,"",11,7
1997,14,reg,Oakland Raiders,Miami Dolphins,MIA,16,34,18,2.5,50,44,FALSE,0,0,"",15.5,6
1997,14,reg,Philadelphia Eagles,Cincinnati Bengals,PHI,44,42,2,5,86,39,FALSE,0,0,"",3,47
1997,14,reg,San Diego Chargers,Denver Broncos,DEN,28,38,10,8.5,66,43.5,FALSE,0,0,"",1.5,22.5
1997,14,reg,Seattle Seahawks,Atlanta Falcons,SEA,17,24,7,7,41,43.5,FALSE,1,0,DOME,0,2.5
1997,14,reg,Washington Redskins,St. Louis Rams,WAS,20,23,3,8.5,43,36.5,FALSE,0,0,"",5.5,6.5
1997,14,reg,Minnesota Vikings,Green Bay Packers,GB,11,27,16,3,38,44,FALSE,1,0,DOME,13,6
1997,15,reg,Cincinnati Bengals,Tennessee Oilers,TEN,41,14,27,3,55,41.5,FALSE,0,0,"",24,13.5
1997,15,reg,Arizona Cardinals,Washington Redskins,WAS,28,38,10,2.5,66,38,FALSE,0,0,"",7.5,28
1997,15,reg,Baltimore Ravens,Seattle Seahawks,BAL,31,24,7,1,55,45.5,FALSE,0,0,"",6,9.5
1997,15,reg,Chicago Bears,Buffalo Bills,BUF,20,3,17,1.5,23,37,FALSE,0,0,"",15.5,14
1997,15,reg,Jacksonville Jaguars,New England Patriots,JAX,20,26,6,3.5,46,44.5,FALSE,0,0,"",2.5,1.5
1997,15,reg,Kansas City Chiefs,Oakland Raiders,KC,30,0,30,9,30,42,FALSE,0,0,"",21,12
1997,15,reg,Miami Dolphins,Detroit Lions,MIA,33,30,3,3.5,63,43,FALSE,0,0,"",0.5,20
1997,15,reg,New Orleans Saints,St. Louis Rams,NO,27,34,7,1.5,61,37,FALSE,1,0,DOME,5.5,24
1997,15,reg,New York Jets,Indianapolis Colts,NYJ,14,22,8,8,36,41,FALSE,0,0,"",0,5
1997,15,reg,Philadelphia Eagles,New York Giants,PHI,21,31,10,4,52,35.5,FALSE,0,0,"",6,16.5
1997,15,reg,Pittsburgh Steelers,Denver Broncos,PIT,35,24,11,1,59,43,FALSE,0,0,"",10,16
1997,15,reg,San Diego Chargers,Atlanta Falcons,ATL,3,14,11,3,17,43.5,FALSE,0,0,"",8,26.5
1997,15,reg,San Francisco 49ers,Minnesota Vikings,SF,28,17,11,7,45,41,FALSE,0,0,"",4,4
1997,15,reg,Tampa Bay Buccaneers,Green Bay Packers,GB,6,17,11,4,23,38,FALSE,0,0,"",7,15
1997,15,reg,Dallas Cowboys,Carolina Panthers,DAL,13,23,10,6.5,36,36.5,FALSE,0,0,"",3.5,0.5
1997,16,reg,New England Patriots,Pittsburgh Steelers,NE,21,24,3,2.5,45,42,FALSE,0,0,"",0.5,3
1997,16,reg,New York Giants,Washington Redskins,NYG,30,10,20,3,40,36.5,FALSE,0,0,"",17,3.5
1997,16,reg,Atlanta Falcons,Philadelphia Eagles,ATL,20,17,3,2,37,42.5,FALSE,1,0,DOME,1,5.5
1997,16,reg,Baltimore Ravens,Tennessee Oilers,PICK,21,19,2,0,40,43,FALSE,0,0,"",2,3
1997,16,reg,Buffalo Bills,Jacksonville Jaguars,JAX,14,20,6,5,34,38.5,FALSE,0,0,"",1,4.5
1997,16,reg,Carolina Panthers,Green Bay Packers,GB,10,31,21,7,41,38,FALSE,0,0,"",14,3
1997,16,reg,Cincinnati Bengals,Dallas Cowboys,CIN,31,24,7,3.5,55,41.5,FALSE,0,0,"",3.5,13.5
1997,16,reg,Indianapolis Colts,Miami Dolphins,MIA,41,0,41,4,41,41,FALSE,1,0,DOME,37,0
1997,16,reg,Minnesota Vikings,Detroit Lions,MIN,13,14,1,2.5,27,46,FALSE,1,0,DOME,1.5,19
1997,16,reg,New Orleans Saints,Arizona Cardinals,NO,27,10,17,2,37,38.5,FALSE,1,0,DOME,15,1.5
1997,16,reg,New York Jets,Tampa Bay Buccaneers,TB,31,0,31,2.5,31,37,FALSE,0,0,"",28.5,6
1997,16,reg,Oakland Raiders,Seattle Seahawks,OAK,21,22,1,1.5,43,46,FALSE,0,0,"",0.5,3
1997,16,reg,San Diego Chargers,Kansas City Chiefs,KC,7,29,22,9.5,36,41,FALSE,0,0,"",12.5,5
1997,16,reg,St. Louis Rams,Chicago Bears,LAR,10,13,3,3,23,41,FALSE,1,0,DOME,0,18
1997,16,reg,San Francisco 49ers,Denver Broncos,SF,34,17,17,4,51,44,FALSE,0,0,"",13,7
1997,17,reg,Carolina Panthers,St. Louis Rams,CAR,18,30,12,5,48,38,FALSE,0,0,"",7,10
1997,17,reg,Green Bay Packers,Buffalo Bills,GB,31,21,10,7,52,37.5,FALSE,0,0,"",3,14.5
1997,17,reg,Arizona Cardinals,Atlanta Falcons,ATL,29,26,3,1.5,55,42.5,FALSE,0,0,"",1.5,12.5
1997,17,reg,Cincinnati Bengals,Baltimore Ravens,CIN,16,14,2,7,30,45,FALSE,0,0,"",5,15
1997,17,reg,Dallas Cowboys,New York Giants,DAL,7,20,13,1.5,27,38,FALSE,0,0,"",11.5,11
1997,17,reg,Denver Broncos,San Diego Chargers,DEN,38,3,35,13,41,41.5,FALSE,0,0,"",22,0.5
1997,17,reg,Detroit Lions,New York Jets,DET,13,10,3,5.5,23,43,FALSE,1,0,DOME,2.5,20
1997,17,reg,Kansas City Chiefs,New Orleans Saints,KC,25,13,12,7,38,37,FALSE,0,0,"",5,1
1997,17,reg,Minnesota Vikings,Indianapolis Colts,MIN,39,28,11,6.5,67,42,FALSE,1,0,DOME,4.5,25
1997,17,reg,Oakland Raiders,Jacksonville Jaguars,JAX,9,20,11,2.5,29,44,FALSE,0,0,"",8.5,15
1997,17,reg,Seattle Seahawks,San Francisco 49ers,SF,38,9,29,2.5,47,42.5,FALSE,1,0,DOME,26.5,4.5
1997,17,reg,Tampa Bay Buccaneers,Chicago Bears,TB,31,15,16,7.5,46,36.5,FALSE,0,0,"",8.5,9.5
1997,17,reg,Tennessee Oilers,Pittsburgh Steelers,PIT,16,6,10,1.5,22,39.5,FALSE,0,0,"",8.5,17.5
1997,17,reg,Washington Redskins,Philadelphia Eagles,WAS,35,32,3,5.5,67,38,FALSE,0,0,"",2.5,29
1997,17,reg,Miami Dolphins,New England Patriots,MIA,12,14,2,2,26,44.5,FALSE,0,0,"",0,18.5
1997,Wildcard,post,Denver Broncos,Jacksonville Jaguars,DEN,42,17,25,6.5,59,45.5,FALSE,0,0,"",18.5,13.5
1997,Wildcard,post,New York Giants,Minnesota Vikings,NYG,22,23,1,4.5,45,38,FALSE,0,0,"",3.5,7
1997,Wildcard,post,New England Patriots,Miami Dolphins,NE,17,3,14,5,20,41.5,FALSE,0,0,"",9,21.5
1997,Wildcard,post,Tampa Bay Buccaneers,Detroit Lions,TB,20,10,10,3,30,38.5,FALSE,0,0,"",7,8.5
1997,Division,post,Pittsburgh Steelers,New England Patriots,PIT,7,6,1,6,13,42,FALSE,0,0,"",5,29
1997,Division,post,San Francisco 49ers,Minnesota Vikings,SF,38,22,16,11.5,60,42,FALSE,0,0,"",4.5,18
1997,Division,post,Green Bay Packers,Tampa Bay Buccaneers,GB,21,7,14,13,28,38,FALSE,0,0,"",1,10
1997,Division,post,Kansas City Chiefs,Denver Broncos,PICK,10,14,4,0,24,41,FALSE,0,0,"",4,17
1997,Conference,post,Pittsburgh Steelers,Denver Broncos,PIT,21,24,3,1,45,41,FALSE,0,0,"",2,4
1997,Conference,post,San Francisco 49ers,Green Bay Packers,GB,10,23,13,1.5,33,43.5,FALSE,0,0,"",11.5,10.5
1997,Superbowl,post,Green Bay Packers,Denver Broncos,GB,24,31,7,11,55,49,TRUE,0,0,"",4,6
1998,1,reg,Baltimore Ravens,Pittsburgh Steelers,PIT,13,20,7,3,33,42,FALSE,0,0,"",4,9
1998,1,reg,Carolina Panthers,Atlanta Falcons,CAR,14,19,5,4.5,33,38.5,FALSE,0,0,"",0.5,5.5
1998,1,reg,Chicago Bears,Jacksonville Jaguars,JAX,23,24,1,10,47,41,FALSE,0,0,"",9,6
1998,1,reg,Cincinnati Bengals,Tennessee Oilers,PICK,14,23,9,0,37,44,FALSE,0,0,"",9,7
1998,1,reg,Dallas Cowboys,Arizona Cardinals,DAL,38,10,28,5.5,48,41.5,FALSE,0,0,"",22.5,6.5
1998,1,reg,Green Bay Packers,Detroit Lions,GB,38,19,19,9.5,57,44.5,FALSE,0,0,"",9.5,12.5
1998,1,reg,Indianapolis Colts,Miami Dolphins,MIA,15,24,9,3.5,39,39,FALSE,1,0,DOME,5.5,0
1998,1,reg,Kansas City Chiefs,Oakland Raiders,KC,28,8,20,8,36,41,FALSE,0,0,"",12,5
1998,1,reg,Minnesota Vikings,Tampa Bay Buccaneers,MIN,31,7,24,3,38,39.5,FALSE,1,0,DOME,21,1.5
1998,1,reg,New York Giants,Washington Redskins,NYG,31,24,7,2.5,55,36.5,FALSE,0,0,"",4.5,18.5
1998,1,reg,Philadelphia Eagles,Seattle Seahawks,SEA,0,38,38,4.5,38,39,FALSE,0,0,"",33.5,1
1998,1,reg,San Diego Chargers,Buffalo Bills,LAC,16,14,2,1.5,30,41,FALSE,0,0,"",0.5,11
1998,1,reg,San Francisco 49ers,New York Jets,SF,36,30,6,7.5,66,44,FALSE,0,0,"",1.5,22
1998,1,reg,St. Louis Rams,New Orleans Saints,LAR,17,24,7,4,41,36.5,FALSE,1,0,DOME,3,4.5
1998,1,reg,Denver Broncos,New England Patriots,DEN,27,21,6,7,48,45.5,FALSE,0,0,"",1,2.5
1998,2,reg,Atlanta Falcons,Philadelphia Eagles,ATL,17,12,5,8.5,29,38.5,FALSE,1,0,DOME,3.5,9.5
1998,2,reg,Denver Broncos,Dallas Cowboys,DEN,42,23,19,7.5,65,44,FALSE,0,0,"",11.5,21
1998,2,reg,Detroit Lions,Cincinnati Bengals,DET,28,34,6,7,62,44.5,FALSE,1,0,DOME,1,17.5
1998,2,reg,Green Bay Packers,Tampa Bay Buccaneers,GB,23,15,8,7.5,38,39,FALSE,0,0,"",0.5,1
1998,2,reg,Jacksonville Jaguars,Kansas City Chiefs,JAX,21,16,5,3.5,37,42.5,FALSE,0,0,"",1.5,5.5
1998,2,reg,Miami Dolphins,Buffalo Bills,MIA,13,7,6,7.5,20,38,FALSE,0,0,"",1.5,18
1998,2,reg,New England Patriots,Indianapolis Colts,NE,29,6,23,10.5,35,39.5,FALSE,0,0,"",12.5,4.5
1998,2,reg,New Orleans Saints,Carolina Panthers,CAR,19,14,5,4,33,35,FALSE,1,0,DOME,1,2
1998,2,reg,New York Jets,Baltimore Ravens,NYJ,10,24,14,5.5,34,44.5,FALSE,0,0,"",8.5,10.5
1998,2,reg,Oakland Raiders,New York Giants,OAK,20,17,3,2,37,40.5,FALSE,0,0,"",1,3.5
1998,2,reg,Pittsburgh Steelers,Chicago Bears,PIT,17,12,5,11.5,29,42,FALSE,0,0,"",6.5,13
1998,2,reg,Seattle Seahawks,Arizona Cardinals,SEA,33,14,19,8,47,44.5,FALSE,1,0,DOME,11,2.5
1998,2,reg,St. Louis Rams,Minnesota Vikings,MIN,31,38,7,7.5,69,43,FALSE,1,0,DOME,0.5,26
1998,2,reg,Tennessee Oilers,San Diego Chargers,TEN,7,13,6,7.5,20,40,FALSE,0,0,"",1.5,20
1998,2,reg,Washington Redskins,San Francisco 49ers,SF,10,45,35,4.5,55,43.5,FALSE,0,0,"",30.5,11.5
1998,3,reg,Arizona Cardinals,Philadelphia Eagles,ARI,17,3,14,4.5,20,39,FALSE,0,0,"",9.5,19
1998,3,reg,Buffalo Bills,St. Louis Rams,BUF,33,34,1,4.5,67,38.5,FALSE,0,0,"",3.5,28.5
1998,3,reg,Cincinnati Bengals,Green Bay Packers,GB,6,13,7,7,19,44.5,FALSE,0,0,"",0,25.5
1998,3,reg,Jacksonville Jaguars,Baltimore Ravens,JAX,24,10,14,7,34,42,FALSE,0,0,"",7,8
1998,3,reg,Kansas City Chiefs,San Diego Chargers,KC,23,7,16,10,30,37,FALSE,0,0,"",6,7
1998,3,reg,Miami Dolphins,Pittsburgh Steelers,MIA,21,0,21,2.5,21,37.5,FALSE,0,0,"",18.5,16.5
1998,3,reg,Minnesota Vikings,Detroit Lions,MIN,29,6,23,6.5,35,44,FALSE,1,0,DOME,16.5,9
1998,3,reg,New England Patriots,Tennessee Oilers,NE,27,16,11,6.5,43,40,FALSE,0,0,"",4.5,3
1998,3,reg,New York Jets,Indianapolis Colts,NYJ,44,6,38,9,50,40.5,FALSE,0,0,"",29,9.5
1998,3,reg,Oakland Raiders,Denver Broncos,DEN,17,34,17,7,51,45,FALSE,0,0,"",10,6
1998,3,reg,Seattle Seahawks,Washington Redskins,SEA,24,14,10,8.5,38,43,FALSE,1,0,DOME,1.5,5
1998,3,reg,Tampa Bay Buccaneers,Chicago Bears,TB,27,15,12,7.5,42,37,FALSE,0,0,"",4.5,5
1998,3,reg,New York Giants,Dallas Cowboys,NYG,7,31,24,4,38,37,FALSE,0,0,"",20,1
1998,4,reg,Baltimore Ravens,Cincinnati Bengals,BAL,31,24,7,4.5,55,40.5,FALSE,0,0,"",2.5,14.5
1998,4,reg,Carolina Panthers,Green Bay Packers,GB,30,37,7,7,67,37.5,FALSE,0,0,"",0,29.5
1998,4,reg,Chicago Bears,Minnesota Vikings,MIN,28,31,3,6.5,59,40,FALSE,0,0,"",3.5,19
1998,4,reg,Dallas Cowboys,Oakland Raiders,DAL,12,13,1,5,25,41.5,FALSE,0,0,"",4,16.5
1998,4,reg,Indianapolis Colts,New Orleans Saints,PICK,13,19,6,0,32,35.5,FALSE,1,0,DOME,6,3.5
1998,4,reg,Philadelphia Eagles,Kansas City Chiefs,KC,21,24,3,8,45,36,FALSE,0,0,"",5,9
1998,4,reg,Pittsburgh Steelers,Seattle Seahawks,PIT,13,10,3,3,23,39.5,FALSE,0,0,"",0,16.5
1998,4,reg,San Diego Chargers,New York Giants,NYG,16,34,18,1,50,35,FALSE,0,0,"",17,15
1998,4,reg,San Francisco 49ers,Atlanta Falcons,SF,31,20,11,11,51,45,FALSE,0,0,"",0,6
1998,4,reg,St. Louis Rams,Arizona Cardinals,LAR,17,20,3,3,37,41,FALSE,1,0,DOME,0,4
1998,4,reg,Tennessee Oilers,Jacksonville Jaguars,JAX,22,27,5,3,49,41,FALSE,0,0,"",2,8
1998,4,reg,Washington Redskins,Denver Broncos,DEN,16,38,22,6.5,54,44,FALSE,0,0,"",15.5,10
1998,4,reg,Detroit Lions,Tampa Bay Buccaneers,TB,27,6,21,1.5,33,39.5,FALSE,1,0,DOME,19.5,6.5
1998,5,reg,Arizona Cardinals,Oakland Raiders,ARI,20,23,3,2.5,43,41.5,FALSE,0,0,"",0.5,1.5
1998,5,reg,Atlanta Falcons,Carolina Panthers,ATL,51,23,28,3,74,39,FALSE,1,0,DOME,25,35
1998,5,reg,Buffalo Bills,San Francisco 49ers,SF,26,21,5,10,47,45,FALSE,0,0,"",5,2
1998,5,reg,Chicago Bears,Detroit Lions,CHI,31,27,4,2,58,38,FALSE,0,0,"",2,20
1998,5,reg,Denver Broncos,Philadelphia Eagles,DEN,41,16,25,15.5,57,42.5,FALSE,0,0,"",9.5,14.5
1998,5,reg,Indianapolis Colts,San Diego Chargers,IND,17,12,5,1,29,36.5,FALSE,1,0,DOME,4,7.5
1998,5,reg,Kansas City Chiefs,Seattle Seahawks,KC,17,6,11,4,23,36.5,FALSE,0,0,"",7,13.5
1998,5,reg,New Orleans Saints,New England Patriots,NE,27,30,3,7,57,36,FALSE,1,0,DOME,4,21
1998,5,reg,New York Jets,Miami Dolphins,NYJ,20,9,11,2.5,29,40,FALSE,0,0,"",8.5,11
1998,5,reg,Tampa Bay Buccaneers,New York Giants,TB,20,3,17,4,23,35,FALSE,0,0,"",13,12
1998,5,reg,Washington Redskins,Dallas Cowboys,WAS,10,31,21,1,41,38.5,FALSE,0,0,"",20,2.5
1998,5,reg,Green Bay Packers,Minnesota Vikings,GB,24,37,13,7,61,47,FALSE,0,0,"",6,14
1998,6,reg,Arizona Cardinals,Chicago Bears,ARI,20,7,13,3,27,42.5,FALSE,0,0,"",10,15.5
1998,6,reg,Baltimore Ravens,Tennessee Oilers,BAL,8,12,4,3.5,20,41,FALSE,0,0,"",0.5,21
1998,6,reg,Cincinnati Bengals,Pittsburgh Steelers,PIT,25,20,5,2.5,45,40.5,FALSE,0,0,"",2.5,4.5
1998,6,reg,Dallas Cowboys,Carolina Panthers,DAL,27,20,7,7,47,39,FALSE,0,0,"",0,8
1998,6,reg,Indianapolis Colts,Buffalo Bills,BUF,24,31,7,3,55,37,FALSE,1,0,DOME,4,18
1998,6,reg,New England Patriots,Kansas City Chiefs,NE,40,10,30,3,50,37.5,FALSE,0,0,"",27,12.5
1998,6,reg,New Orleans Saints,San Francisco 49ers,SF,0,31,31,10.5,31,43,FALSE,1,0,DOME,20.5,12
1998,6,reg,New York Giants,Atlanta Falcons,NYG,20,34,14,2.5,54,37.5,FALSE,0,0,"",11.5,16.5
1998,6,reg,Oakland Raiders,San Diego Chargers,OAK,7,6,1,5,13,36.5,FALSE,0,0,"",4,23.5
1998,6,reg,Philadelphia Eagles,Washington Redskins,WAS,17,12,5,2.5,29,39,FALSE,0,0,"",2.5,10
1998,6,reg,Seattle Seahawks,Denver Broncos,DEN,16,21,5,6.5,37,45,FALSE,1,0,DOME,1.5,8
1998,6,reg,St. Louis Rams,New York Jets,NYJ,30,10,20,3,40,43,FALSE,1,0,DOME,17,3
1998,6,reg,Jacksonville Jaguars,Miami Dolphins,JAX,28,21,7,6.5,49,40,FALSE,0,0,"",0.5,9
1998,7,reg,Detroit Lions,Green Bay Packers,GB,27,20,7,7,47,44,FALSE,1,0,DOME,0,3
1998,7,reg,Atlanta Falcons,New Orleans Saints,ATL,31,23,8,7,54,37.5,FALSE,1,0,DOME,1,16.5
1998,7,reg,Buffalo Bills,Jacksonville Jaguars,JAX,17,16,1,3,33,42.5,FALSE,0,0,"",2,9.5
1998,7,reg,Chicago Bears,Dallas Cowboys,DAL,13,12,1,3,25,40.5,FALSE,0,0,"",2,15.5
1998,7,reg,Miami Dolphins,St. Louis Rams,MIA,14,0,14,7,14,39.5,FALSE,0,0,"",7,25.5
1998,7,reg,Minnesota Vikings,Washington Redskins,MIN,41,7,34,13.5,48,46,FALSE,1,0,DOME,20.5,2
1998,7,reg,New York Giants,Arizona Cardinals,NYG,34,7,27,2.5,41,37,FALSE,0,0,"",24.5,4
1998,7,reg,Pittsburgh Steelers,Baltimore Ravens,PIT,16,6,10,6,22,37,FALSE,0,0,"",4,15
1998,7,reg,San Diego Chargers,Philadelphia Eagles,LAC,13,10,3,3,23,34,FALSE,0,0,"",0,11
1998,7,reg,San Francisco 49ers,Indianapolis Colts,SF,34,31,3,18,65,44.5,FALSE,0,0,"",15,20.5
1998,7,reg,Tampa Bay Buccaneers,Carolina Panthers,TB,16,13,3,7,29,37,FALSE,0,0,"",4,8
1998,7,reg,Tennessee Oilers,Cincinnati Bengals,TEN,44,14,30,3,58,39.5,FALSE,0,0,"",27,18.5
1998,7,reg,New England Patriots,New York Jets,NE,14,24,10,6.5,38,43.5,FALSE,0,0,"",3.5,5.5
1998,8,reg,Carolina Panthers,Buffalo Bills,CAR,14,30,16,1.5,44,38,FALSE,0,0,"",14.5,6
1998,8,reg,Denver Broncos,Jacksonville Jaguars,DEN,37,24,13,8,61,48,FALSE,0,0,"",5,13
1998,8,reg,Detroit Lions,Minnesota Vikings,MIN,13,34,21,5,47,47,FALSE,1,0,DOME,16,0
1998,8,reg,Green Bay Packers,Baltimore Ravens,GB,28,10,18,10.5,38,41.5,FALSE,0,0,"",7.5,3.5
1998,8,reg,Miami Dolphins,New England Patriots,MIA,12,9,3,2,21,36.5,FALSE,0,0,"",1,15.5
1998,8,reg,New Orleans Saints,Tampa Bay Buccaneers,TB,9,3,6,3,12,35,FALSE,1,0,DOME,3,23
1998,8,reg,New York Jets,Atlanta Falcons,NYJ,28,3,25,6.5,31,41.5,FALSE,0,0,"",18.5,10.5
1998,8,reg,Oakland Raiders,Cincinnati Bengals,OAK,27,10,17,2.5,37,39.5,FALSE,0,0,"",14.5,2.5
1998,8,reg,San Diego Chargers,Seattle Seahawks,SEA,20,27,7,6.5,47,35,FALSE,0,0,"",0.5,12
1998,8,reg,St. Louis Rams,San Francisco 49ers,SF,10,28,18,9.5,38,47,FALSE,1,0,DOME,8.5,9
1998,8,reg,Tennessee Oilers,Chicago Bears,TEN,20,23,3,6,43,40.5,FALSE,0,0,"",3,2.5
1998,8,reg,Kansas City Chiefs,Pittsburgh Steelers,KC,13,20,7,6,33,36.5,FALSE,0,0,"",1,3.5
1998,9,reg,Atlanta Falcons,St. Louis Rams,ATL,37,15,22,7,52,41,FALSE,1,0,DOME,15,11
1998,9,reg,Baltimore Ravens,Jacksonville Jaguars,JAX,19,45,26,3.5,64,42,FALSE,0,0,"",22.5,22
1998,9,reg,Buffalo Bills,Miami Dolphins,BUF,30,24,6,2.5,54,35,FALSE,0,0,"",3.5,19
1998,9,reg,Carolina Panthers,New Orleans Saints,CAR,31,17,14,3,48,36,FALSE,0,0,"",11,12
1998,9,reg,Cincinnati Bengals,Denver Broncos,DEN,26,33,7,11,59,48.5,FALSE,0,0,"",4,10.5
1998,9,reg,Detroit Lions,Arizona Cardinals,DET,15,17,2,6,32,42.5,FALSE,1,0,DOME,4,10.5
1998,9,reg,Green Bay Packers,San Francisco 49ers,GB,36,22,14,3,58,49,FALSE,0,0,"",11,9
1998,9,reg,Indianapolis Colts,New England Patriots,NE,16,21,5,5.5,37,37.5,FALSE,1,0,DOME,0.5,0.5
1998,9,reg,Kansas City Chiefs,New York Jets,KC,17,20,3,4.5,37,37,FALSE,0,0,"",1.5,0
1998,9,reg,Pittsburgh Steelers,Tennessee Oilers,PIT,31,41,10,5.5,72,37,FALSE,0,0,"",4.5,35
1998,9,reg,Seattle Seahawks,Oakland Raiders,SEA,18,31,13,7,49,40,FALSE,1,0,DOME,6,9
1998,9,reg,Tampa Bay Buccaneers,Minnesota Vikings,MIN,27,24,3,6.5,51,39.5,FALSE,0,0,"",3.5,11.5
1998,9,reg,Washington Redskins,New York Giants,NYG,21,14,7,2.5,35,38,FALSE,0,0,"",4.5,3
1998,9,reg,Philadelphia Eagles,Dallas Cowboys,DAL,0,34,34,6.5,34,37,FALSE,0,0,"",27.5,3
1998,10,reg,Arizona Cardinals,Washington Redskins,ARI,29,27,2,4.5,56,38,FALSE,0,0,"",2.5,18
1998,10,reg,Baltimore Ravens,Oakland Raiders,OAK,13,10,3,2,23,39,FALSE,0,0,"",1,16
1998,10,reg,Chicago Bears,St. Louis Rams,CHI,12,20,8,3,32,38.5,FALSE,0,0,"",5,6.5
1998,10,reg,Dallas Cowboys,New York Giants,DAL,16,6,10,8,22,37.5,FALSE,0,0,"",2,15.5
1998,10,reg,Denver Broncos,San Diego Chargers,DEN,27,10,17,16,37,44,FALSE,0,0,"",1,7
1998,10,reg,Jacksonville Jaguars,Cincinnati Bengals,JAX,24,11,13,10.5,35,46.5,FALSE,0,0,"",2.5,11.5
1998,10,reg,Miami Dolphins,Indianapolis Colts,MIA,27,14,13,9.5,41,37,FALSE,0,0,"",3.5,4
1998,10,reg,Minnesota Vikings,New Orleans Saints,MIN,31,24,7,14,55,44,FALSE,1,0,DOME,7,11
1998,10,reg,New England Patriots,Atlanta Falcons,NE,10,41,31,4.5,51,41,FALSE,0,0,"",26.5,10
1998,10,reg,New York Jets,Buffalo Bills,NYJ,34,12,22,4,46,42,FALSE,0,0,"",18,4
1998,10,reg,Philadelphia Eagles,Detroit Lions,DET,10,9,1,4,19,36.5,FALSE,0,0,"",3,17.5
1998,10,reg,San Francisco 49ers,Carolina Panthers,SF,25,23,2,13.5,48,43.5,FALSE,0,0,"",11.5,4.5
1998,10,reg,Seattle Seahawks,Kansas City Chiefs,SEA,24,12,12,3,36,40,FALSE,1,0,DOME,9,4
1998,10,reg,Tampa Bay Buccaneers,Tennessee Oilers,TB,22,31,9,3,53,37,FALSE,0,0,"",6,16
1998,10,reg,Pittsburgh Steelers,Green Bay Packers,GB,27,20,7,3,47,41.5,FALSE,0,0,"",4,5.5
1998,11,reg,Arizona Cardinals,Dallas Cowboys,DAL,28,35,7,3.5,63,38.5,FALSE,0,0,"",3.5,24.5
1998,11,reg,Atlanta Falcons,San Francisco 49ers,SF,31,19,12,3,50,50,FALSE,1,0,DOME,9,0
1998,11,reg,Buffalo Bills,New England Patriots,BUF,13,10,3,3,23,39,FALSE,0,0,"",0,16
1998,11,reg,Carolina Panthers,Miami Dolphins,MIA,9,13,4,3,22,38,FALSE,0,0,"",1,16
1998,11,reg,Detroit Lions,Chicago Bears,DET,26,3,23,6.5,29,39,FALSE,1,0,DOME,16.5,10
1998,11,reg,Indianapolis Colts,New York Jets,NYJ,24,23,1,6.5,47,41.5,FALSE,1,0,DOME,5.5,5.5
1998,11,reg,Jacksonville Jaguars,Tampa Bay Buccaneers,JAX,29,24,5,6.5,53,39.5,FALSE,0,0,"",1.5,13.5
1998,11,reg,Minnesota Vikings,Cincinnati Bengals,MIN,24,3,21,11,27,46,FALSE,1,0,DOME,10,19
1998,11,reg,New Orleans Saints,St. Louis Rams,NO,24,3,21,3,27,37.5,FALSE,1,0,DOME,18,10.5
1998,11,reg,New York Giants,Green Bay Packers,GB,3,37,34,7,40,39,FALSE,0,0,"",27,1
1998,11,reg,Oakland Raiders,Seattle Seahawks,SEA,20,17,3,1.5,37,38,FALSE,0,0,"",1.5,1
1998,11,reg,San Diego Chargers,Baltimore Ravens,PICK,14,13,1,0,27,33.5,FALSE,0,0,"",1,6.5
1998,11,reg,Tennessee Oilers,Pittsburgh Steelers,TEN,23,14,9,1.5,37,38,FALSE,0,0,"",7.5,1
1998,11,reg,Washington Redskins,Philadelphia Eagles,WAS,28,3,25,4,31,36,FALSE,0,0,"",21,5
1998,11,reg,Kansas City Chiefs,Denver Broncos,DEN,7,30,23,4,37,40,FALSE,0,0,"",19,3
1998,12,reg,Atlanta Falcons,Chicago Bears,ATL,20,13,7,12,33,41.5,FALSE,1,0,DOME,5,8.5
1998,12,reg,Buffalo Bills,Indianapolis Colts,BUF,34,11,23,7,45,39.5,FALSE,0,0,"",16,5.5
1998,12,reg,Cincinnati Bengals,Baltimore Ravens,CIN,13,20,7,1.5,33,37,FALSE,0,0,"",5.5,4
1998,12,reg,Dallas Cowboys,Seattle Seahawks,DAL,30,22,8,5.5,52,40,FALSE,0,0,"",2.5,12
1998,12,reg,Denver Broncos,Oakland Raiders,DEN,40,14,26,11,54,44,FALSE,0,0,"",15,10
1998,12,reg,Minnesota Vikings,Green Bay Packers,MIN,28,14,14,3,42,49.5,FALSE,1,0,DOME,11,7.5
1998,12,reg,New York Giants,Philadelphia Eagles,NYG,20,0,20,5.5,20,33.5,FALSE,0,0,"",14.5,13.5
1998,12,reg,Pittsburgh Steelers,Jacksonville Jaguars,PIT,30,15,15,2.5,45,41,FALSE,0,0,"",12.5,4
1998,12,reg,San Diego Chargers,Kansas City Chiefs,KC,38,37,1,3,75,33.5,FALSE,0,0,"",2,41.5
1998,12,reg,San Francisco 49ers,New Orleans Saints,SF,31,20,11,12.5,51,44,FALSE,0,0,"",1.5,7
1998,12,reg,St. Louis Rams,Carolina Panthers,LAR,20,24,4,1.5,44,40,FALSE,1,0,DOME,2.5,4
1998,12,reg,Tampa Bay Buccaneers,Detroit Lions,TB,25,28,3,6,53,36,FALSE,0,0,"",3,17
1998,12,reg,Tennessee Oilers,New York Jets,TEN,3,24,21,2.5,27,42.5,FALSE,0,0,"",18.5,15.5
1998,12,reg,Washington Redskins,Arizona Cardinals,WAS,42,45,3,1,87,41,FALSE,0,0,"",2,46
1998,12,reg,New England Patriots,Miami Dolphins,NE,26,23,3,3,49,36.5,FALSE,0,0,"",0,12.5
1998,13,reg,Dallas Cowboys,Minnesota Vikings,MIN,36,46,10,3,82,46.5,FALSE,0,0,"",7,35.5
1998,13,reg,Detroit Lions,Pittsburgh Steelers,PIT,19,16,3,2.5,35,41,FALSE,1,0,DOME,0.5,6
1998,13,reg,Baltimore Ravens,Indianapolis Colts,BAL,38,31,7,6,69,39,FALSE,0,0,"",1,30
1998,13,reg,Chicago Bears,Tampa Bay Buccaneers,TB,17,31,14,3.5,48,36,FALSE,0,0,"",10.5,12
1998,13,reg,Cincinnati Bengals,Jacksonville Jaguars,JAX,17,34,17,7,51,45,FALSE,0,0,"",10,6
1998,13,reg,Green Bay Packers,Philadelphia Eagles,GB,24,16,8,18,40,37,FALSE,0,0,"",10,3
1998,13,reg,Kansas City Chiefs,Arizona Cardinals,KC,34,24,10,3,58,42.5,FALSE,0,0,"",7,15.5
1998,13,reg,Miami Dolphins,New Orleans Saints,MIA,30,10,20,8.5,40,37.5,FALSE,0,0,"",11.5,2.5
1998,13,reg,New England Patriots,Buffalo Bills,NE,25,21,4,1.5,46,38,FALSE,0,0,"",2.5,8
1998,13,reg,New York Jets,Carolina Panthers,NYJ,48,21,27,9,69,42,FALSE,0,0,"",18,27
1998,13,reg,Oakland Raiders,Washington Redskins,OAK,19,29,10,7,48,41.5,FALSE,0,0,"",3,6.5
1998,13,reg,San Diego Chargers,Denver Broncos,DEN,16,31,15,13,47,44.5,FALSE,0,0,"",2,2.5
1998,13,reg,Seattle Seahawks,Tennessee Oilers,SEA,20,18,2,2.5,38,41,FALSE,1,0,DOME,0.5,3
1998,13,reg,St. Louis Rams,Atlanta Falcons,ATL,10,21,11,4,31,41,FALSE,1,0,DOME,7,10
1998,13,reg,San Francisco 49ers,New York Giants,SF,31,7,24,13,38,44,FALSE,0,0,"",11,6
1998,14,reg,Philadelphia Eagles,St. Louis Rams,PHI,17,14,3,1,31,35,FALSE,0,0,"",2,4
1998,14,reg,Arizona Cardinals,New York Giants,ARI,19,23,4,4.5,42,41.5,FALSE,0,0,"",0.5,0.5
1998,14,reg,Atlanta Falcons,Indianapolis Colts,ATL,28,21,7,12,49,46,FALSE,1,0,DOME,5,3
1998,14,reg,Carolina Panthers,San Francisco 49ers,SF,28,31,3,9.5,59,48,FALSE,0,0,"",6.5,11
1998,14,reg,Cincinnati Bengals,Buffalo Bills,BUF,20,33,13,4.5,53,43,FALSE,0,0,"",8.5,10
1998,14,reg,Denver Broncos,Kansas City Chiefs,DEN,35,31,4,13.5,66,45,FALSE,0,0,"",9.5,21
1998,14,reg,Jacksonville Jaguars,Detroit Lions,JAX,37,22,15,7,59,44.5,FALSE,0,0,"",8,14.5
1998,14,reg,Minnesota Vikings,Chicago Bears,MIN,48,22,26,16,70,46,FALSE,1,0,DOME,10,24
1998,14,reg,New Orleans Saints,Dallas Cowboys,DAL,22,3,19,6.5,25,41,FALSE,1,0,DOME,12.5,16
1998,14,reg,New York Jets,Seattle Seahawks,NYJ,32,31,1,7,63,42.5,FALSE,0,0,"",6,20.5
1998,14,reg,Oakland Raiders,Miami Dolphins,MIA,17,27,10,2.5,44,37,FALSE,0,0,"",7.5,7
1998,14,reg,Pittsburgh Steelers,New England Patriots,PIT,9,23,14,4.5,32,39,FALSE,0,0,"",9.5,7
1998,14,reg,Tennessee Oilers,Baltimore Ravens,TEN,16,14,2,6,30,40,FALSE,0,0,"",4,10
1998,14,reg,Washington Redskins,San Diego Chargers,WAS,24,20,4,3,44,41,FALSE,0,0,"",1,3
1998,14,reg,Tampa Bay Buccaneers,Green Bay Packers,GB,24,22,2,4,46,42,FALSE,0,0,"",2,4
1998,15,reg,Baltimore Ravens,Minnesota Vikings,MIN,28,38,10,10,66,46,FALSE,0,0,"",0,20
1998,15,reg,Buffalo Bills,Oakland Raiders,BUF,44,21,23,8.5,65,38,FALSE,0,0,"",14.5,27
1998,15,reg,Carolina Panthers,Washington Redskins,CAR,25,28,3,3,53,45.5,FALSE,0,0,"",0,7.5
1998,15,reg,Green Bay Packers,Chicago Bears,GB,26,20,6,13.5,46,42,FALSE,0,0,"",7.5,4
1998,15,reg,Indianapolis Colts,Cincinnati Bengals,IND,39,26,13,4,65,47,FALSE,1,0,DOME,9,18
1998,15,reg,Jacksonville Jaguars,Tennessee Oilers,JAX,13,16,3,4,29,40,FALSE,0,0,"",1,11
1998,15,reg,Kansas City Chiefs,Dallas Cowboys,KC,20,17,3,2.5,37,44,FALSE,0,0,"",0.5,7
1998,15,reg,Miami Dolphins,New York Jets,MIA,16,21,5,3,37,40,FALSE,0,0,"",2,3
1998,15,reg,New Orleans Saints,Atlanta Falcons,ATL,17,27,10,4,44,41.5,FALSE,1,0,DOME,6,2.5
1998,15,reg,New York Giants,Denver Broncos,DEN,20,16,4,13,36,45,FALSE,0,0,"",9,9
1998,15,reg,Philadelphia Eagles,Arizona Cardinals,ARI,17,20,3,3,37,38,FALSE,0,0,"",0,1
1998,15,reg,Seattle Seahawks,San Diego Chargers,SEA,38,17,21,7,55,40.5,FALSE,1,0,DOME,14,14.5
1998,15,reg,St. Louis Rams,New England Patriots,NE,32,18,14,7,50,40,FALSE,1,0,DOME,7,10
1998,15,reg,Tampa Bay Buccaneers,Pittsburgh Steelers,TB,16,3,13,3,19,37.5,FALSE,0,0,"",10,18.5
1998,15,reg,San Francisco 49ers,Detroit Lions,SF,35,13,22,10,48,48,FALSE,0,0,"",12,0
1998,16,reg,Buffalo Bills,New York Jets,BUF,10,17,7,2.5,27,43,FALSE,0,0,"",4.5,16
1998,16,reg,Washington Redskins,Tampa Bay Buccaneers,TB,20,16,4,3,36,41,FALSE,0,0,"",1,5
1998,16,reg,Arizona Cardinals,New Orleans Saints,ARI,19,17,2,3.5,36,41.5,FALSE,0,0,"",1.5,5.5
1998,16,reg,Carolina Panthers,St. Louis Rams,CAR,20,13,7,3,33,44.5,FALSE,0,0,"",4,11.5
1998,16,reg,Chicago Bears,Baltimore Ravens,PICK,24,3,21,0,27,37,FALSE,0,0,"",21,10
1998,16,reg,Dallas Cowboys,Philadelphia Eagles,DAL,13,9,4,10.5,22,37,FALSE,0,0,"",6.5,15
1998,16,reg,Detroit Lions,Atlanta Falcons,ATL,17,24,7,6.5,41,45,FALSE,1,0,DOME,0.5,4
1998,16,reg,Green Bay Packers,Tennessee Oilers,GB,30,22,8,6.5,52,41.5,FALSE,0,0,"",1.5,10.5
1998,16,reg,Minnesota Vikings,Jacksonville Jaguars,MIN,50,10,40,13.5,60,48,FALSE,1,0,DOME,26.5,12
1998,16,reg,New England Patriots,San Francisco 49ers,SF,24,21,3,7,45,44,FALSE,0,0,"",4,1
1998,16,reg,New York Giants,Kansas City Chiefs,NYG,28,7,21,1.5,35,38,FALSE,0,0,"",19.5,3
1998,16,reg,Pittsburgh Steelers,Cincinnati Bengals,PIT,24,25,1,10.5,49,40,FALSE,0,0,"",9.5,9
1998,16,reg,San Diego Chargers,Oakland Raiders,LAC,10,17,7,3,27,37,FALSE,0,0,"",4,10
1998,16,reg,Seattle Seahawks,Indianapolis Colts,SEA,27,23,4,7,50,47.5,FALSE,1,0,DOME,3,2.5
1998,16,reg,Miami Dolphins,Denver Broncos,DEN,31,21,10,4,52,44,FALSE,0,0,"",6,8
1998,17,reg,Oakland Raiders,Kansas City Chiefs,OAK,24,31,7,3,55,39.5,FALSE,0,0,"",4,15.5
1998,17,reg,Tennessee Oilers,Minnesota Vikings,MIN,16,26,10,7,42,48,FALSE,0,0,"",3,6
1998,17,reg,Arizona Cardinals,San Diego Chargers,ARI,16,13,3,7.5,29,40,FALSE,0,0,"",4.5,11
1998,17,reg,Atlanta Falcons,Miami Dolphins,ATL,38,16,22,3,54,41.5,FALSE,1,0,DOME,19,12.5
1998,17,reg,Baltimore Ravens,Detroit Lions,BAL,19,10,9,2,29,38.5,FALSE,0,0,"",7,9.5
1998,17,reg,Chicago Bears,Green Bay Packers,GB,13,16,3,7,29,40.5,FALSE,0,0,"",4,11.5
1998,17,reg,Cincinnati Bengals,Tampa Bay Buccaneers,TB,0,35,35,6.5,35,42,FALSE,0,0,"",28.5,7
1998,17,reg,Dallas Cowboys,Washington Redskins,WAS,23,7,16,1.5,30,41,FALSE,0,0,"",14.5,11
1998,17,reg,Denver Broncos,Seattle Seahawks,DEN,28,21,7,10,49,46.5,FALSE,0,0,"",3,2.5
1998,17,reg,Indianapolis Colts,Carolina Panthers,IND,19,27,8,5,46,49,FALSE,1,0,DOME,3,3
1998,17,reg,New Orleans Saints,Buffalo Bills,BUF,33,45,12,2.5,78,41,FALSE,1,0,DOME,9.5,37
1998,17,reg,New York Jets,New England Patriots,NYJ,31,10,21,6.5,41,41,FALSE,0,0,"",14.5,0
1998,17,reg,Philadelphia Eagles,New York Giants,NYG,10,20,10,4,30,34,FALSE,0,0,"",6,4
1998,17,reg,San Francisco 49ers,St. Louis Rams,SF,38,19,19,12.5,57,45,FALSE,0,0,"",6.5,12
1998,17,reg,Jacksonville Jaguars,Pittsburgh Steelers,JAX,21,3,18,3,24,41,FALSE,0,0,"",15,17
1998,Wildcard,post,Dallas Cowboys,Arizona Cardinals,DAL,7,20,13,7,27,42,FALSE,0,0,"",6,15
1998,Wildcard,post,Miami Dolphins,Buffalo Bills,MIA,24,17,7,2.5,41,43,FALSE,0,0,"",4.5,2
1998,Wildcard,post,Jacksonville Jaguars,New England Patriots,JAX,25,10,15,8.5,35,41,FALSE,0,0,"",6.5,6
1998,Wildcard,post,San Francisco 49ers,Green Bay Packers,SF,30,27,3,3,57,49.5,FALSE,0,0,"",0,7.5
1998,Division,post,Atlanta Falcons,San Francisco 49ers,ATL,20,18,2,3.5,38,53,FALSE,1,0,DOME,1.5,15
1998,Division,post,Denver Broncos,Miami Dolphins,DEN,38,3,35,13.5,41,48,FALSE,0,0,"",21.5,7
1998,Division,post,Minnesota Vikings,Arizona Cardinals,MIN,41,21,20,16.5,62,52.5,FALSE,1,0,DOME,3.5,9.5
1998,Division,post,New York Jets,Jacksonville Jaguars,NYJ,34,24,10,9,58,43,FALSE,0,0,"",1,15
1998,Conference,post,Denver Broncos,New York Jets,DEN,23,10,13,9,33,50.5,FALSE,0,0,"",4,17.5
1998,Conference,post,Minnesota Vikings,Atlanta Falcons,MIN,27,30,3,11,57,55.5,FALSE,1,0,DOME,8,1.5
1998,Superbowl,post,Denver Broncos,Atlanta Falcons,DEN,34,19,15,7.5,53,52.5,TRUE,0,0,"",7.5,0.5
1999,1,reg,Atlanta Falcons,Minnesota Vikings,MIN,14,17,3,4,31,49,FALSE,1,0,DOME,1,18
1999,1,reg,Chicago Bears,Kansas City Chiefs,KC,20,17,3,3,37,38,FALSE,0,0,"",0,1
1999,1,reg,Cleveland Browns,Pittsburgh Steelers,PIT,0,43,43,6,43,37,FALSE,0,0,"",37,6
1999,1,reg,Green Bay Packers,Oakland Raiders,GB,28,24,4,9,52,43,FALSE,0,0,"",5,9
1999,1,reg,Indianapolis Colts,Buffalo Bills,BUF,31,14,17,3,45,45.5,FALSE,1,0,DOME,14,0.5
1999,1,reg,Jacksonville Jaguars,San Francisco 49ers,JAX,41,3,38,5.5,44,49,FALSE,0,0,"",32.5,5
1999,1,reg,New Orleans Saints,Carolina Panthers,NO,19,10,9,3.5,29,38,FALSE,1,0,DOME,5.5,9
1999,1,reg,New York Jets,New England Patriots,NYJ,28,30,2,7,58,44.5,FALSE,0,0,"",5,13.5
1999,1,reg,Philadelphia Eagles,Arizona Cardinals,ARI,24,25,1,3,49,37,FALSE,0,0,"",2,12
1999,1,reg,Seattle Seahawks,Detroit Lions,SEA,20,28,8,9.5,48,42,FALSE,1,0,DOME,1.5,6
1999,1,reg,St. Louis Rams,Baltimore Ravens,PICK,27,10,17,0,37,39,FALSE,1,0,DOME,17,2
1999,1,reg,Tampa Bay Buccaneers,New York Giants,TB,13,17,4,5.5,30,37.5,FALSE,0,0,"",1.5,7.5
1999,1,reg,Tennessee Titans,Cincinnati Bengals,TEN,36,35,1,9,71,42,FALSE,0,0,"",8,29
1999,1,reg,Washington Redskins,Dallas Cowboys,WAS,35,41,6,2.5,76,42,FALSE,0,0,"",3.5,34
1999,1,reg,Denver Broncos,Miami Dolphins,DEN,21,38,17,6,59,43,FALSE,0,0,"",11,16
1999,2,reg,Baltimore Ravens,Pittsburgh Steelers,PIT,20,23,3,2.5,43,38,FALSE,0,0,"",0.5,5
1999,2,reg,Buffalo Bills,New York Jets,BUF,17,3,14,4,20,42,FALSE,0,0,"",10,22
1999,2,reg,Carolina Panthers,Jacksonville Jaguars,JAX,20,22,2,9.5,42,44,FALSE,0,0,"",7.5,2
1999,2,reg,Chicago Bears,Seattle Seahawks,SEA,13,14,1,3.5,27,39,FALSE,0,0,"",2.5,12
1999,2,reg,Cincinnati Bengals,San Diego Chargers,CIN,7,34,27,1,41,40.5,FALSE,0,0,"",26,0.5
1999,2,reg,Detroit Lions,Green Bay Packers,GB,23,15,8,6.5,38,43,FALSE,1,0,DOME,1.5,5
1999,2,reg,Kansas City Chiefs,Denver Broncos,DEN,26,10,16,3.5,36,40.5,FALSE,0,0,"",12.5,4.5
1999,2,reg,Miami Dolphins,Arizona Cardinals,MIA,19,16,3,9,35,41,FALSE,0,0,"",6,6
1999,2,reg,Minnesota Vikings,Oakland Raiders,MIN,17,22,5,11,39,47.5,FALSE,1,0,DOME,6,8.5
1999,2,reg,New England Patriots,Indianapolis Colts,NE,31,28,3,4.5,59,45,FALSE,0,0,"",1.5,14
1999,2,reg,New York Giants,Washington Redskins,NYG,21,50,29,2.5,71,41,FALSE,0,0,"",26.5,30
1999,2,reg,Philadelphia Eagles,Tampa Bay Buccaneers,TB,5,19,14,6.5,24,36.5,FALSE,0,0,"",7.5,12.5
1999,2,reg,San Francisco 49ers,New Orleans Saints,SF,28,21,7,11,49,42.5,FALSE,0,0,"",4,6.5
1999,2,reg,Tennessee Titans,Cleveland Browns,TEN,26,9,17,16,35,40,FALSE,0,0,"",1,5
1999,2,reg,Dallas Cowboys,Atlanta Falcons,DAL,24,7,17,6.5,31,42,FALSE,0,0,"",10.5,11
1999,3,reg,Baltimore Ravens,Cleveland Browns,BAL,17,10,7,12,27,36.5,FALSE,0,0,"",5,9.5
1999,3,reg,Buffalo Bills,Philadelphia Eagles,BUF,26,0,26,11.5,26,38,FALSE,0,0,"",14.5,12
1999,3,reg,Carolina Panthers,Cincinnati Bengals,CAR,27,3,24,7,30,39.5,FALSE,0,0,"",17,9.5
1999,3,reg,Green Bay Packers,Minnesota Vikings,PICK,23,20,3,0,43,47.5,FALSE,0,0,"",3,4.5
1999,3,reg,Jacksonville Jaguars,Tennessee Titans,JAX,19,20,1,9.5,39,45,FALSE,0,0,"",8.5,6
1999,3,reg,Kansas City Chiefs,Detroit Lions,KC,31,21,10,3.5,52,39.5,FALSE,0,0,"",6.5,12.5
1999,3,reg,New England Patriots,New York Giants,NE,16,14,2,6,30,43.5,FALSE,0,0,"",4,13.5
1999,3,reg,New York Jets,Washington Redskins,WAS,20,27,7,1,47,43.5,FALSE,0,0,"",6,3.5
1999,3,reg,Oakland Raiders,Chicago Bears,OAK,24,17,7,7,41,38,FALSE,0,0,"",0,3
1999,3,reg,Pittsburgh Steelers,Seattle Seahawks,PIT,10,29,19,4,39,38,FALSE,0,0,"",15,1
1999,3,reg,San Diego Chargers,Indianapolis Colts,IND,19,27,8,1,46,44,FALSE,0,0,"",7,2
1999,3,reg,St. Louis Rams,Atlanta Falcons,ATL,35,7,28,1.5,42,40.5,FALSE,1,0,DOME,26.5,1.5
1999,3,reg,Tampa Bay Buccaneers,Denver Broncos,TB,13,10,3,2.5,23,38,FALSE,0,0,"",0.5,15
1999,3,reg,Arizona Cardinals,San Francisco 49ers,SF,10,24,14,2.5,34,45.5,FALSE,0,0,"",11.5,11.5
1999,4,reg,Atlanta Falcons,Baltimore Ravens,ATL,13,19,6,2.5,32,36.5,FALSE,1,0,DOME,3.5,4.5
1999,4,reg,Chicago Bears,New Orleans Saints,NO,14,10,4,1,24,37,FALSE,0,0,"",3,13
1999,4,reg,Cincinnati Bengals,St. Louis Rams,LAR,10,38,28,3.5,48,44,FALSE,0,0,"",24.5,4
1999,4,reg,Cleveland Browns,New England Patriots,NE,7,19,12,12,26,38,FALSE,0,0,"",0,12
1999,4,reg,Dallas Cowboys,Arizona Cardinals,DAL,35,7,28,7,42,42.5,FALSE,0,0,"",21,0.5
1999,4,reg,Denver Broncos,New York Jets,DEN,13,21,8,5.5,34,40,FALSE,0,0,"",2.5,6
1999,4,reg,Minnesota Vikings,Tampa Bay Buccaneers,MIN,21,14,7,7,35,40.5,FALSE,1,0,DOME,0,5.5
1999,4,reg,New York Giants,Philadelphia Eagles,NYG,16,15,1,9.5,31,35.5,FALSE,0,0,"",8.5,4.5
1999,4,reg,Pittsburgh Steelers,Jacksonville Jaguars,JAX,3,17,14,3,20,42,FALSE,0,0,"",11,22
1999,4,reg,San Diego Chargers,Kansas City Chiefs,LAC,21,14,7,1,35,38.5,FALSE,0,0,"",6,3.5
1999,4,reg,San Francisco 49ers,Tennessee Titans,SF,24,22,2,1.5,46,40.5,FALSE,0,0,"",0.5,5.5
1999,4,reg,Seattle Seahawks,Oakland Raiders,SEA,22,21,1,3.5,43,40.5,FALSE,1,0,DOME,2.5,2.5
1999,4,reg,Washington Redskins,Carolina Panthers,WAS,38,36,2,8.5,74,45.5,FALSE,0,0,"",6.5,28.5
1999,4,reg,Miami Dolphins,Buffalo Bills,MIA,18,23,5,4.5,41,40.5,FALSE,0,0,"",0.5,0.5
1999,5,reg,Arizona Cardinals,New York Giants,ARI,14,3,11,3,17,37.5,FALSE,0,0,"",8,20.5
1999,5,reg,Buffalo Bills,Pittsburgh Steelers,BUF,24,21,3,6.5,45,38,FALSE,0,0,"",3.5,7
1999,5,reg,Cleveland Browns,Cincinnati Bengals,CIN,17,18,1,3,35,36,FALSE,0,0,"",2,1
1999,5,reg,Detroit Lions,San Diego Chargers,DET,10,20,10,3.5,30,40,FALSE,1,0,DOME,6.5,10
1999,5,reg,Green Bay Packers,Tampa Bay Buccaneers,GB,26,23,3,6,49,40.5,FALSE,0,0,"",3,8.5
1999,5,reg,Indianapolis Colts,Miami Dolphins,MIA,31,34,3,1.5,65,44.5,FALSE,1,0,DOME,1.5,20.5
1999,5,reg,Kansas City Chiefs,New England Patriots,KC,16,14,2,2.5,30,41,FALSE,0,0,"",0.5,11
1999,5,reg,Minnesota Vikings,Chicago Bears,MIN,22,24,2,13,46,43.5,FALSE,1,0,DOME,11,2.5
1999,5,reg,New Orleans Saints,Atlanta Falcons,NO,17,20,3,3,37,35.5,FALSE,1,0,DOME,0,1.5
1999,5,reg,Oakland Raiders,Denver Broncos,OAK,13,16,3,7,29,38,FALSE,0,0,"",4,9
1999,5,reg,Philadelphia Eagles,Dallas Cowboys,DAL,13,10,3,9.5,23,37,FALSE,0,0,"",6.5,14
1999,5,reg,St. Louis Rams,San Francisco 49ers,LAR,42,20,22,3,62,45.5,FALSE,1,0,DOME,19,16.5
1999,5,reg,Tennessee Titans,Baltimore Ravens,TEN,14,11,3,7,25,38.5,FALSE,0,0,"",4,13.5
1999,5,reg,New York Jets,Jacksonville Jaguars,JAX,6,16,10,3,22,40,FALSE,0,0,"",7,18
1999,6,reg,Arizona Cardinals,Washington Redskins,WAS,10,24,14,3.5,34,45.5,FALSE,0,0,"",10.5,11.5
1999,6,reg,Atlanta Falcons,St. Louis Rams,LAR,13,41,28,6,54,45,FALSE,1,0,DOME,22,9
1999,6,reg,Buffalo Bills,Oakland Raiders,BUF,14,20,6,3.5,34,40.5,FALSE,0,0,"",2.5,6.5
1999,6,reg,Chicago Bears,Philadelphia Eagles,CHI,16,20,4,6.5,36,35,FALSE,0,0,"",2.5,1
1999,6,reg,Cincinnati Bengals,Pittsburgh Steelers,PIT,3,17,14,5,20,37.5,FALSE,0,0,"",9,17.5
1999,6,reg,Denver Broncos,Green Bay Packers,GB,31,10,21,3.5,41,40,FALSE,0,0,"",17.5,1
1999,6,reg,Detroit Lions,Minnesota Vikings,MIN,25,23,2,3.5,48,45,FALSE,1,0,DOME,1.5,3
1999,6,reg,Jacksonville Jaguars,Cleveland Browns,JAX,24,7,17,17.5,31,37.5,FALSE,0,0,"",0.5,6.5
1999,6,reg,New England Patriots,Miami Dolphins,NE,30,31,1,2.5,61,42.5,FALSE,0,0,"",1.5,18.5
1999,6,reg,New Orleans Saints,Tennessee Titans,TEN,21,24,3,3,45,36.5,FALSE,1,0,DOME,0,8.5
1999,6,reg,New York Jets,Indianapolis Colts,IND,13,16,3,2.5,29,42.5,FALSE,0,0,"",0.5,13.5
1999,6,reg,San Diego Chargers,Seattle Seahawks,SEA,13,10,3,1.5,23,37.5,FALSE,0,0,"",1.5,14.5
1999,6,reg,San Francisco 49ers,Carolina Panthers,SF,29,31,2,5,60,44,FALSE,0,0,"",3,16
1999,6,reg,New York Giants,Dallas Cowboys,DAL,13,10,3,3,23,37,FALSE,0,0,"",0,14
1999,7,reg,Baltimore Ravens,Kansas City Chiefs,KC,8,35,27,1,43,36,FALSE,0,0,"",26,7
1999,7,reg,Carolina Panthers,Detroit Lions,CAR,9,24,15,4.5,33,43.5,FALSE,0,0,"",10.5,10.5
1999,7,reg,Dallas Cowboys,Washington Redskins,DAL,38,20,18,2,58,44,FALSE,0,0,"",16,14
1999,7,reg,Indianapolis Colts,Cincinnati Bengals,IND,31,10,21,11,41,44,FALSE,1,0,DOME,10,3
1999,7,reg,Miami Dolphins,Philadelphia Eagles,MIA,16,13,3,9,29,34,FALSE,0,0,"",6,5
1999,7,reg,Minnesota Vikings,San Francisco 49ers,MIN,40,16,24,7,56,48.5,FALSE,1,0,DOME,17,7.5
1999,7,reg,New England Patriots,Denver Broncos,NE,24,23,1,3.5,47,40.5,FALSE,0,0,"",2.5,6.5
1999,7,reg,New York Giants,New Orleans Saints,NYG,31,3,28,3,34,34,FALSE,0,0,"",25,0
1999,7,reg,Oakland Raiders,New York Jets,OAK,24,23,1,6.5,47,37,FALSE,0,0,"",5.5,10
1999,7,reg,San Diego Chargers,Green Bay Packers,GB,3,31,28,3,34,37.5,FALSE,0,0,"",25,3.5
1999,7,reg,Seattle Seahawks,Buffalo Bills,SEA,26,16,10,2.5,42,38,FALSE,1,0,DOME,7.5,4
1999,7,reg,St. Louis Rams,Cleveland Browns,LAR,34,3,31,18.5,37,43.5,FALSE,1,0,DOME,12.5,6.5
1999,7,reg,Tampa Bay Buccaneers,Chicago Bears,TB,6,3,3,8,9,36.5,FALSE,0,0,"",5,27.5
1999,7,reg,Pittsburgh Steelers,Atlanta Falcons,PIT,13,9,4,5.5,22,37,FALSE,0,0,"",1.5,15
1999,8,reg,Arizona Cardinals,New England Patriots,NE,3,27,24,3,30,40.5,FALSE,0,0,"",21,10.5
1999,8,reg,Atlanta Falcons,Carolina Panthers,ATL,27,20,7,2,47,40,FALSE,1,0,DOME,5,7
1999,8,reg,Baltimore Ravens,Buffalo Bills,BUF,10,13,3,3.5,23,36.5,FALSE,0,0,"",0.5,13.5
1999,8,reg,Cincinnati Bengals,Jacksonville Jaguars,JAX,10,41,31,12.5,51,38,FALSE,0,0,"",18.5,13
1999,8,reg,Denver Broncos,Minnesota Vikings,MIN,20,23,3,2.5,43,45,FALSE,0,0,"",0.5,2
1999,8,reg,Detroit Lions,Tampa Bay Buccaneers,TB,20,3,17,2.5,23,35,FALSE,1,0,DOME,14.5,12
1999,8,reg,Indianapolis Colts,Dallas Cowboys,IND,34,24,10,3,58,46,FALSE,1,0,DOME,7,12
1999,8,reg,Kansas City Chiefs,San Diego Chargers,KC,34,0,34,6,34,35,FALSE,0,0,"",28,1
1999,8,reg,New Orleans Saints,Cleveland Browns,NO,16,21,5,9.5,37,33.5,FALSE,1,0,DOME,4.5,3.5
1999,8,reg,Oakland Raiders,Miami Dolphins,OAK,9,16,7,3,25,37,FALSE,0,0,"",4,12
1999,8,reg,Philadelphia Eagles,New York Giants,NYG,17,23,6,2.5,40,33.5,FALSE,0,0,"",3.5,6.5
1999,8,reg,Tennessee Titans,St. Louis Rams,LAR,24,21,3,3,45,44.5,FALSE,0,0,"",0,0.5
1999,8,reg,Washington Redskins,Chicago Bears,WAS,48,22,26,8.5,70,44,FALSE,0,0,"",17.5,26
1999,8,reg,Green Bay Packers,Seattle Seahawks,GB,7,27,20,5.5,34,42.5,FALSE,0,0,"",14.5,8.5
1999,9,reg,Atlanta Falcons,Jacksonville Jaguars,JAX,7,30,23,6,37,41,FALSE,1,0,DOME,17,4
1999,9,reg,Carolina Panthers,Philadelphia Eagles,CAR,33,7,26,5,40,36,FALSE,0,0,"",21,4
1999,9,reg,Cleveland Browns,Baltimore Ravens,BAL,9,41,32,3.5,50,32.5,FALSE,0,0,"",28.5,17.5
1999,9,reg,Detroit Lions,St. Louis Rams,LAR,31,27,4,4,58,45,FALSE,1,0,DOME,0,13
1999,9,reg,Green Bay Packers,Chicago Bears,GB,13,14,1,9,27,40.5,FALSE,0,0,"",8,13.5
1999,9,reg,Indianapolis Colts,Kansas City Chiefs,IND,25,17,8,4,42,45,FALSE,1,0,DOME,4,3
1999,9,reg,Miami Dolphins,Tennessee Titans,MIA,17,0,17,3,17,37,FALSE,0,0,"",14,20
1999,9,reg,New Orleans Saints,Tampa Bay Buccaneers,TB,16,31,15,3.5,47,33.5,FALSE,1,0,DOME,11.5,13.5
1999,9,reg,New York Jets,Arizona Cardinals,NYJ,12,7,5,7,19,35,FALSE,0,0,"",2,16
1999,9,reg,San Diego Chargers,Denver Broncos,PICK,17,33,16,0,50,35.5,FALSE,0,0,"",16,14.5
1999,9,reg,San Francisco 49ers,Pittsburgh Steelers,SF,6,27,21,2.5,33,41.5,FALSE,0,0,"",18.5,8.5
1999,9,reg,Seattle Seahawks,Cincinnati Bengals,SEA,37,20,17,14,57,40,FALSE,1,0,DOME,3,17
1999,9,reg,Washington Redskins,Buffalo Bills,WAS,17,34,17,4,51,47,FALSE,0,0,"",13,4
1999,9,reg,Minnesota Vikings,Dallas Cowboys,MIN,27,17,10,6.5,44,47.5,FALSE,1,0,DOME,3.5,3.5
1999,10,reg,Arizona Cardinals,Detroit Lions,DET,23,19,4,5.5,42,35.5,FALSE,0,0,"",1.5,6.5
1999,10,reg,Buffalo Bills,Miami Dolphins,BUF,23,3,20,3,26,37,FALSE,0,0,"",17,11
1999,10,reg,Chicago Bears,Minnesota Vikings,MIN,24,27,3,6.5,51,43,FALSE,0,0,"",3.5,8
1999,10,reg,Cincinnati Bengals,Tennessee Titans,TEN,14,24,10,10,38,41,FALSE,0,0,"",0,3
1999,10,reg,Dallas Cowboys,Green Bay Packers,GB,27,13,14,3,40,38,FALSE,0,0,"",11,2
1999,10,reg,Jacksonville Jaguars,Baltimore Ravens,JAX,6,3,3,13,9,37,FALSE,0,0,"",10,28
1999,10,reg,New Orleans Saints,San Francisco 49ers,SF,24,6,18,1,30,38.5,FALSE,1,0,DOME,17,8.5
1999,10,reg,New York Giants,Indianapolis Colts,IND,19,27,8,3,46,41.5,FALSE,0,0,"",5,4.5
1999,10,reg,Oakland Raiders,San Diego Chargers,OAK,28,9,19,7,37,36,FALSE,0,0,"",12,1
1999,10,reg,Philadelphia Eagles,Washington Redskins,WAS,35,28,7,6,63,42,FALSE,0,0,"",1,21
1999,10,reg,Pittsburgh Steelers,Cleveland Browns,PIT,15,16,1,14.5,31,34.5,FALSE,0,0,"",13.5,3.5
1999,10,reg,Seattle Seahawks,Denver Broncos,SEA,20,17,3,5.5,37,41,FALSE,1,0,DOME,2.5,4
1999,10,reg,St. Louis Rams,Carolina Panthers,LAR,35,10,25,10,45,48,FALSE,1,0,DOME,15,3
1999,10,reg,Tampa Bay Buccaneers,Kansas City Chiefs,TB,17,10,7,3,27,34.5,FALSE,0,0,"",4,7.5
1999,10,reg,New England Patriots,New York Jets,NE,17,24,7,6,41,37,FALSE,0,0,"",1,4
1999,11,reg,Arizona Cardinals,Dallas Cowboys,DAL,13,9,4,1.5,22,35,FALSE,0,0,"",2.5,13
1999,11,reg,Cincinnati Bengals,Baltimore Ravens,BAL,31,34,3,5,65,34.5,FALSE,0,0,"",2,30.5
1999,11,reg,Cleveland Browns,Carolina Panthers,CAR,17,31,14,5.5,48,35.5,FALSE,0,0,"",8.5,12.5
1999,11,reg,Green Bay Packers,Detroit Lions,GB,26,17,9,4,43,39,FALSE,0,0,"",5,4
1999,11,reg,Jacksonville Jaguars,New Orleans Saints,JAX,41,23,18,12.5,64,35,FALSE,0,0,"",5.5,29
1999,11,reg,Kansas City Chiefs,Seattle Seahawks,KC,19,31,12,3,50,37.5,FALSE,0,0,"",9,12.5
1999,11,reg,Miami Dolphins,New England Patriots,MIA,27,17,10,3.5,44,37.5,FALSE,0,0,"",6.5,6.5
1999,11,reg,New York Jets,Buffalo Bills,BUF,17,7,10,2.5,24,36,FALSE,0,0,"",7.5,12
1999,11,reg,Philadelphia Eagles,Indianapolis Colts,IND,17,44,27,7,61,41,FALSE,0,0,"",20,20
1999,11,reg,San Diego Chargers,Chicago Bears,PICK,20,23,3,0,43,36,FALSE,0,0,"",3,7
1999,11,reg,San Francisco 49ers,St. Louis Rams,LAR,7,23,16,7.5,30,47.5,FALSE,0,0,"",8.5,17.5
1999,11,reg,Tampa Bay Buccaneers,Atlanta Falcons,TB,19,10,9,7,29,34.5,FALSE,0,0,"",2,5.5
1999,11,reg,Tennessee Titans,Pittsburgh Steelers,TEN,16,10,6,5.5,26,36.5,FALSE,0,0,"",0.5,10.5
1999,11,reg,Washington Redskins,New York Giants,WAS,23,13,10,5.5,36,44.5,FALSE,0,0,"",4.5,8.5
1999,11,reg,Denver Broncos,Oakland Raiders,DEN,27,21,6,1.5,48,37,FALSE,0,0,"",4.5,11
1999,12,reg,Dallas Cowboys,Miami Dolphins,DAL,20,0,20,1.5,20,38,FALSE,0,0,"",18.5,18
1999,12,reg,Detroit Lions,Chicago Bears,DET,21,17,4,6,38,44,FALSE,1,0,DOME,2,6
1999,12,reg,Baltimore Ravens,Jacksonville Jaguars,JAX,23,30,7,7,53,36.5,FALSE,0,0,"",0,16.5
1999,12,reg,Buffalo Bills,New England Patriots,BUF,17,7,10,4,24,38,FALSE,0,0,"",6,14
1999,12,reg,Carolina Panthers,Atlanta Falcons,CAR,34,28,6,4.5,62,40,FALSE,0,0,"",1.5,22
1999,12,reg,Cleveland Browns,Tennessee Titans,TEN,21,33,12,10.5,54,35.5,FALSE,0,0,"",1.5,18.5
1999,12,reg,Indianapolis Colts,New York Jets,IND,13,6,7,7,19,44,FALSE,1,0,DOME,0,25
1999,12,reg,Minnesota Vikings,San Diego Chargers,MIN,35,27,8,13.5,62,43.5,FALSE,1,0,DOME,5.5,18.5
1999,12,reg,New York Giants,Arizona Cardinals,NYG,24,34,10,4.5,58,34.5,FALSE,0,0,"",5.5,23.5
1999,12,reg,Oakland Raiders,Kansas City Chiefs,OAK,34,37,3,3.5,71,37,FALSE,0,0,"",0.5,34
1999,12,reg,Pittsburgh Steelers,Cincinnati Bengals,PIT,20,27,7,11,47,36,FALSE,0,0,"",4,11
1999,12,reg,Seattle Seahawks,Tampa Bay Buccaneers,SEA,3,16,13,6,19,37,FALSE,1,0,DOME,7,18
1999,12,reg,St. Louis Rams,New Orleans Saints,LAR,43,12,31,14,55,47,FALSE,1,0,DOME,17,8
1999,12,reg,Washington Redskins,Philadelphia Eagles,WAS,20,17,3,10,37,42.5,FALSE,0,0,"",7,5.5
1999,12,reg,San Francisco 49ers,Green Bay Packers,GB,3,20,17,6,23,40.5,FALSE,0,0,"",11,17.5
1999,13,reg,Jacksonville Jaguars,Pittsburgh Steelers,JAX,20,6,14,10.5,26,37,FALSE,0,0,"",3.5,11
1999,13,reg,Arizona Cardinals,Philadelphia Eagles,ARI,21,17,4,7,38,37,FALSE,0,0,"",3,1
1999,13,reg,Atlanta Falcons,New Orleans Saints,ATL,35,12,23,4,47,39.5,FALSE,1,0,DOME,19,7.5
1999,13,reg,Baltimore Ravens,Tennessee Titans,TEN,41,14,27,3.5,55,36.5,FALSE,0,0,"",23.5,18.5
1999,13,reg,Carolina Panthers,St. Louis Rams,LAR,21,34,13,7,55,49,FALSE,0,0,"",6,6
1999,13,reg,Chicago Bears,Green Bay Packers,GB,19,35,16,3.5,54,39,FALSE,0,0,"",12.5,15
1999,13,reg,Cincinnati Bengals,San Francisco 49ers,CIN,44,30,14,3,74,39,FALSE,0,0,"",11,35
1999,13,reg,Denver Broncos,Kansas City Chiefs,DEN,10,16,6,3.5,26,38.5,FALSE,0,0,"",2.5,12.5
1999,13,reg,Detroit Lions,Washington Redskins,DET,33,17,16,3.5,50,49.5,FALSE,1,0,DOME,12.5,0.5
1999,13,reg,Miami Dolphins,Indianapolis Colts,MIA,34,37,3,2,71,43,FALSE,0,0,"",1,28
1999,13,reg,New England Patriots,Dallas Cowboys,NE,13,6,7,2,19,38,FALSE,0,0,"",5,19
1999,13,reg,New York Giants,New York Jets,NYJ,41,28,13,2.5,69,34,FALSE,0,0,"",10.5,35
1999,13,reg,Oakland Raiders,Seattle Seahawks,OAK,30,21,9,1,51,41,FALSE,0,0,"",8,10
1999,13,reg,San Diego Chargers,Cleveland Browns,LAC,23,10,13,7.5,33,36,FALSE,0,0,"",5.5,3
1999,13,reg,Tampa Bay Buccaneers,Minnesota Vikings,MIN,24,17,7,2.5,41,39,FALSE,0,0,"",4.5,2
1999,14,reg,Tennessee Titans,Oakland Raiders,TEN,21,14,7,3,35,40,FALSE,0,0,"",4,5
1999,14,reg,Buffalo Bills,New York Giants,BUF,17,19,2,8,36,36.5,FALSE,0,0,"",6,0.5
1999,14,reg,Cincinnati Bengals,Cleveland Browns,CIN,44,28,16,7,72,41,FALSE,0,0,"",9,31
1999,14,reg,Dallas Cowboys,Philadelphia Eagles,DAL,20,10,10,9,30,36.5,FALSE,0,0,"",1,6.5
1999,14,reg,Green Bay Packers,Carolina Panthers,GB,31,33,2,8,64,42,FALSE,0,0,"",6,22
1999,14,reg,Indianapolis Colts,New England Patriots,IND,20,15,5,7,35,46.5,FALSE,1,0,DOME,2,11.5
1999,14,reg,Kansas City Chiefs,Minnesota Vikings,KC,31,28,3,1,59,42,FALSE,0,0,"",2,17
1999,14,reg,New Orleans Saints,St. Louis Rams,LAR,14,30,16,10.5,44,49,FALSE,1,0,DOME,5.5,5
1999,14,reg,New York Jets,Miami Dolphins,MIA,28,20,8,3,48,37,FALSE,0,0,"",5,11
1999,14,reg,Pittsburgh Steelers,Baltimore Ravens,PIT,24,31,7,1.5,55,36,FALSE,0,0,"",5.5,19
1999,14,reg,San Francisco 49ers,Atlanta Falcons,ATL,26,7,19,3,33,41,FALSE,0,0,"",16,8
1999,14,reg,Seattle Seahawks,San Diego Chargers,SEA,16,19,3,9.5,35,42.5,FALSE,1,0,DOME,6.5,7.5
1999,14,reg,Tampa Bay Buccaneers,Detroit Lions,TB,23,16,7,4,39,36,FALSE,0,0,"",3,3
1999,14,reg,Washington Redskins,Arizona Cardinals,WAS,28,3,25,5.5,31,46.5,FALSE,0,0,"",19.5,15.5
1999,14,reg,Jacksonville Jaguars,Denver Broncos,JAX,27,24,3,9,51,37.5,FALSE,0,0,"",6,13.5
1999,15,reg,Carolina Panthers,San Francisco 49ers,CAR,41,24,17,7.5,65,46,FALSE,0,0,"",9.5,19
1999,15,reg,Kansas City Chiefs,Pittsburgh Steelers,KC,35,19,16,8.5,54,37,FALSE,0,0,"",7.5,17
1999,15,reg,Arizona Cardinals,Buffalo Bills,BUF,21,31,10,3,52,37.5,FALSE,0,0,"",7,14.5
1999,15,reg,Baltimore Ravens,New Orleans Saints,BAL,31,8,23,8.5,39,41.5,FALSE,0,0,"",14.5,2.5
1999,15,reg,Chicago Bears,Detroit Lions,DET,28,10,18,3,38,37,FALSE,0,0,"",15,1
1999,15,reg,Cleveland Browns,Jacksonville Jaguars,JAX,14,24,10,14.5,38,39,FALSE,0,0,"",4.5,1
1999,15,reg,Dallas Cowboys,New York Jets,DAL,21,22,1,6,43,35.5,FALSE,0,0,"",5,7.5
1999,15,reg,Denver Broncos,Seattle Seahawks,DEN,36,30,6,1.5,66,39,FALSE,0,0,"",4.5,27
1999,15,reg,Indianapolis Colts,Washington Redskins,IND,24,21,3,6.5,45,51,FALSE,1,0,DOME,3.5,6
1999,15,reg,Miami Dolphins,San Diego Chargers,MIA,12,9,3,7.5,21,37,FALSE,0,0,"",4.5,16
1999,15,reg,Oakland Raiders,Tampa Bay Buccaneers,TB,45,0,45,1,45,36,FALSE,0,0,"",44,9
1999,15,reg,Philadelphia Eagles,New England Patriots,NE,24,9,15,3.5,33,37,FALSE,0,0,"",11.5,4
1999,15,reg,St. Louis Rams,New York Giants,LAR,31,10,21,10.5,41,46.5,FALSE,1,0,DOME,10.5,5.5
1999,15,reg,Tennessee Titans,Atlanta Falcons,TEN,30,17,13,10,47,37,FALSE,0,0,"",3,10
1999,15,reg,Minnesota Vikings,Green Bay Packers,MIN,24,20,4,4.5,44,49,FALSE,1,0,DOME,0.5,5
1999,16,reg,New Orleans Saints,Dallas Cowboys,DAL,31,24,7,8.5,55,38.5,FALSE,1,0,DOME,1.5,16.5
1999,16,reg,Detroit Lions,Denver Broncos,DET,7,17,10,4.5,24,43.5,FALSE,1,0,DOME,5.5,19.5
1999,16,reg,Atlanta Falcons,Arizona Cardinals,ATL,37,14,23,2,51,38,FALSE,1,0,DOME,21,13
1999,16,reg,Baltimore Ravens,Cincinnati Bengals,BAL,22,0,22,7,22,45.5,FALSE,0,0,"",15,23.5
1999,16,reg,Cleveland Browns,Indianapolis Colts,IND,28,29,1,13.5,57,41.5,FALSE,0,0,"",12.5,15.5
1999,16,reg,New England Patriots,Buffalo Bills,BUF,10,13,3,3,23,37.5,FALSE,0,0,"",0,14.5
1999,16,reg,New York Giants,Minnesota Vikings,MIN,17,34,17,2.5,51,43,FALSE,0,0,"",14.5,8
1999,16,reg,Pittsburgh Steelers,Carolina Panthers,CAR,30,20,10,3.5,50,42.5,FALSE,0,0,"",6.5,7.5
1999,16,reg,San Diego Chargers,Oakland Raiders,OAK,23,20,3,3,43,38,FALSE,0,0,"",0,5
1999,16,reg,San Francisco 49ers,Washington Redskins,WAS,20,26,6,7,46,47.5,FALSE,0,0,"",1,1.5
1999,16,reg,Seattle Seahawks,Kansas City Chiefs,SEA,23,14,9,3,37,43,FALSE,1,0,DOME,6,6
1999,16,reg,St. Louis Rams,Chicago Bears,LAR,34,12,22,10,46,46.5,FALSE,1,0,DOME,12,0.5
1999,16,reg,Tampa Bay Buccaneers,Green Bay Packers,TB,29,10,19,3.5,39,37,FALSE,0,0,"",15.5,2
1999,16,reg,Tennessee Titans,Jacksonville Jaguars,JAX,41,14,27,3,55,39,FALSE,0,0,"",24,16
1999,16,reg,Miami Dolphins,New York Jets,MIA,31,38,7,3.5,69,37,FALSE,0,0,"",3.5,32
1999,17,reg,Buffalo Bills,Indianapolis Colts,IND,31,6,25,1.5,37,42,FALSE,0,0,"",23.5,5
1999,17,reg,Carolina Panthers,New Orleans Saints,CAR,45,13,32,8.5,58,46.5,FALSE,0,0,"",23.5,11.5
1999,17,reg,Chicago Bears,Tampa Bay Buccaneers,TB,6,20,14,3.5,26,34,FALSE,0,0,"",10.5,8
1999,17,reg,Dallas Cowboys,New York Giants,DAL,26,18,8,6.5,44,37.5,FALSE,0,0,"",1.5,6.5
1999,17,reg,Denver Broncos,San Diego Chargers,DEN,6,12,6,7,18,37.5,FALSE,0,0,"",1,19.5
1999,17,reg,Green Bay Packers,Arizona Cardinals,GB,49,24,25,7.5,73,38,FALSE,0,0,"",17.5,35
1999,17,reg,Jacksonville Jaguars,Cincinnati Bengals,JAX,24,7,17,9,31,39.5,FALSE,0,0,"",8,8.5
1999,17,reg,Kansas City Chiefs,Oakland Raiders,KC,38,41,3,5,79,39,FALSE,0,0,"",2,40
1999,17,reg,Minnesota Vikings,Detroit Lions,MIN,24,17,7,7,41,48.5,FALSE,1,0,DOME,0,7.5
1999,17,reg,New England Patriots,Baltimore Ravens,BAL,20,3,17,1,23,37.5,FALSE,0,0,"",16,14.5
1999,17,reg,New York Jets,Seattle Seahawks,NYJ,19,9,10,1,28,38,FALSE,0,0,"",9,10
1999,17,reg,Philadelphia Eagles,St. Louis Rams,LAR,38,31,7,8,69,42,FALSE,0,0,"",1,27
1999,17,reg,Pittsburgh Steelers,Tennessee Titans,TEN,36,47,11,4,83,38,FALSE,0,0,"",7,45
1999,17,reg,Washington Redskins,Miami Dolphins,WAS,21,10,11,3,31,44,FALSE,0,0,"",8,13
1999,17,reg,Atlanta Falcons,San Francisco 49ers,ATL,34,29,5,6.5,63,46.5,FALSE,1,0,DOME,1.5,16.5
1999,Wildcard,post,Tennessee Titans,Buffalo Bills,TEN,22,16,6,5,38,39,FALSE,0,0,"",1,1
1999,Wildcard,post,Washington Redskins,Detroit Lions,WAS,27,13,14,6,40,46,FALSE,0,0,"",8,6
1999,Wildcard,post,Minnesota Vikings,Dallas Cowboys,MIN,27,10,17,7,37,46.5,FALSE,1,0,DOME,10,9.5
1999,Wildcard,post,Seattle Seahawks,Miami Dolphins,SEA,17,20,3,3.5,37,39,FALSE,1,0,DOME,0.5,2
1999,Division,post,Jacksonville Jaguars,Miami Dolphins,JAX,62,7,55,8,69,37.5,FALSE,0,0,"",47,31.5
1999,Division,post,Tampa Bay Buccaneers,Washington Redskins,TB,14,13,1,4.5,27,38,FALSE,0,0,"",3.5,11
1999,Division,post,Indianapolis Colts,Tennessee Titans,IND,16,19,3,5.5,35,46.5,FALSE,1,0,DOME,2.5,11.5
1999,Division,post,St. Louis Rams,Minnesota Vikings,LAR,49,37,12,7,86,52,FALSE,1,0,DOME,5,34
1999,Conference,post,Jacksonville Jaguars,Tennessee Titans,JAX,14,33,19,7,47,39.5,FALSE,0,0,"",12,7.5
1999,Conference,post,St. Louis Rams,Tampa Bay Buccaneers,LAR,11,6,5,14,17,46,FALSE,1,0,DOME,9,29
1999,Superbowl,post,St. Louis Rams,Tennessee Titans,LAR,23,16,7,7,39,45,TRUE,1,0,DOME,0,6
2000,1,reg,Atlanta Falcons,San Francisco 49ers,ATL,36,28,8,6.5,64,46.5,FALSE,1,0,DOME,1.5,17.5
2000,1,reg,Buffalo Bills,Tennessee Titans,BUF,16,13,3,1,29,40,FALSE,0,0,"",2,11
2000,1,reg,Cleveland Browns,Jacksonville Jaguars,JAX,7,27,20,10.5,34,38.5,FALSE,0,0,"",9.5,4.5
2000,1,reg,Dallas Cowboys,Philadelphia Eagles,DAL,14,41,27,6,55,39.5,FALSE,0,0,"",21,15.5
2000,1,reg,Green Bay Packers,New York Jets,GB,16,20,4,2.5,36,44,FALSE,0,0,"",1.5,8
2000,1,reg,Kansas City Chiefs,Indianapolis Colts,IND,14,27,13,3.5,41,44,FALSE,0,0,"",9.5,3
2000,1,reg,Miami Dolphins,Seattle Seahawks,MIA,23,0,23,2,23,36,FALSE,0,0,"",21,13
2000,1,reg,Minnesota Vikings,Chicago Bears,MIN,30,27,3,4.5,57,46.5,FALSE,1,0,DOME,1.5,10.5
2000,1,reg,New England Patriots,Tampa Bay Buccaneers,TB,16,21,5,3,37,36,FALSE,0,0,"",2,1
2000,1,reg,New Orleans Saints,Detroit Lions,PICK,10,14,4,0,24,40.5,FALSE,1,0,DOME,4,16.5
2000,1,reg,New York Giants,Arizona Cardinals,NYG,21,16,5,6.5,37,40,FALSE,0,0,"",1.5,3
2000,1,reg,Oakland Raiders,San Diego Chargers,OAK,9,6,3,6.5,15,39.5,FALSE,0,0,"",3.5,24.5
2000,1,reg,Pittsburgh Steelers,Baltimore Ravens,BAL,0,16,16,2.5,16,37,FALSE,0,0,"",13.5,21
2000,1,reg,Washington Redskins,Carolina Panthers,WAS,20,17,3,10.5,37,47.5,FALSE,0,0,"",7.5,10.5
2000,1,reg,St. Louis Rams,Denver Broncos,LAR,41,36,5,6.5,77,48.5,FALSE,1,0,DOME,1.5,28.5
2000,2,reg,Arizona Cardinals,Dallas Cowboys,ARI,32,31,1,3,63,38.5,FALSE,0,0,"",2,24.5
2000,2,reg,Baltimore Ravens,Jacksonville Jaguars,BAL,39,36,3,3,75,36.5,FALSE,0,0,"",0,38.5
2000,2,reg,Buffalo Bills,Green Bay Packers,BUF,27,18,9,6,45,38.5,FALSE,0,0,"",3,6.5
2000,2,reg,Cincinnati Bengals,Cleveland Browns,CIN,7,24,17,6,31,40.5,FALSE,0,0,"",11,9.5
2000,2,reg,Denver Broncos,Atlanta Falcons,DEN,42,14,28,4.5,56,47,FALSE,0,0,"",23.5,9
2000,2,reg,Detroit Lions,Washington Redskins,WAS,15,10,5,5.5,25,43,FALSE,1,0,DOME,0.5,18
2000,2,reg,Indianapolis Colts,Oakland Raiders,IND,31,38,7,6.5,69,44,FALSE,1,0,DOME,0.5,25
2000,2,reg,Minnesota Vikings,Miami Dolphins,MIN,13,7,6,3,20,42.5,FALSE,1,0,DOME,3,22.5
2000,2,reg,Philadelphia Eagles,New York Giants,PHI,18,33,15,3,51,39.5,FALSE,0,0,"",12,11.5
2000,2,reg,San Diego Chargers,New Orleans Saints,LAC,27,28,1,5.5,55,35.5,FALSE,0,0,"",4.5,19.5
2000,2,reg,San Francisco 49ers,Carolina Panthers,CAR,22,38,16,3,60,48,FALSE,0,0,"",13,12
2000,2,reg,Seattle Seahawks,St. Louis Rams,LAR,34,37,3,7.5,71,46,FALSE,0,0,"",4.5,25
2000,2,reg,Tampa Bay Buccaneers,Chicago Bears,TB,41,0,41,7,41,36.5,FALSE,0,0,"",34,4.5
2000,2,reg,Tennessee Titans,Kansas City Chiefs,TEN,17,14,3,8.5,31,38.5,FALSE,0,0,"",5.5,7.5
2000,2,reg,New York Jets,New England Patriots,NYJ,20,19,1,6.5,39,39.5,FALSE,0,0,"",5.5,0.5
2000,3,reg,Carolina Panthers,Atlanta Falcons,CAR,10,15,5,6,25,48.5,FALSE,0,0,"",1,23.5
2000,3,reg,Chicago Bears,New York Giants,CHI,7,14,7,2,21,42,FALSE,0,0,"",5,21
2000,3,reg,Cleveland Browns,Pittsburgh Steelers,PIT,23,20,3,2.5,43,35.5,FALSE,0,0,"",0.5,7.5
2000,3,reg,Detroit Lions,Tampa Bay Buccaneers,TB,10,31,21,3,41,34.5,FALSE,1,0,DOME,18,6.5
2000,3,reg,Green Bay Packers,Philadelphia Eagles,GB,6,3,3,4,9,42.5,FALSE,0,0,"",1,33.5
2000,3,reg,Jacksonville Jaguars,Cincinnati Bengals,JAX,13,0,13,13,13,41,FALSE,0,0,"",0,28
2000,3,reg,Kansas City Chiefs,San Diego Chargers,KC,42,10,32,4.5,52,35.5,FALSE,0,0,"",27.5,16.5
2000,3,reg,Miami Dolphins,Baltimore Ravens,BAL,19,6,13,1.5,25,34.5,FALSE,0,0,"",11.5,9.5
2000,3,reg,New England Patriots,Minnesota Vikings,NE,13,21,8,1.5,34,42.5,FALSE,0,0,"",6.5,8.5
2000,3,reg,New York Jets,Buffalo Bills,NYJ,27,14,13,1,41,38.5,FALSE,0,0,"",12,2.5
2000,3,reg,Oakland Raiders,Denver Broncos,OAK,24,33,9,3,57,44,FALSE,0,0,"",6,13
2000,3,reg,Seattle Seahawks,New Orleans Saints,SEA,20,10,10,6,30,40,FALSE,0,0,"",4,10
2000,3,reg,St. Louis Rams,San Francisco 49ers,LAR,41,24,17,17,65,55.5,FALSE,1,0,DOME,0,9.5
2000,3,reg,Washington Redskins,Dallas Cowboys,WAS,21,27,6,10.5,48,44,FALSE,0,0,"",4.5,4
2000,4,reg,Arizona Cardinals,Green Bay Packers,ARI,3,29,26,1,32,42,FALSE,0,0,"",25,10
2000,4,reg,Atlanta Falcons,St. Louis Rams,LAR,20,41,21,6.5,61,55,FALSE,1,0,DOME,14.5,6
2000,4,reg,Baltimore Ravens,Cincinnati Bengals,BAL,37,0,37,11.5,37,38,FALSE,0,0,"",25.5,1
2000,4,reg,Chicago Bears,Detroit Lions,CHI,14,21,7,1,35,37.5,FALSE,0,0,"",6,2.5
2000,4,reg,Dallas Cowboys,San Francisco 49ers,DAL,24,41,17,6.5,65,47,FALSE,0,0,"",10.5,18
2000,4,reg,Denver Broncos,Kansas City Chiefs,DEN,22,23,1,7,45,43,FALSE,0,0,"",6,2
2000,4,reg,Miami Dolphins,New England Patriots,MIA,10,3,7,4.5,13,34.5,FALSE,0,0,"",2.5,21.5
2000,4,reg,New Orleans Saints,Philadelphia Eagles,NO,7,21,14,1.5,28,38,FALSE,1,0,DOME,12.5,10
2000,4,reg,New York Giants,Washington Redskins,NYG,6,16,10,1,22,42,FALSE,0,0,"",9,20
2000,4,reg,Oakland Raiders,Cleveland Browns,OAK,36,10,26,10.5,46,40.5,FALSE,0,0,"",15.5,5.5
2000,4,reg,Pittsburgh Steelers,Tennessee Titans,TEN,20,23,3,7,43,36,FALSE,0,0,"",4,7
2000,4,reg,San Diego Chargers,Seattle Seahawks,SEA,12,20,8,2.5,32,36,FALSE,0,0,"",5.5,4
2000,4,reg,Tampa Bay Buccaneers,New York Jets,TB,17,21,4,7,38,36,FALSE,0,0,"",3,2
2000,4,reg,Indianapolis Colts,Jacksonville Jaguars,IND,43,14,29,3.5,57,45,FALSE,1,0,DOME,25.5,12
2000,5,reg,Buffalo Bills,Indianapolis Colts,BUF,16,18,2,1.5,34,44,FALSE,0,0,"",0.5,10
2000,5,reg,Carolina Panthers,Dallas Cowboys,CAR,13,16,3,6.5,29,47.5,FALSE,0,0,"",3.5,18.5
2000,5,reg,Cincinnati Bengals,Miami Dolphins,MIA,16,31,15,7,47,33,FALSE,0,0,"",8,14
2000,5,reg,Cleveland Browns,Baltimore Ravens,BAL,0,12,12,8.5,12,37,FALSE,0,0,"",3.5,25
2000,5,reg,Denver Broncos,New England Patriots,DEN,19,28,9,8.5,47,41,FALSE,0,0,"",0.5,6
2000,5,reg,Detroit Lions,Minnesota Vikings,DET,24,31,7,1,55,42.5,FALSE,1,0,DOME,6,12.5
2000,5,reg,Green Bay Packers,Chicago Bears,GB,24,27,3,5.5,51,41,FALSE,0,0,"",2.5,10
2000,5,reg,Jacksonville Jaguars,Pittsburgh Steelers,JAX,13,24,11,11,37,38.5,FALSE,0,0,"",0,1.5
2000,5,reg,Philadelphia Eagles,Atlanta Falcons,PHI,38,10,28,3,48,41.5,FALSE,0,0,"",25,6.5
2000,5,reg,San Francisco 49ers,Arizona Cardinals,SF,27,20,7,3.5,47,47.5,FALSE,0,0,"",3.5,0.5
2000,5,reg,St. Louis Rams,San Diego Chargers,LAR,57,31,26,17,88,53.5,FALSE,1,0,DOME,9,34.5
2000,5,reg,Tennessee Titans,New York Giants,TEN,28,14,14,5,42,38,FALSE,0,0,"",9,4
2000,5,reg,Washington Redskins,Tampa Bay Buccaneers,WAS,20,17,3,1.5,37,36,FALSE,0,0,"",1.5,1
2000,5,reg,Kansas City Chiefs,Seattle Seahawks,KC,24,17,7,4,41,38.5,FALSE,0,0,"",3,2.5
2000,6,reg,Arizona Cardinals,Cleveland Browns,ARI,29,21,8,4.5,50,40.5,FALSE,0,0,"",3.5,9.5
2000,6,reg,Atlanta Falcons,New York Giants,ATL,6,13,7,1,19,42,FALSE,1,0,DOME,6,23
2000,6,reg,Carolina Panthers,Seattle Seahawks,CAR,26,3,23,3.5,29,43,FALSE,0,0,"",19.5,14
2000,6,reg,Chicago Bears,New Orleans Saints,CHI,10,31,21,5.5,41,40,FALSE,0,0,"",15.5,1
2000,6,reg,Cincinnati Bengals,Tennessee Titans,TEN,14,23,9,10,37,38,FALSE,0,0,"",1,1
2000,6,reg,Detroit Lions,Green Bay Packers,DET,31,24,7,3,55,43,FALSE,1,0,DOME,4,12
2000,6,reg,Jacksonville Jaguars,Baltimore Ravens,JAX,10,15,5,2.5,25,37.5,FALSE,0,0,"",2.5,12.5
2000,6,reg,Miami Dolphins,Buffalo Bills,MIA,22,13,9,2,35,34.5,FALSE,0,0,"",7,0.5
2000,6,reg,New England Patriots,Indianapolis Colts,IND,24,16,8,3.5,40,43.5,FALSE,0,0,"",4.5,3.5
2000,6,reg,New York Jets,Pittsburgh Steelers,NYJ,3,20,17,8,23,37.5,FALSE,0,0,"",9,14.5
2000,6,reg,Philadelphia Eagles,Washington Redskins,WAS,14,17,3,3.5,31,37.5,FALSE,0,0,"",0.5,6.5
2000,6,reg,San Diego Chargers,Denver Broncos,DEN,7,21,14,6.5,28,43,FALSE,0,0,"",7.5,15
2000,6,reg,San Francisco 49ers,Oakland Raiders,OAK,28,34,6,4.5,62,48.5,FALSE,0,0,"",1.5,13.5
2000,6,reg,Minnesota Vikings,Tampa Bay Buccaneers,MIN,30,23,7,1,53,39,FALSE,1,0,DOME,6,14
2000,7,reg,Arizona Cardinals,Philadelphia Eagles,PHI,14,33,19,2.5,47,39,FALSE,0,0,"",16.5,8
2000,7,reg,Buffalo Bills,San Diego Chargers,BUF,27,24,3,10,51,36.5,FALSE,0,0,"",7,14.5
2000,7,reg,Chicago Bears,Minnesota Vikings,MIN,16,28,12,6,44,44,FALSE,0,0,"",6,0
2000,7,reg,Denver Broncos,Cleveland Browns,DEN,44,10,34,12.5,54,44,FALSE,0,0,"",21.5,10
2000,7,reg,Green Bay Packers,San Francisco 49ers,GB,31,28,3,4.5,59,49.5,FALSE,0,0,"",1.5,9.5
2000,7,reg,Kansas City Chiefs,Oakland Raiders,KC,17,20,3,3,37,43.5,FALSE,0,0,"",0,6.5
2000,7,reg,New England Patriots,New York Jets,NE,17,34,17,3,51,37,FALSE,0,0,"",14,14
2000,7,reg,New Orleans Saints,Carolina Panthers,PICK,24,6,18,0,30,40.5,FALSE,1,0,DOME,18,10.5
2000,7,reg,New York Giants,Dallas Cowboys,NYG,19,14,5,4,33,40.5,FALSE,0,0,"",1,7.5
2000,7,reg,Pittsburgh Steelers,Cincinnati Bengals,PIT,15,0,15,8.5,15,37,FALSE,0,0,"",6.5,22
2000,7,reg,Seattle Seahawks,Indianapolis Colts,IND,24,37,13,5.5,61,44,FALSE,0,0,"",7.5,17
2000,7,reg,St. Louis Rams,Atlanta Falcons,LAR,45,29,16,18,74,58.5,FALSE,1,0,DOME,2,15.5
2000,7,reg,Washington Redskins,Baltimore Ravens,WAS,10,3,7,3.5,13,34.5,FALSE,0,0,"",3.5,21.5
2000,7,reg,Tennessee Titans,Jacksonville Jaguars,TEN,27,13,14,6,40,38,FALSE,0,0,"",8,2
2000,8,reg,Tampa Bay Buccaneers,Detroit Lions,TB,14,28,14,8,42,37.5,FALSE,0,0,"",6,4.5
2000,8,reg,Atlanta Falcons,New Orleans Saints,NO,19,21,2,1.5,40,40,FALSE,1,0,DOME,0.5,0
2000,8,reg,Baltimore Ravens,Tennessee Titans,BAL,6,14,8,1,20,35,FALSE,0,0,"",7,15
2000,8,reg,Carolina Panthers,San Francisco 49ers,CAR,34,16,18,3,50,50,FALSE,0,0,"",15,0
2000,8,reg,Cincinnati Bengals,Denver Broncos,DEN,31,21,10,10,52,43,FALSE,0,0,"",0,9
2000,8,reg,Dallas Cowboys,Arizona Cardinals,DAL,48,7,41,7,55,41.5,FALSE,0,0,"",34,13.5
2000,8,reg,Indianapolis Colts,New England Patriots,IND,30,23,7,8.5,53,47,FALSE,1,0,DOME,1.5,6
2000,8,reg,Jacksonville Jaguars,Washington Redskins,WAS,16,35,19,4,51,36,FALSE,0,0,"",15,15
2000,8,reg,Kansas City Chiefs,St. Louis Rams,LAR,54,34,20,7,88,56,FALSE,0,0,"",13,32
2000,8,reg,Minnesota Vikings,Buffalo Bills,MIN,31,27,4,6.5,58,44.5,FALSE,1,0,DOME,2.5,13.5
2000,8,reg,Oakland Raiders,Seattle Seahawks,OAK,31,3,28,7.5,34,44,FALSE,0,0,"",20.5,10
2000,8,reg,Philadelphia Eagles,Chicago Bears,PHI,13,9,4,6.5,22,41,FALSE,0,0,"",2.5,19
2000,8,reg,Pittsburgh Steelers,Cleveland Browns,PIT,22,0,22,9,22,37.5,FALSE,0,0,"",13,15.5
2000,8,reg,New York Jets,Miami Dolphins,NYJ,40,37,3,3,77,35,FALSE,0,0,"",0,42
2000,9,reg,Arizona Cardinals,New Orleans Saints,NO,10,21,11,6,31,41,FALSE,0,0,"",5,10
2000,9,reg,Atlanta Falcons,Carolina Panthers,CAR,13,12,1,3,25,45.5,FALSE,1,0,DOME,2,20.5
2000,9,reg,Baltimore Ravens,Pittsburgh Steelers,BAL,6,9,3,4.5,15,33,FALSE,0,0,"",1.5,18
2000,9,reg,Buffalo Bills,New York Jets,BUF,23,20,3,3.5,43,41,FALSE,0,0,"",0.5,2
2000,9,reg,Cleveland Browns,Cincinnati Bengals,CIN,3,12,9,3,15,35.5,FALSE,0,0,"",6,20.5
2000,9,reg,Dallas Cowboys,Jacksonville Jaguars,DAL,17,23,6,4,40,44.5,FALSE,0,0,"",2,4.5
2000,9,reg,Indianapolis Colts,Detroit Lions,IND,30,18,12,7,48,47,FALSE,1,0,DOME,5,1
2000,9,reg,Miami Dolphins,Green Bay Packers,MIA,28,20,8,4.5,48,38.5,FALSE,0,0,"",3.5,9.5
2000,9,reg,New York Giants,Philadelphia Eagles,NYG,24,7,17,3.5,31,37,FALSE,0,0,"",13.5,6
2000,9,reg,San Diego Chargers,Oakland Raiders,OAK,13,15,2,6.5,28,42.5,FALSE,0,0,"",4.5,14.5
2000,9,reg,San Francisco 49ers,St. Louis Rams,LAR,24,34,10,7,58,63,FALSE,0,0,"",3,5
2000,9,reg,Seattle Seahawks,Kansas City Chiefs,KC,19,24,5,4,43,43,FALSE,0,0,"",1,0
2000,9,reg,Tampa Bay Buccaneers,Minnesota Vikings,TB,41,13,28,3,54,41,FALSE,0,0,"",25,13
2000,9,reg,Washington Redskins,Tennessee Titans,WAS,21,27,6,4,48,37.5,FALSE,0,0,"",2,10.5
2000,10,reg,Arizona Cardinals,Washington Redskins,WAS,16,15,1,10,31,40,FALSE,0,0,"",9,9
2000,10,reg,Atlanta Falcons,Tampa Bay Buccaneers,TB,14,27,13,7,41,40,FALSE,1,0,DOME,6,1
2000,10,reg,Chicago Bears,Indianapolis Colts,IND,27,24,3,7,51,45,FALSE,0,0,"",4,6
2000,10,reg,Cincinnati Bengals,Baltimore Ravens,BAL,7,27,20,6,34,32.5,FALSE,0,0,"",14,1.5
2000,10,reg,Cleveland Browns,New York Giants,NYG,3,24,21,10,27,33.5,FALSE,0,0,"",11,6.5
2000,10,reg,Detroit Lions,Miami Dolphins,DET,8,23,15,2.5,31,39,FALSE,1,0,DOME,12.5,8
2000,10,reg,New England Patriots,Buffalo Bills,NE,13,16,3,2,29,39,FALSE,0,0,"",1,10
2000,10,reg,New Orleans Saints,San Francisco 49ers,NO,31,15,16,5.5,46,48,FALSE,1,0,DOME,10.5,2
2000,10,reg,New York Jets,Denver Broncos,NYJ,23,30,7,3,53,45.5,FALSE,0,0,"",4,7.5
2000,10,reg,Oakland Raiders,Kansas City Chiefs,OAK,49,31,18,3.5,80,44,FALSE,0,0,"",14.5,36
2000,10,reg,Philadelphia Eagles,Dallas Cowboys,PHI,16,13,3,3,29,40,FALSE,0,0,"",0,11
2000,10,reg,Seattle Seahawks,San Diego Chargers,SEA,17,15,2,4.5,32,39.5,FALSE,0,0,"",2.5,7.5
2000,10,reg,St. Louis Rams,Carolina Panthers,LAR,24,27,3,13.5,51,59.5,FALSE,1,0,DOME,10.5,8.5
2000,10,reg,Tennessee Titans,Pittsburgh Steelers,TEN,9,7,2,8,16,36.5,FALSE,0,0,"",6,20.5
2000,10,reg,Green Bay Packers,Minnesota Vikings,MIN,26,20,6,3.5,46,47.5,FALSE,0,0,"",2.5,1.5
2000,11,reg,Buffalo Bills,Chicago Bears,BUF,20,3,17,7,23,39.5,FALSE,0,0,"",10,16.5
2000,11,reg,Carolina Panthers,New Orleans Saints,NO,10,20,10,2,30,37.5,FALSE,0,0,"",8,7.5
2000,11,reg,Cleveland Browns,New England Patriots,NE,19,11,8,7,30,32,FALSE,0,0,"",1,2
2000,11,reg,Dallas Cowboys,Cincinnati Bengals,DAL,23,6,17,8.5,29,39,FALSE,0,0,"",8.5,10
2000,11,reg,Detroit Lions,Atlanta Falcons,DET,13,10,3,8.5,23,40,FALSE,1,0,DOME,5.5,17
2000,11,reg,Indianapolis Colts,New York Jets,IND,23,15,8,6,38,52.5,FALSE,1,0,DOME,2,14.5
2000,11,reg,Jacksonville Jaguars,Seattle Seahawks,JAX,21,28,7,7.5,49,40.5,FALSE,0,0,"",0.5,8.5
2000,11,reg,Minnesota Vikings,Arizona Cardinals,MIN,31,14,17,12.5,45,46,FALSE,1,0,DOME,4.5,1
2000,11,reg,New York Giants,St. Louis Rams,LAR,24,38,14,2,62,48.5,FALSE,0,0,"",12,13.5
2000,11,reg,Pittsburgh Steelers,Philadelphia Eagles,PIT,23,26,3,3.5,49,33,FALSE,0,0,"",0.5,16
2000,11,reg,San Diego Chargers,Miami Dolphins,MIA,7,17,10,5,24,33.5,FALSE,0,0,"",5,9.5
2000,11,reg,San Francisco 49ers,Kansas City Chiefs,KC,21,7,14,3.5,28,52,FALSE,0,0,"",10.5,24
2000,11,reg,Tampa Bay Buccaneers,Green Bay Packers,TB,20,15,5,9,35,42,FALSE,0,0,"",4,7
2000,11,reg,Tennessee Titans,Baltimore Ravens,TEN,23,24,1,4,47,33,FALSE,0,0,"",3,14
2000,11,reg,Denver Broncos,Oakland Raiders,DEN,27,24,3,3,51,50,FALSE,0,0,"",0,1
2000,12,reg,Baltimore Ravens,Dallas Cowboys,BAL,27,0,27,7,27,36,FALSE,0,0,"",20,9
2000,12,reg,Chicago Bears,Tampa Bay Buccaneers,TB,13,10,3,8,23,36,FALSE,0,0,"",5,13
2000,12,reg,Denver Broncos,San Diego Chargers,DEN,38,37,1,9.5,75,42.5,FALSE,0,0,"",8.5,32.5
2000,12,reg,Green Bay Packers,Indianapolis Colts,IND,26,24,2,6,50,46,FALSE,0,0,"",4,4
2000,12,reg,Kansas City Chiefs,Buffalo Bills,KC,17,21,4,3,38,42,FALSE,0,0,"",1,4
2000,12,reg,Miami Dolphins,New York Jets,MIA,3,20,17,3.5,23,38.5,FALSE,0,0,"",13.5,15.5
2000,12,reg,Minnesota Vikings,Carolina Panthers,MIN,31,17,14,9.5,48,46.5,FALSE,1,0,DOME,4.5,1.5
2000,12,reg,New England Patriots,Cincinnati Bengals,NE,16,13,3,7,29,36,FALSE,0,0,"",4,7
2000,12,reg,New Orleans Saints,Oakland Raiders,OAK,22,31,9,3,53,43,FALSE,1,0,DOME,6,10
2000,12,reg,New York Giants,Detroit Lions,NYG,21,31,10,5,52,36.5,FALSE,0,0,"",5,15.5
2000,12,reg,Philadelphia Eagles,Arizona Cardinals,PHI,34,9,25,7,43,38,FALSE,0,0,"",18,5
2000,12,reg,Pittsburgh Steelers,Jacksonville Jaguars,PIT,24,34,10,3,58,37,FALSE,0,0,"",7,21
2000,12,reg,San Francisco 49ers,Atlanta Falcons,SF,16,6,10,5.5,22,47.5,FALSE,0,0,"",4.5,25.5
2000,12,reg,Tennessee Titans,Cleveland Browns,TEN,24,10,14,16,34,35.5,FALSE,0,0,"",2,1.5
2000,12,reg,St. Louis Rams,Washington Redskins,LAR,20,33,13,5.5,53,56,FALSE,1,0,DOME,7.5,3
2000,13,reg,Dallas Cowboys,Minnesota Vikings,MIN,15,27,12,7,42,48,FALSE,0,0,"",5,6
2000,13,reg,Detroit Lions,New England Patriots,DET,34,9,25,6.5,43,38,FALSE,1,0,DOME,18.5,5
2000,13,reg,Arizona Cardinals,New York Giants,NYG,7,31,24,6,38,39,FALSE,0,0,"",18,1
2000,13,reg,Baltimore Ravens,Cleveland Browns,BAL,44,7,37,15,51,34,FALSE,0,0,"",22,17
2000,13,reg,Cincinnati Bengals,Pittsburgh Steelers,PIT,28,48,20,4,76,34,FALSE,0,0,"",16,42
2000,13,reg,Indianapolis Colts,Miami Dolphins,IND,14,17,3,5.5,31,44.5,FALSE,1,0,DOME,2.5,13.5
2000,13,reg,Jacksonville Jaguars,Tennessee Titans,TEN,16,13,3,3,29,41.5,FALSE,0,0,"",0,12.5
2000,13,reg,New York Jets,Chicago Bears,NYJ,17,10,7,7,27,39.5,FALSE,0,0,"",0,12.5
2000,13,reg,Oakland Raiders,Atlanta Falcons,OAK,41,14,27,11,55,44,FALSE,0,0,"",16,11
2000,13,reg,San Diego Chargers,Kansas City Chiefs,KC,17,16,1,3,33,41,FALSE,0,0,"",2,8
2000,13,reg,Seattle Seahawks,Denver Broncos,DEN,31,38,7,3,69,45.5,FALSE,0,0,"",4,23.5
2000,13,reg,St. Louis Rams,New Orleans Saints,LAR,24,31,7,13.5,55,53.5,FALSE,1,0,DOME,6.5,1.5
2000,13,reg,Tampa Bay Buccaneers,Buffalo Bills,TB,31,17,14,4,48,37,FALSE,0,0,"",10,11
2000,13,reg,Washington Redskins,Philadelphia Eagles,WAS,20,23,3,7,43,37,FALSE,0,0,"",4,6
2000,13,reg,Carolina Panthers,Green Bay Packers,PICK,31,14,17,0,45,44,FALSE,0,0,"",17,1
2000,14,reg,Minnesota Vikings,Detroit Lions,MIN,24,17,7,9,41,48.5,FALSE,1,0,DOME,2,7.5
2000,14,reg,Atlanta Falcons,Seattle Seahawks,PICK,10,30,20,0,40,42,FALSE,1,0,DOME,20,2
2000,14,reg,Buffalo Bills,Miami Dolphins,BUF,6,33,27,3.5,39,36,FALSE,0,0,"",23.5,3
2000,14,reg,Carolina Panthers,St. Louis Rams,LAR,16,3,13,8,19,58,FALSE,0,0,"",5,39
2000,14,reg,Chicago Bears,Green Bay Packers,GB,6,28,22,2.5,34,39,FALSE,0,0,"",19.5,5
2000,14,reg,Cincinnati Bengals,Arizona Cardinals,CIN,24,13,11,4,37,38.5,FALSE,0,0,"",7,1.5
2000,14,reg,Jacksonville Jaguars,Cleveland Browns,JAX,48,0,48,14.5,48,39,FALSE,0,0,"",33.5,9
2000,14,reg,New Orleans Saints,Denver Broncos,PICK,23,38,15,0,61,45,FALSE,1,0,DOME,15,16
2000,14,reg,New York Jets,Indianapolis Colts,NYJ,27,17,10,2.5,44,44,FALSE,0,0,"",7.5,0
2000,14,reg,Philadelphia Eagles,Tennessee Titans,TEN,13,15,2,3,28,36.5,FALSE,0,0,"",1,8.5
2000,14,reg,Pittsburgh Steelers,Oakland Raiders,OAK,21,20,1,3,41,42,FALSE,0,0,"",2,1
2000,14,reg,San Diego Chargers,San Francisco 49ers,SF,17,45,28,2.5,62,44,FALSE,0,0,"",25.5,18
2000,14,reg,Tampa Bay Buccaneers,Dallas Cowboys,TB,27,7,20,10,34,37,FALSE,0,0,"",10,3
2000,14,reg,Washington Redskins,New York Giants,WAS,7,9,2,6,16,38,FALSE,0,0,"",4,22
2000,14,reg,New England Patriots,Kansas City Chiefs,NE,30,24,6,1,54,41,FALSE,0,0,"",5,13
2000,15,reg,Baltimore Ravens,San Diego Chargers,BAL,24,3,21,13.5,27,36.5,FALSE,0,0,"",7.5,9.5
2000,15,reg,Chicago Bears,New England Patriots,CHI,24,17,7,2,41,36.5,FALSE,0,0,"",5,4.5
2000,15,reg,Cleveland Browns,Philadelphia Eagles,PHI,24,35,11,14,59,35.5,FALSE,0,0,"",3,23.5
2000,15,reg,Dallas Cowboys,Washington Redskins,WAS,32,13,19,6,45,39,FALSE,0,0,"",13,6
2000,15,reg,Denver Broncos,Seattle Seahawks,DEN,31,24,7,10,55,48,FALSE,0,0,"",3,7
2000,15,reg,Green Bay Packers,Detroit Lions,GB,26,13,13,3.5,39,41,FALSE,0,0,"",9.5,2
2000,15,reg,Jacksonville Jaguars,Arizona Cardinals,JAX,44,10,34,15,54,42,FALSE,0,0,"",19,12
2000,15,reg,Kansas City Chiefs,Carolina Panthers,KC,15,14,1,2.5,29,42,FALSE,0,0,"",1.5,13
2000,15,reg,Miami Dolphins,Tampa Bay Buccaneers,MIA,13,16,3,2.5,29,34.5,FALSE,0,0,"",0.5,5.5
2000,15,reg,New York Giants,Pittsburgh Steelers,NYG,30,10,20,3.5,40,35.5,FALSE,0,0,"",16.5,4.5
2000,15,reg,Oakland Raiders,New York Jets,OAK,31,7,24,3.5,38,47,FALSE,0,0,"",20.5,9
2000,15,reg,San Francisco 49ers,New Orleans Saints,SF,27,31,4,3,58,47.5,FALSE,0,0,"",1,10.5
2000,15,reg,St. Louis Rams,Minnesota Vikings,LAR,40,29,11,3.5,69,56.5,FALSE,1,0,DOME,7.5,12.5
2000,15,reg,Tennessee Titans,Cincinnati Bengals,TEN,35,3,32,13,38,36,FALSE,0,0,"",19,2
2000,15,reg,Indianapolis Colts,Buffalo Bills,IND,44,20,24,6,64,45,FALSE,1,0,DOME,18,19
2000,16,reg,Pittsburgh Steelers,Washington Redskins,WAS,24,3,21,1,27,37.5,FALSE,0,0,"",20,10.5
2000,16,reg,Seattle Seahawks,Oakland Raiders,OAK,27,24,3,6,51,47.5,FALSE,0,0,"",3,3.5
2000,16,reg,Arizona Cardinals,Baltimore Ravens,BAL,7,13,6,15,20,37.5,FALSE,0,0,"",9,17.5
2000,16,reg,Buffalo Bills,New England Patriots,BUF,10,13,3,4.5,23,39,FALSE,0,0,"",1.5,16
2000,16,reg,Carolina Panthers,San Diego Chargers,CAR,30,22,8,8.5,52,38.5,FALSE,0,0,"",0.5,13.5
2000,16,reg,Cincinnati Bengals,Jacksonville Jaguars,JAX,17,14,3,10.5,31,42.5,FALSE,0,0,"",7.5,11.5
2000,16,reg,Cleveland Browns,Tennessee Titans,TEN,0,24,24,16,24,37,FALSE,0,0,"",8,13
2000,16,reg,Dallas Cowboys,New York Giants,NYG,13,17,4,6.5,30,36,FALSE,0,0,"",2.5,6
2000,16,reg,Kansas City Chiefs,Denver Broncos,DEN,20,7,13,3,27,47,FALSE,0,0,"",10,20
2000,16,reg,Miami Dolphins,Indianapolis Colts,MIA,13,20,7,3,33,42,FALSE,0,0,"",4,9
2000,16,reg,Minnesota Vikings,Green Bay Packers,MIN,28,33,5,7.5,61,49,FALSE,1,0,DOME,2.5,12
2000,16,reg,New Orleans Saints,Atlanta Falcons,NO,23,7,16,10,30,41,FALSE,1,0,DOME,6,11
2000,16,reg,New York Jets,Detroit Lions,NYJ,7,10,3,6.5,17,39.5,FALSE,0,0,"",3.5,22.5
2000,16,reg,San Francisco 49ers,Chicago Bears,SF,17,0,17,6,17,45.5,FALSE,0,0,"",11,28.5
2000,16,reg,Tampa Bay Buccaneers,St. Louis Rams,LAR,38,35,3,1,73,49,FALSE,0,0,"",2,24
2000,17,reg,Denver Broncos,San Francisco 49ers,DEN,38,9,29,7,47,48.5,FALSE,0,0,"",22,1.5
2000,17,reg,New York Giants,Jacksonville Jaguars,NYG,28,25,3,4,53,37.5,FALSE,0,0,"",1,15.5
2000,17,reg,Seattle Seahawks,Buffalo Bills,SEA,23,42,19,3,65,42.5,FALSE,0,0,"",16,22.5
2000,17,reg,Atlanta Falcons,Kansas City Chiefs,KC,29,13,16,4.5,42,40.5,FALSE,1,0,DOME,11.5,1.5
2000,17,reg,Baltimore Ravens,New York Jets,BAL,34,20,14,6,54,35.5,FALSE,0,0,"",8,18.5
2000,17,reg,Detroit Lions,Chicago Bears,DET,20,23,3,10,43,37,FALSE,1,0,DOME,7,6
2000,17,reg,Green Bay Packers,Tampa Bay Buccaneers,GB,17,14,3,2.5,31,38,FALSE,0,0,"",0.5,7
2000,17,reg,Indianapolis Colts,Minnesota Vikings,IND,31,10,21,3,41,53.5,FALSE,1,0,DOME,18,12.5
2000,17,reg,New England Patriots,Miami Dolphins,MIA,24,27,3,4,51,35,FALSE,0,0,"",1,16
2000,17,reg,New Orleans Saints,St. Louis Rams,LAR,21,26,5,3.5,47,56,FALSE,1,0,DOME,1.5,9
2000,17,reg,Oakland Raiders,Carolina Panthers,OAK,52,9,43,9,61,45.5,FALSE,0,0,"",34,15.5
2000,17,reg,Philadelphia Eagles,Cincinnati Bengals,PHI,16,7,9,10.5,23,35,FALSE,0,0,"",1.5,12
2000,17,reg,San Diego Chargers,Pittsburgh Steelers,PIT,21,34,13,3,55,37.5,FALSE,0,0,"",10,17.5
2000,17,reg,Washington Redskins,Arizona Cardinals,WAS,20,3,17,7,23,38.5,FALSE,0,0,"",10,15.5
2000,17,reg,Tennessee Titans,Dallas Cowboys,TEN,31,0,31,13.5,31,37.5,FALSE,0,0,"",17.5,6.5
2000,Wildcard,post,Miami Dolphins,Indianapolis Colts,IND,23,17,6,1.5,40,42,FALSE,0,0,"",4.5,2
2000,Wildcard,post,New Orleans Saints,St. Louis Rams,LAR,31,28,3,5.5,59,55,FALSE,1,0,DOME,2.5,4
2000,Wildcard,post,Baltimore Ravens,Denver Broncos,BAL,21,3,18,3.5,24,41,FALSE,0,0,"",14.5,17
2000,Wildcard,post,Philadelphia Eagles,Tampa Bay Buccaneers,TB,21,3,18,3,24,34,FALSE,0,0,"",15,10
2000,Division,post,Minnesota Vikings,New Orleans Saints,MIN,34,16,18,8,50,49.5,FALSE,1,0,DOME,10,0.5
2000,Division,post,Oakland Raiders,Miami Dolphins,OAK,27,0,27,9,27,42,FALSE,0,0,"",18,15
2000,Division,post,New York Giants,Philadelphia Eagles,NYG,20,10,10,4.5,30,33.5,FALSE,0,0,"",5.5,3.5
2000,Division,post,Tennessee Titans,Baltimore Ravens,TEN,10,24,14,6,34,34,FALSE,0,0,"",8,0
2000,Conference,post,New York Giants,Minnesota Vikings,MIN,41,0,41,1,41,41.5,FALSE,0,0,"",40,0.5
2000,Conference,post,Oakland Raiders,Baltimore Ravens,OAK,3,16,13,6,19,38,FALSE,0,0,"",7,19
2000,Superbowl,post,Baltimore Ravens,New York Giants,BAL,34,7,27,3,41,33,TRUE,0,0,"",24,8
2001,1,reg,Baltimore Ravens,Chicago Bears,BAL,17,6,11,10.5,23,33.5,FALSE,0,0,"",0.5,10.5
2001,1,reg,Buffalo Bills,New Orleans Saints,NO,6,24,18,1.5,30,37.5,FALSE,0,0,"",16.5,7.5
2001,1,reg,Cincinnati Bengals,New England Patriots,PICK,23,17,6,0,40,36,FALSE,0,0,"",6,4
2001,1,reg,Cleveland Browns,Seattle Seahawks,SEA,6,9,3,4,15,38.5,FALSE,0,0,"",1,23.5
2001,1,reg,Dallas Cowboys,Tampa Bay Buccaneers,TB,6,10,4,9,16,34,FALSE,0,0,"",5,18
2001,1,reg,Green Bay Packers,Detroit Lions,GB,28,6,22,5.5,34,41.5,FALSE,0,0,"",16.5,7.5
2001,1,reg,Jacksonville Jaguars,Pittsburgh Steelers,JAX,21,3,18,3,24,37.5,FALSE,0,0,"",15,13.5
2001,1,reg,Kansas City Chiefs,Oakland Raiders,OAK,24,27,3,3,51,43,FALSE,0,0,"",0,8
2001,1,reg,Minnesota Vikings,Carolina Panthers,MIN,13,24,11,10,37,45,FALSE,1,0,DOME,1,8
2001,1,reg,New York Jets,Indianapolis Colts,IND,24,45,21,1.5,69,44.5,FALSE,0,0,"",19.5,24.5
2001,1,reg,Philadelphia Eagles,St. Louis Rams,LAR,17,20,3,3,37,46,FALSE,0,0,"",0,9
2001,1,reg,San Diego Chargers,Washington Redskins,LAC,30,3,27,2.5,33,36.5,FALSE,0,0,"",24.5,3.5
2001,1,reg,San Francisco 49ers,Atlanta Falcons,SF,16,13,3,3.5,29,46,FALSE,0,0,"",0.5,17
2001,1,reg,Tennessee Titans,Miami Dolphins,TEN,23,31,8,6.5,54,34,FALSE,0,0,"",1.5,20
2001,1,reg,Denver Broncos,New York Giants,DEN,31,20,11,7,51,43.5,FALSE,0,0,"",4,7.5
2001,2,reg,Arizona Cardinals,Denver Broncos,DEN,17,38,21,8.5,55,45,FALSE,0,0,"",12.5,10
2001,2,reg,Atlanta Falcons,Carolina Panthers,ATL,24,16,8,3.5,40,41,FALSE,1,0,DOME,4.5,1
2001,2,reg,Chicago Bears,Minnesota Vikings,MIN,17,10,7,3,27,43.5,FALSE,0,0,"",4,16.5
2001,2,reg,Cincinnati Bengals,Baltimore Ravens,BAL,21,10,11,7,31,33.5,FALSE,0,0,"",4,2.5
2001,2,reg,Cleveland Browns,Detroit Lions,DET,24,14,10,1.5,38,33,FALSE,0,0,"",8.5,5
2001,2,reg,Dallas Cowboys,San Diego Chargers,LAC,21,32,11,3.5,53,34,FALSE,0,0,"",7.5,19
2001,2,reg,Indianapolis Colts,Buffalo Bills,IND,42,26,16,10,68,44.5,FALSE,1,0,DOME,6,23.5
2001,2,reg,Jacksonville Jaguars,Tennessee Titans,JAX,13,6,7,2,19,36,FALSE,0,0,"",5,17
2001,2,reg,Kansas City Chiefs,New York Giants,KC,3,13,10,1.5,16,39,FALSE,0,0,"",8.5,23
2001,2,reg,Miami Dolphins,Oakland Raiders,MIA,18,15,3,1.5,33,40,FALSE,0,0,"",1.5,7
2001,2,reg,New England Patriots,New York Jets,NYJ,3,10,7,1.5,13,38.5,FALSE,0,0,"",5.5,25.5
2001,2,reg,San Francisco 49ers,St. Louis Rams,LAR,26,30,4,6,56,50,FALSE,0,0,"",2,6
2001,2,reg,Seattle Seahawks,Philadelphia Eagles,PHI,3,27,24,2.5,30,37,FALSE,0,0,"",21.5,7
2001,2,reg,Green Bay Packers,Washington Redskins,GB,37,0,37,8.5,37,41,FALSE,0,0,"",28.5,4
2001,3,reg,Arizona Cardinals,Atlanta Falcons,ATL,14,34,20,3,48,42,FALSE,0,0,"",17,6
2001,3,reg,Buffalo Bills,Pittsburgh Steelers,PIT,3,20,17,3,23,36,FALSE,0,0,"",14,13
2001,3,reg,Carolina Panthers,Green Bay Packers,GB,7,28,21,3.5,35,41,FALSE,0,0,"",17.5,6
2001,3,reg,Denver Broncos,Baltimore Ravens,DEN,13,20,7,4.5,33,41,FALSE,0,0,"",2.5,8
2001,3,reg,Jacksonville Jaguars,Cleveland Browns,JAX,14,23,9,8.5,37,35.5,FALSE,0,0,"",0.5,1.5
2001,3,reg,Minnesota Vikings,Tampa Bay Buccaneers,TB,20,16,4,2.5,36,39,FALSE,1,0,DOME,1.5,3
2001,3,reg,New England Patriots,Indianapolis Colts,IND,44,13,31,11.5,57,45,FALSE,0,0,"",19.5,12
2001,3,reg,New York Giants,New Orleans Saints,NYG,21,13,8,3,34,37,FALSE,0,0,"",5,3
2001,3,reg,Oakland Raiders,Seattle Seahawks,OAK,38,14,24,10.5,52,39,FALSE,0,0,"",13.5,13
2001,3,reg,Philadelphia Eagles,Dallas Cowboys,PHI,40,18,22,13.5,58,34.5,FALSE,0,0,"",8.5,23.5
2001,3,reg,San Diego Chargers,Cincinnati Bengals,LAC,28,14,14,6.5,42,39,FALSE,0,0,"",7.5,3
2001,3,reg,St. Louis Rams,Miami Dolphins,LAR,42,10,32,6,52,44,FALSE,1,0,DOME,26,8
2001,3,reg,Washington Redskins,Kansas City Chiefs,KC,13,45,32,3,58,35.5,FALSE,0,0,"",29,22.5
2001,3,reg,New York Jets,San Francisco 49ers,NYJ,17,19,2,3,36,44.5,FALSE,0,0,"",1,8.5
2001,4,reg,Atlanta Falcons,Chicago Bears,ATL,3,31,28,3.5,34,39.5,FALSE,1,0,DOME,24.5,5.5
2001,4,reg,Baltimore Ravens,Tennessee Titans,BAL,26,7,19,3.5,33,33.5,FALSE,0,0,"",15.5,0.5
2001,4,reg,Buffalo Bills,New York Jets,NYJ,36,42,6,4.5,78,36,FALSE,0,0,"",1.5,42
2001,4,reg,Cleveland Browns,San Diego Chargers,LAC,20,16,4,3,36,35,FALSE,0,0,"",1,1
2001,4,reg,Denver Broncos,Kansas City Chiefs,DEN,20,6,14,10,26,48,FALSE,0,0,"",4,22
2001,4,reg,Miami Dolphins,New England Patriots,MIA,30,10,20,9.5,40,35,FALSE,0,0,"",10.5,5
2001,4,reg,New Orleans Saints,Minnesota Vikings,NO,28,15,13,3.5,43,44,FALSE,1,0,DOME,9.5,1
2001,4,reg,New York Giants,Washington Redskins,NYG,23,9,14,14,32,36,FALSE,0,0,"",0,4
2001,4,reg,Oakland Raiders,Dallas Cowboys,OAK,28,21,7,18,49,41.5,FALSE,0,0,"",11,7.5
2001,4,reg,Philadelphia Eagles,Arizona Cardinals,PHI,20,21,1,14.5,41,41,FALSE,0,0,"",13.5,0
2001,4,reg,Pittsburgh Steelers,Cincinnati Bengals,PIT,16,7,9,5,23,35.5,FALSE,0,0,"",4,12.5
2001,4,reg,San Francisco 49ers,Carolina Panthers,SF,24,14,10,6.5,38,45,FALSE,0,0,"",3.5,7
2001,4,reg,Seattle Seahawks,Jacksonville Jaguars,JAX,24,15,9,3.5,39,35,FALSE,0,0,"",5.5,4
2001,4,reg,Tampa Bay Buccaneers,Green Bay Packers,TB,14,10,4,3,24,36.5,FALSE,0,0,"",1,12.5
2001,4,reg,Detroit Lions,St. Louis Rams,LAR,0,35,35,12.5,35,48.5,FALSE,1,0,DOME,22.5,13.5
2001,5,reg,Atlanta Falcons,San Francisco 49ers,SF,31,37,6,3,68,43.5,FALSE,1,0,DOME,3,24.5
2001,5,reg,Carolina Panthers,New Orleans Saints,NO,25,27,2,5,52,39.5,FALSE,0,0,"",3,12.5
2001,5,reg,Chicago Bears,Arizona Cardinals,CHI,20,13,7,7,33,39.5,FALSE,0,0,"",0,6.5
2001,5,reg,Cincinnati Bengals,Cleveland Browns,CIN,24,14,10,1.5,38,35,FALSE,0,0,"",8.5,3
2001,5,reg,Green Bay Packers,Baltimore Ravens,PICK,31,23,8,0,54,34,FALSE,0,0,"",8,20
2001,5,reg,Indianapolis Colts,Oakland Raiders,IND,18,23,5,3.5,41,52,FALSE,1,0,DOME,1.5,11
2001,5,reg,Kansas City Chiefs,Pittsburgh Steelers,KC,17,20,3,2.5,37,36,FALSE,0,0,"",0.5,1
2001,5,reg,Minnesota Vikings,Detroit Lions,MIN,31,26,5,10,57,44,FALSE,1,0,DOME,5,13
2001,5,reg,New England Patriots,San Diego Chargers,LAC,29,26,3,3,55,36,FALSE,0,0,"",0,19
2001,5,reg,New York Jets,Miami Dolphins,MIA,21,17,4,3,38,38,FALSE,0,0,"",1,0
2001,5,reg,Seattle Seahawks,Denver Broncos,DEN,34,21,13,6,55,44,FALSE,0,0,"",7,11
2001,5,reg,St. Louis Rams,New York Giants,LAR,15,14,1,10.5,29,45,FALSE,1,0,DOME,9.5,16
2001,5,reg,Tennessee Titans,Tampa Bay Buccaneers,TEN,31,28,3,3,59,33,FALSE,0,0,"",0,26
2001,5,reg,Dallas Cowboys,Washington Redskins,DAL,9,7,2,3,16,37,FALSE,0,0,"",1,21
2001,6,reg,Jacksonville Jaguars,Buffalo Bills,JAX,10,13,3,9,23,38.5,FALSE,0,0,"",6,15.5
2001,6,reg,Arizona Cardinals,Kansas City Chiefs,KC,24,16,8,2,40,41,FALSE,0,0,"",6,1
2001,6,reg,Cincinnati Bengals,Chicago Bears,CIN,0,24,24,1,24,36,FALSE,0,0,"",23,12
2001,6,reg,Cleveland Browns,Baltimore Ravens,BAL,24,14,10,7.5,38,33,FALSE,0,0,"",2.5,5
2001,6,reg,Detroit Lions,Tennessee Titans,TEN,24,27,3,5.5,51,38.5,FALSE,1,0,DOME,2.5,12.5
2001,6,reg,Indianapolis Colts,New England Patriots,IND,17,38,21,10.5,55,48,FALSE,1,0,DOME,10.5,7
2001,6,reg,Minnesota Vikings,Green Bay Packers,GB,35,13,22,3,48,47.5,FALSE,1,0,DOME,19,0.5
2001,6,reg,New Orleans Saints,Atlanta Falcons,NO,13,20,7,8,33,42,FALSE,1,0,DOME,1,9
2001,6,reg,New York Jets,St. Louis Rams,LAR,14,34,20,7,48,46.5,FALSE,0,0,"",13,1.5
2001,6,reg,San Diego Chargers,Denver Broncos,DEN,27,10,17,2.5,37,43.5,FALSE,0,0,"",14.5,6.5
2001,6,reg,Tampa Bay Buccaneers,Pittsburgh Steelers,TB,10,17,7,5,27,33.5,FALSE,0,0,"",2,6.5
2001,6,reg,Washington Redskins,Carolina Panthers,CAR,17,14,3,3.5,31,36,FALSE,0,0,"",0.5,5
2001,6,reg,New York Giants,Philadelphia Eagles,NYG,9,10,1,3,19,35.5,FALSE,0,0,"",2,16.5
2001,7,reg,Kansas City Chiefs,Indianapolis Colts,IND,28,35,7,3,63,47.5,FALSE,0,0,"",4,15.5
2001,7,reg,Baltimore Ravens,Jacksonville Jaguars,BAL,18,17,1,7.5,35,33,FALSE,0,0,"",6.5,2
2001,7,reg,Carolina Panthers,New York Jets,NYJ,12,13,1,2.5,25,39,FALSE,0,0,"",1.5,14
2001,7,reg,Chicago Bears,San Francisco 49ers,CHI,37,31,6,2,68,39,FALSE,0,0,"",4,29
2001,7,reg,Dallas Cowboys,Arizona Cardinals,ARI,17,3,14,3,20,38,FALSE,0,0,"",11,18
2001,7,reg,Denver Broncos,New England Patriots,DEN,31,20,11,7,51,43,FALSE,0,0,"",4,8
2001,7,reg,Detroit Lions,Cincinnati Bengals,DET,27,31,4,3,58,39.5,FALSE,1,0,DOME,1,18.5
2001,7,reg,Philadelphia Eagles,Oakland Raiders,PHI,10,20,10,1,30,39,FALSE,0,0,"",9,9
2001,7,reg,San Diego Chargers,Buffalo Bills,LAC,27,24,3,7.5,51,39,FALSE,0,0,"",4.5,12
2001,7,reg,Seattle Seahawks,Miami Dolphins,MIA,20,24,4,2.5,44,36.5,FALSE,0,0,"",1.5,7.5
2001,7,reg,St. Louis Rams,New Orleans Saints,LAR,31,34,3,12,65,48.5,FALSE,1,0,DOME,9,16.5
2001,7,reg,Tampa Bay Buccaneers,Minnesota Vikings,TB,41,14,27,3,55,38.5,FALSE,0,0,"",24,16.5
2001,7,reg,Washington Redskins,New York Giants,NYG,35,21,14,7.5,56,33.5,FALSE,0,0,"",6.5,22.5
2001,7,reg,Pittsburgh Steelers,Tennessee Titans,PIT,34,7,27,3,41,36,FALSE,0,0,"",24,5
2001,8,reg,Arizona Cardinals,Philadelphia Eagles,PHI,7,21,14,7,28,39.5,FALSE,0,0,"",7,11.5
2001,8,reg,Atlanta Falcons,New England Patriots,ATL,10,24,14,3,34,42.5,FALSE,1,0,DOME,11,8.5
2001,8,reg,Buffalo Bills,Indianapolis Colts,IND,14,30,16,3,44,44.5,FALSE,0,0,"",13,0.5
2001,8,reg,Chicago Bears,Cleveland Browns,CHI,27,21,6,4.5,48,34,FALSE,0,0,"",1.5,14
2001,8,reg,Green Bay Packers,Tampa Bay Buccaneers,GB,21,20,1,5,41,37,FALSE,0,0,"",4,4
2001,8,reg,Miami Dolphins,Carolina Panthers,MIA,23,6,17,10,29,34.5,FALSE,0,0,"",7,5.5
2001,8,reg,New Orleans Saints,New York Jets,NO,9,16,7,6.5,25,42.5,FALSE,1,0,DOME,0.5,17.5
2001,8,reg,New York Giants,Dallas Cowboys,NYG,27,24,3,10.5,51,35.5,FALSE,0,0,"",7.5,15.5
2001,8,reg,Pittsburgh Steelers,Baltimore Ravens,PIT,10,13,3,2,23,33,FALSE,0,0,"",1,10
2001,8,reg,San Diego Chargers,Kansas City Chiefs,LAC,20,25,5,5.5,45,41,FALSE,0,0,"",0.5,4
2001,8,reg,San Francisco 49ers,Detroit Lions,SF,21,13,8,8.5,34,47,FALSE,0,0,"",0.5,13
2001,8,reg,Tennessee Titans,Jacksonville Jaguars,TEN,28,24,4,3,52,37.5,FALSE,0,0,"",1,14.5
2001,8,reg,Washington Redskins,Seattle Seahawks,SEA,27,14,13,2.5,41,37,FALSE,0,0,"",10.5,4
2001,8,reg,Oakland Raiders,Denver Broncos,OAK,38,28,10,5.5,66,45.5,FALSE,0,0,"",4.5,20.5
2001,9,reg,Arizona Cardinals,New York Giants,NYG,10,17,7,5.5,27,37.5,FALSE,0,0,"",1.5,10.5
2001,9,reg,Atlanta Falcons,Dallas Cowboys,ATL,20,13,7,6,33,37,FALSE,1,0,DOME,1,4
2001,9,reg,Chicago Bears,Green Bay Packers,GB,12,20,8,2.5,32,37.5,FALSE,0,0,"",5.5,5.5
2001,9,reg,Cleveland Browns,Pittsburgh Steelers,PIT,12,15,3,3,27,33,FALSE,0,0,"",0,6
2001,9,reg,Denver Broncos,San Diego Chargers,DEN,26,16,10,5.5,42,45,FALSE,0,0,"",4.5,3
2001,9,reg,Detroit Lions,Tampa Bay Buccaneers,TB,17,20,3,5,37,40,FALSE,1,0,DOME,2,3
2001,9,reg,Indianapolis Colts,Miami Dolphins,IND,24,27,3,3,51,44,FALSE,1,0,DOME,0,7
2001,9,reg,Jacksonville Jaguars,Cincinnati Bengals,JAX,30,13,17,4,43,39.5,FALSE,0,0,"",13,3.5
2001,9,reg,New England Patriots,Buffalo Bills,NE,21,11,10,6,32,40,FALSE,0,0,"",4,8
2001,9,reg,New York Jets,Kansas City Chiefs,NYJ,27,7,20,4.5,34,40.5,FALSE,0,0,"",15.5,6.5
2001,9,reg,Philadelphia Eagles,Minnesota Vikings,PHI,48,17,31,4.5,65,41,FALSE,0,0,"",26.5,24
2001,9,reg,San Francisco 49ers,New Orleans Saints,SF,28,27,1,3,55,45,FALSE,0,0,"",2,10
2001,9,reg,Seattle Seahawks,Oakland Raiders,OAK,34,27,7,6,61,43.5,FALSE,0,0,"",1,17.5
2001,9,reg,St. Louis Rams,Carolina Panthers,LAR,48,14,34,18,62,47,FALSE,1,0,DOME,16,15
2001,9,reg,Tennessee Titans,Baltimore Ravens,BAL,10,16,6,1.5,26,35,FALSE,0,0,"",4.5,9
2001,10,reg,Arizona Cardinals,Detroit Lions,ARI,45,38,7,2,83,39.5,FALSE,0,0,"",5,43.5
2001,10,reg,Baltimore Ravens,Cleveland Browns,BAL,17,27,10,8,44,33,FALSE,0,0,"",2,11
2001,10,reg,Buffalo Bills,Seattle Seahawks,SEA,20,23,3,3.5,43,39,FALSE,0,0,"",0.5,4
2001,10,reg,Carolina Panthers,San Francisco 49ers,SF,22,25,3,7,47,43,FALSE,0,0,"",4,4
2001,10,reg,Cincinnati Bengals,Tennessee Titans,CIN,7,20,13,1.5,27,39.5,FALSE,0,0,"",11.5,12.5
2001,10,reg,Dallas Cowboys,Philadelphia Eagles,PHI,3,36,33,7,39,37,FALSE,0,0,"",26,2
2001,10,reg,Denver Broncos,Washington Redskins,DEN,10,17,7,8.5,27,43,FALSE,0,0,"",1.5,16
2001,10,reg,Green Bay Packers,Atlanta Falcons,GB,20,23,3,10,43,39.5,FALSE,0,0,"",7,3.5
2001,10,reg,Miami Dolphins,New York Jets,MIA,0,24,24,5.5,24,37.5,FALSE,0,0,"",18.5,13.5
2001,10,reg,New England Patriots,St. Louis Rams,LAR,17,24,7,8.5,41,46.5,FALSE,0,0,"",1.5,5.5
2001,10,reg,New Orleans Saints,Indianapolis Colts,NO,34,20,14,5.5,54,47.5,FALSE,1,0,DOME,8.5,6.5
2001,10,reg,Oakland Raiders,San Diego Chargers,OAK,34,24,10,9,58,45,FALSE,0,0,"",1,13
2001,10,reg,Pittsburgh Steelers,Jacksonville Jaguars,PIT,20,7,13,5.5,27,36,FALSE,0,0,"",7.5,9
2001,10,reg,Tampa Bay Buccaneers,Chicago Bears,TB,24,27,3,5,51,35,FALSE,0,0,"",2,16
2001,10,reg,Minnesota Vikings,New York Giants,MIN,28,16,12,2,44,44,FALSE,1,0,DOME,10,0
2001,11,reg,Dallas Cowboys,Denver Broncos,DEN,24,26,2,7,50,40.5,FALSE,0,0,"",5,9.5
2001,11,reg,Detroit Lions,Green Bay Packers,GB,27,29,2,7,56,47,FALSE,1,0,DOME,5,9
2001,11,reg,Buffalo Bills,Miami Dolphins,MIA,27,34,7,5,61,36,FALSE,0,0,"",2,25
2001,11,reg,Carolina Panthers,Atlanta Falcons,ATL,7,10,3,3,17,40,FALSE,0,0,"",0,23
2001,11,reg,Cleveland Browns,Cincinnati Bengals,CLE,18,0,18,6,18,35.5,FALSE,0,0,"",12,17.5
2001,11,reg,Indianapolis Colts,San Francisco 49ers,IND,21,40,19,2.5,61,52.5,FALSE,1,0,DOME,16.5,8.5
2001,11,reg,Jacksonville Jaguars,Baltimore Ravens,BAL,21,24,3,3,45,34,FALSE,0,0,"",0,11
2001,11,reg,Kansas City Chiefs,Seattle Seahawks,KC,19,7,12,1.5,26,41,FALSE,0,0,"",10.5,15
2001,11,reg,Minnesota Vikings,Chicago Bears,MIN,6,13,7,3,19,45,FALSE,1,0,DOME,4,26
2001,11,reg,New England Patriots,New Orleans Saints,PICK,34,17,17,0,51,42,FALSE,0,0,"",17,9
2001,11,reg,New York Giants,Oakland Raiders,OAK,10,28,18,2.5,38,39,FALSE,0,0,"",15.5,1
2001,11,reg,Philadelphia Eagles,Washington Redskins,PHI,3,13,10,8,16,37.5,FALSE,0,0,"",2,21.5
2001,11,reg,San Diego Chargers,Arizona Cardinals,LAC,17,20,3,7,37,44,FALSE,0,0,"",4,7
2001,11,reg,Tennessee Titans,Pittsburgh Steelers,TEN,24,34,10,2,58,34.5,FALSE,0,0,"",8,23.5
2001,11,reg,St. Louis Rams,Tampa Bay Buccaneers,LAR,17,24,7,9.5,41,46,FALSE,1,0,DOME,2.5,5
2001,12,reg,Kansas City Chiefs,Philadelphia Eagles,PHI,10,23,13,3,33,37,FALSE,0,0,"",10,4
2001,12,reg,Atlanta Falcons,St. Louis Rams,LAR,6,35,29,8,41,47,FALSE,1,0,DOME,21,6
2001,12,reg,Baltimore Ravens,Indianapolis Colts,BAL,39,27,12,7,66,43,FALSE,0,0,"",5,23
2001,12,reg,Chicago Bears,Detroit Lions,CHI,13,10,3,7,23,38,FALSE,0,0,"",4,15
2001,12,reg,Cincinnati Bengals,Tampa Bay Buccaneers,TB,13,16,3,5,29,35,FALSE,0,0,"",2,6
2001,12,reg,Cleveland Browns,Tennessee Titans,CLE,15,31,16,1.5,46,35.5,FALSE,0,0,"",14.5,10.5
2001,12,reg,Miami Dolphins,Denver Broncos,MIA,21,10,11,3,31,39.5,FALSE,0,0,"",8,8.5
2001,12,reg,New Orleans Saints,Carolina Panthers,NO,27,23,4,10,50,41,FALSE,1,0,DOME,6,9
2001,12,reg,New York Jets,New England Patriots,NYJ,16,17,1,3,33,38,FALSE,0,0,"",2,5
2001,12,reg,Oakland Raiders,Arizona Cardinals,OAK,31,34,3,13,65,44,FALSE,0,0,"",10,21
2001,12,reg,Pittsburgh Steelers,Minnesota Vikings,PIT,21,16,5,7,37,41,FALSE,0,0,"",2,4
2001,12,reg,San Francisco 49ers,Buffalo Bills,SF,35,0,35,8.5,35,44.5,FALSE,0,0,"",26.5,9.5
2001,12,reg,Seattle Seahawks,San Diego Chargers,SEA,13,10,3,3,23,43,FALSE,0,0,"",0,20
2001,12,reg,Washington Redskins,Dallas Cowboys,WAS,14,20,6,8.5,34,35.5,FALSE,0,0,"",2.5,1.5
2001,12,reg,Jacksonville Jaguars,Green Bay Packers,GB,21,28,7,3,49,43,FALSE,0,0,"",4,6
2001,13,reg,Arizona Cardinals,Washington Redskins,ARI,10,20,10,2,30,38.5,FALSE,0,0,"",8,8.5
2001,13,reg,Atlanta Falcons,New Orleans Saints,NO,10,28,18,3,38,39,FALSE,1,0,DOME,15,1
2001,13,reg,Buffalo Bills,Carolina Panthers,BUF,25,24,1,3.5,49,36.5,FALSE,0,0,"",2.5,12.5
2001,13,reg,Cincinnati Bengals,Jacksonville Jaguars,CIN,10,14,4,1,24,36.5,FALSE,0,0,"",3,12.5
2001,13,reg,Dallas Cowboys,New York Giants,NYG,20,13,7,3.5,33,35.5,FALSE,0,0,"",3.5,2.5
2001,13,reg,Denver Broncos,Seattle Seahawks,DEN,20,7,13,6,27,41,FALSE,0,0,"",7,14
2001,13,reg,Green Bay Packers,Chicago Bears,GB,17,7,10,5.5,24,37.5,FALSE,0,0,"",4.5,13.5
2001,13,reg,Minnesota Vikings,Tennessee Titans,TEN,42,24,18,2.5,66,42.5,FALSE,1,0,DOME,15.5,23.5
2001,13,reg,New England Patriots,Cleveland Browns,NE,27,16,11,5,43,36.5,FALSE,0,0,"",6,6.5
2001,13,reg,Oakland Raiders,Kansas City Chiefs,OAK,28,26,2,9,54,44.5,FALSE,0,0,"",7,9.5
2001,13,reg,Philadelphia Eagles,San Diego Chargers,PHI,24,14,10,7,38,37.5,FALSE,0,0,"",3,0.5
2001,13,reg,Pittsburgh Steelers,New York Jets,PIT,18,7,11,3.5,25,34.5,FALSE,0,0,"",7.5,9.5
2001,13,reg,St. Louis Rams,San Francisco 49ers,LAR,27,14,13,7,41,55,FALSE,1,0,DOME,6,14
2001,13,reg,Tampa Bay Buccaneers,Detroit Lions,TB,15,12,3,8,27,36.5,FALSE,0,0,"",5,9.5
2001,13,reg,Miami Dolphins,Indianapolis Colts,MIA,41,6,35,5,47,45,FALSE,0,0,"",30,2
2001,14,reg,New York Giants,Arizona Cardinals,NYG,17,13,4,5,30,37.5,FALSE,0,0,"",1,7.5
2001,14,reg,San Diego Chargers,Oakland Raiders,OAK,6,13,7,4,19,46.5,FALSE,0,0,"",3,27.5
2001,14,reg,Baltimore Ravens,Pittsburgh Steelers,BAL,21,26,5,3,47,33.5,FALSE,0,0,"",2,13.5
2001,14,reg,Buffalo Bills,New England Patriots,NE,9,12,3,4,21,38,FALSE,0,0,"",1,17
2001,14,reg,Chicago Bears,Tampa Bay Buccaneers,CHI,27,3,24,2.5,30,33,FALSE,0,0,"",21.5,3
2001,14,reg,Cleveland Browns,Jacksonville Jaguars,CLE,10,15,5,2,25,36.5,FALSE,0,0,"",3,11.5
2001,14,reg,Detroit Lions,Minnesota Vikings,MIN,27,24,3,3,51,46.5,FALSE,1,0,DOME,0,4.5
2001,14,reg,Indianapolis Colts,Atlanta Falcons,IND,41,27,14,4,68,46.5,FALSE,1,0,DOME,10,21.5
2001,14,reg,Kansas City Chiefs,Denver Broncos,DEN,26,23,3,2.5,49,37.5,FALSE,0,0,"",0.5,11.5
2001,14,reg,New York Jets,Cincinnati Bengals,NYJ,15,14,1,8.5,29,35,FALSE,0,0,"",7.5,6
2001,14,reg,San Francisco 49ers,Miami Dolphins,SF,21,0,21,3.5,21,43,FALSE,0,0,"",17.5,22
2001,14,reg,Seattle Seahawks,Dallas Cowboys,SEA,29,3,26,5.5,32,36.5,FALSE,0,0,"",20.5,4.5
2001,14,reg,Tennessee Titans,Green Bay Packers,GB,26,20,6,2.5,46,42.5,FALSE,0,0,"",3.5,3.5
2001,14,reg,Washington Redskins,Philadelphia Eagles,PHI,6,20,14,2.5,26,34.5,FALSE,0,0,"",11.5,8.5
2001,14,reg,New Orleans Saints,St. Louis Rams,LAR,21,34,13,6,55,51,FALSE,1,0,DOME,7,4
2001,15,reg,New England Patriots,Miami Dolphins,NE,20,13,7,3,33,37,FALSE,0,0,"",4,4
2001,15,reg,Oakland Raiders,Tennessee Titans,OAK,10,13,3,6,23,45.5,FALSE,0,0,"",3,22.5
2001,15,reg,San Francisco 49ers,Philadelphia Eagles,SF,13,3,10,3,16,40,FALSE,0,0,"",7,24
2001,15,reg,Arizona Cardinals,Dallas Cowboys,ARI,17,10,7,3.5,27,37,FALSE,0,0,"",3.5,10
2001,15,reg,Atlanta Falcons,Buffalo Bills,ATL,33,30,3,4,63,41,FALSE,1,0,DOME,1,22
2001,15,reg,Baltimore Ravens,Cincinnati Bengals,BAL,16,0,16,10.5,16,33.5,FALSE,0,0,"",5.5,17.5
2001,15,reg,Carolina Panthers,St. Louis Rams,LAR,32,38,6,12.5,70,46.5,FALSE,0,0,"",6.5,23.5
2001,15,reg,Green Bay Packers,Cleveland Browns,GB,30,7,23,7.5,37,37,FALSE,0,0,"",15.5,0
2001,15,reg,Indianapolis Colts,New York Jets,IND,28,29,1,1,57,47,FALSE,1,0,DOME,0,10
2001,15,reg,Kansas City Chiefs,San Diego Chargers,KC,20,17,3,3.5,37,40,FALSE,0,0,"",0.5,3
2001,15,reg,Minnesota Vikings,Jacksonville Jaguars,MIN,3,33,30,2.5,36,45.5,FALSE,1,0,DOME,27.5,9.5
2001,15,reg,New York Giants,Seattle Seahawks,NYG,27,24,3,3,51,34,FALSE,0,0,"",0,17
2001,15,reg,Pittsburgh Steelers,Detroit Lions,PIT,47,14,33,10,61,36,FALSE,0,0,"",23,25
2001,15,reg,Tampa Bay Buccaneers,New Orleans Saints,TB,48,21,27,2.5,69,38,FALSE,0,0,"",24.5,31
2001,15,reg,Washington Redskins,Chicago Bears,WAS,15,20,5,1,35,33,FALSE,0,0,"",4,2
2001,16,reg,Tampa Bay Buccaneers,Baltimore Ravens,TB,22,10,12,1.5,32,34,FALSE,0,0,"",10.5,2
2001,16,reg,Carolina Panthers,Arizona Cardinals,CAR,7,30,23,1,37,39.5,FALSE,0,0,"",22,2.5
2001,16,reg,Cincinnati Bengals,Pittsburgh Steelers,PIT,26,23,3,8,49,33.5,FALSE,0,0,"",5,15.5
2001,16,reg,Dallas Cowboys,San Francisco 49ers,SF,27,21,6,6.5,48,39.5,FALSE,0,0,"",0.5,8.5
2001,16,reg,Denver Broncos,Oakland Raiders,DEN,23,17,6,1,40,41,FALSE,0,0,"",5,1
2001,16,reg,Detroit Lions,Chicago Bears,CHI,0,24,24,5.5,24,38.5,FALSE,1,0,DOME,18.5,14.5
2001,16,reg,Green Bay Packers,Minnesota Vikings,GB,24,13,11,12,37,40,FALSE,0,0,"",1,3
2001,16,reg,Jacksonville Jaguars,Kansas City Chiefs,JAX,26,30,4,4.5,56,40,FALSE,0,0,"",0.5,16
2001,16,reg,Miami Dolphins,Atlanta Falcons,MIA,21,14,7,7,35,38.5,FALSE,0,0,"",0,3.5
2001,16,reg,New Orleans Saints,Washington Redskins,NO,10,40,30,5,50,39.5,FALSE,1,0,DOME,25,10.5
2001,16,reg,New York Jets,Buffalo Bills,NYJ,9,14,5,7,23,37,FALSE,0,0,"",2,14
2001,16,reg,Philadelphia Eagles,New York Giants,PHI,24,21,3,5,45,34.5,FALSE,0,0,"",2,10.5
2001,16,reg,San Diego Chargers,Seattle Seahawks,LAC,22,25,3,1.5,47,39,FALSE,0,0,"",1.5,8
2001,16,reg,St. Louis Rams,Indianapolis Colts,LAR,42,17,25,13,59,58.5,FALSE,1,0,DOME,12,0.5
2001,16,reg,Tennessee Titans,Cleveland Browns,TEN,38,41,3,5,79,37.5,FALSE,0,0,"",2,41.5
2001,17,reg,Carolina Panthers,New England Patriots,NE,6,38,32,6.5,44,36,FALSE,0,0,"",25.5,8
2001,17,reg,Chicago Bears,Jacksonville Jaguars,CHI,33,13,20,6,46,33.5,FALSE,0,0,"",14,12.5
2001,17,reg,Detroit Lions,Dallas Cowboys,DAL,15,10,5,3,25,36,FALSE,1,0,DOME,2,11
2001,17,reg,Indianapolis Colts,Denver Broncos,IND,29,10,19,2,39,51,FALSE,1,0,DOME,17,12
2001,17,reg,Miami Dolphins,Buffalo Bills,MIA,34,7,27,6.5,41,36.5,FALSE,0,0,"",20.5,4.5
2001,17,reg,New Orleans Saints,San Francisco 49ers,SF,0,38,38,2.5,38,46.5,FALSE,1,0,DOME,35.5,8.5
2001,17,reg,New York Giants,Green Bay Packers,GB,25,34,9,3,59,36.5,FALSE,0,0,"",6,22.5
2001,17,reg,Oakland Raiders,New York Jets,OAK,22,24,2,4.5,46,41.5,FALSE,0,0,"",2.5,4.5
2001,17,reg,Pittsburgh Steelers,Cleveland Browns,PIT,28,7,21,7,35,34.5,FALSE,0,0,"",14,0.5
2001,17,reg,Seattle Seahawks,Kansas City Chiefs,SEA,21,18,3,3.5,39,40,FALSE,0,0,"",0.5,1
2001,17,reg,St. Louis Rams,Atlanta Falcons,LAR,31,13,18,14.5,44,48,FALSE,1,0,DOME,3.5,4
2001,17,reg,Tampa Bay Buccaneers,Philadelphia Eagles,TB,13,17,4,3,30,33,FALSE,0,0,"",1,3
2001,17,reg,Tennessee Titans,Cincinnati Bengals,TEN,21,23,2,5.5,44,37.5,FALSE,0,0,"",3.5,6.5
2001,17,reg,Washington Redskins,Arizona Cardinals,WAS,20,17,3,3.5,37,36.5,FALSE,0,0,"",0.5,0.5
2001,17,reg,Baltimore Ravens,Minnesota Vikings,BAL,19,3,16,10,22,37.5,FALSE,0,0,"",6,15.5
2001,Wildcard,post,Oakland Raiders,New York Jets,OAK,38,24,14,4.5,62,42,FALSE,0,0,"",9.5,20
2001,Wildcard,post,Philadelphia Eagles,Tampa Bay Buccaneers,PHI,31,9,22,3.5,40,33,FALSE,0,0,"",18.5,7
2001,Wildcard,post,Green Bay Packers,San Francisco 49ers,GB,25,15,10,3.5,40,39,FALSE,0,0,"",6.5,1
2001,Wildcard,post,Miami Dolphins,Baltimore Ravens,MIA,3,20,17,2.5,23,33,FALSE,0,0,"",14.5,10
2001,Division,post,Chicago Bears,Philadelphia Eagles,CHI,19,33,14,3,52,32.5,FALSE,0,0,"",11,19.5
2001,Division,post,New England Patriots,Oakland Raiders,NE,16,13,3,3,29,41.5,FALSE,0,0,"",0,12.5
2001,Division,post,Pittsburgh Steelers,Baltimore Ravens,PIT,27,10,17,5.5,37,32,FALSE,0,0,"",11.5,5
2001,Division,post,St. Louis Rams,Green Bay Packers,LAR,45,17,28,11,62,54.5,FALSE,1,0,DOME,17,7.5
2001,Conference,post,Pittsburgh Steelers,New England Patriots,PIT,17,24,7,10,41,35.5,FALSE,0,0,"",3,5.5
2001,Conference,post,St. Louis Rams,Philadelphia Eagles,LAR,29,24,5,11,53,51,FALSE,1,0,DOME,6,2
2001,Superbowl,post,St. Louis Rams,New England Patriots,LAR,17,20,3,14,37,53,TRUE,1,0,DOME,11,16
2002,1,reg,New York Giants,San Francisco 49ers,SF,13,16,3,4,29,39,FALSE,0,0,"",1,10
2002,1,reg,Buffalo Bills,New York Jets,NYJ,31,37,6,3,68,43,FALSE,0,0,"",3,25
2002,1,reg,Carolina Panthers,Baltimore Ravens,PICK,10,7,3,0,17,33,FALSE,0,0,"",3,16
2002,1,reg,Chicago Bears,Minnesota Vikings,CHI,27,23,4,4.5,50,41,FALSE,0,0,"",0.5,9
2002,1,reg,Cincinnati Bengals,San Diego Chargers,CIN,6,34,28,3,40,37,FALSE,0,0,"",25,3
2002,1,reg,Cleveland Browns,Kansas City Chiefs,CLE,39,40,1,2,79,36,FALSE,0,0,"",1,43
2002,1,reg,Denver Broncos,St. Louis Rams,LAR,23,16,7,3,39,51,FALSE,0,0,"",4,12
2002,1,reg,Green Bay Packers,Atlanta Falcons,GB,37,34,3,7,71,42.5,FALSE,0,0,"",4,28.5
2002,1,reg,Houston Texans,Dallas Cowboys,DAL,19,10,9,8.5,29,33.5,FALSE,1,0,DOME,0.5,4.5
2002,1,reg,Jacksonville Jaguars,Indianapolis Colts,IND,25,28,3,3.5,53,44,FALSE,0,0,"",0.5,9
2002,1,reg,Miami Dolphins,Detroit Lions,MIA,49,21,28,9.5,70,35.5,FALSE,0,0,"",18.5,34.5
2002,1,reg,Oakland Raiders,Seattle Seahawks,OAK,31,17,14,7.5,48,40,FALSE,0,0,"",6.5,8
2002,1,reg,Tampa Bay Buccaneers,New Orleans Saints,TB,20,26,6,6,46,37.5,FALSE,0,0,"",0,8.5
2002,1,reg,Tennessee Titans,Philadelphia Eagles,TEN,27,24,3,2,51,37,FALSE,0,0,"",1,14
2002,1,reg,Washington Redskins,Arizona Cardinals,WAS,31,23,8,6,54,44.5,FALSE,0,0,"",2,9.5
2002,1,reg,New England Patriots,Pittsburgh Steelers,PIT,30,14,16,2.5,44,37.5,FALSE,0,0,"",13.5,6.5
2002,2,reg,Atlanta Falcons,Chicago Bears,ATL,13,14,1,2.5,27,45,FALSE,1,0,DOME,1.5,18
2002,2,reg,Baltimore Ravens,Tampa Bay Buccaneers,TB,0,25,25,4.5,25,32,FALSE,0,0,"",20.5,7
2002,2,reg,Carolina Panthers,Detroit Lions,CAR,31,7,24,3,38,35.5,FALSE,0,0,"",21,2.5
2002,2,reg,Cleveland Browns,Cincinnati Bengals,CLE,20,7,13,3.5,27,39,FALSE,0,0,"",9.5,12
2002,2,reg,Dallas Cowboys,Tennessee Titans,TEN,21,13,8,3.5,34,37.5,FALSE,0,0,"",4.5,3.5
2002,2,reg,Indianapolis Colts,Miami Dolphins,PICK,13,21,8,0,34,47,FALSE,1,0,DOME,8,13
2002,2,reg,Kansas City Chiefs,Jacksonville Jaguars,KC,16,23,7,3.5,39,46,FALSE,0,0,"",3.5,7
2002,2,reg,Minnesota Vikings,Buffalo Bills,MIN,39,45,6,3.5,84,49,FALSE,1,0,DOME,2.5,35
2002,2,reg,New Orleans Saints,Green Bay Packers,GB,35,20,15,2.5,55,45.5,FALSE,1,0,DOME,12.5,9.5
2002,2,reg,New York Jets,New England Patriots,NYJ,7,44,37,1,51,41,FALSE,0,0,"",36,10
2002,2,reg,Pittsburgh Steelers,Oakland Raiders,PIT,17,30,13,4,47,39.5,FALSE,0,0,"",9,7.5
2002,2,reg,San Diego Chargers,Houston Texans,LAC,24,3,21,13.5,27,34,FALSE,0,0,"",7.5,7
2002,2,reg,San Francisco 49ers,Denver Broncos,SF,14,24,10,3.5,38,44,FALSE,0,0,"",6.5,6
2002,2,reg,Seattle Seahawks,Arizona Cardinals,SEA,13,24,11,4,37,40.5,FALSE,0,0,"",7,3.5
2002,2,reg,St. Louis Rams,New York Giants,LAR,21,26,5,12,47,46,FALSE,1,0,DOME,7,1
2002,2,reg,Washington Redskins,Philadelphia Eagles,PHI,7,37,30,3,44,44,FALSE,0,0,"",27,0
2002,3,reg,Arizona Cardinals,San Diego Chargers,LAC,15,23,8,2.5,38,39,FALSE,0,0,"",5.5,1
2002,3,reg,Atlanta Falcons,Cincinnati Bengals,ATL,30,3,27,7,33,42.5,FALSE,1,0,DOME,20,9.5
2002,3,reg,Chicago Bears,New Orleans Saints,NO,23,29,6,2,52,40.5,FALSE,0,0,"",4,11.5
2002,3,reg,Denver Broncos,Buffalo Bills,DEN,28,23,5,7.5,51,47,FALSE,0,0,"",2.5,4
2002,3,reg,Detroit Lions,Green Bay Packers,GB,31,37,6,7.5,68,44,FALSE,1,0,DOME,1.5,24
2002,3,reg,Houston Texans,Indianapolis Colts,IND,3,23,20,10.5,26,38,FALSE,1,0,DOME,9.5,12
2002,3,reg,Miami Dolphins,New York Jets,MIA,30,3,27,6,33,40.5,FALSE,0,0,"",21,7.5
2002,3,reg,Minnesota Vikings,Carolina Panthers,MIN,14,21,7,6.5,35,44.5,FALSE,1,0,DOME,0.5,9.5
2002,3,reg,New England Patriots,Kansas City Chiefs,NE,41,38,3,8.5,79,43.5,FALSE,0,0,"",5.5,35.5
2002,3,reg,New York Giants,Seattle Seahawks,NYG,9,6,3,5.5,15,39,FALSE,0,0,"",2.5,24
2002,3,reg,Philadelphia Eagles,Dallas Cowboys,PHI,44,13,31,10,57,36.5,FALSE,0,0,"",21,20.5
2002,3,reg,San Francisco 49ers,Washington Redskins,SF,20,10,10,10,30,44,FALSE,0,0,"",0,14
2002,3,reg,Tennessee Titans,Cleveland Browns,TEN,28,31,3,4.5,59,40.5,FALSE,0,0,"",1.5,18.5
2002,3,reg,Tampa Bay Buccaneers,St. Louis Rams,LAR,26,14,12,1.5,40,44,FALSE,0,0,"",10.5,4
2002,4,reg,Arizona Cardinals,New York Giants,NYG,21,7,14,3,28,38.5,FALSE,0,0,"",11,10.5
2002,4,reg,Buffalo Bills,Chicago Bears,BUF,33,27,6,3,60,46.5,FALSE,0,0,"",3,13.5
2002,4,reg,Cincinnati Bengals,Tampa Bay Buccaneers,TB,7,35,28,6.5,42,33.5,FALSE,0,0,"",21.5,8.5
2002,4,reg,Detroit Lions,New Orleans Saints,NO,26,21,5,9,47,45,FALSE,1,0,DOME,4,2
2002,4,reg,Green Bay Packers,Carolina Panthers,GB,17,14,3,6.5,31,41.5,FALSE,0,0,"",3.5,10.5
2002,4,reg,Jacksonville Jaguars,New York Jets,JAX,28,3,25,3.5,31,41.5,FALSE,0,0,"",21.5,10.5
2002,4,reg,Kansas City Chiefs,Miami Dolphins,MIA,48,30,18,3,78,44.5,FALSE,0,0,"",15,33.5
2002,4,reg,Oakland Raiders,Tennessee Titans,OAK,52,25,27,6.5,77,45,FALSE,0,0,"",20.5,32
2002,4,reg,Philadelphia Eagles,Houston Texans,PHI,35,17,18,19,52,36,FALSE,0,0,"",1,16
2002,4,reg,Pittsburgh Steelers,Cleveland Browns,PIT,16,13,3,6,29,44,FALSE,0,0,"",3,15
2002,4,reg,San Diego Chargers,New England Patriots,NE,21,14,7,3,35,40.5,FALSE,0,0,"",4,5.5
2002,4,reg,Seattle Seahawks,Minnesota Vikings,SEA,48,23,25,3,71,44,FALSE,0,0,"",22,27
2002,4,reg,St. Louis Rams,Dallas Cowboys,LAR,10,13,3,12,23,44,FALSE,1,0,DOME,9,21
2002,4,reg,Baltimore Ravens,Denver Broncos,DEN,34,23,11,9,57,35,FALSE,0,0,"",2,22
2002,5,reg,Atlanta Falcons,Tampa Bay Buccaneers,ATL,6,20,14,2.5,26,38.5,FALSE,1,0,DOME,11.5,12.5
2002,5,reg,Buffalo Bills,Oakland Raiders,OAK,31,49,18,3,80,53.5,FALSE,0,0,"",15,26.5
2002,5,reg,Carolina Panthers,Arizona Cardinals,CAR,13,16,3,5,29,35,FALSE,0,0,"",2,6
2002,5,reg,Cleveland Browns,Baltimore Ravens,CLE,21,26,5,6,47,36.5,FALSE,0,0,"",1,10.5
2002,5,reg,Dallas Cowboys,New York Giants,NYG,17,21,4,1.5,38,34.5,FALSE,0,0,"",2.5,3.5
2002,5,reg,Denver Broncos,San Diego Chargers,DEN,26,9,17,6.5,35,39.5,FALSE,0,0,"",10.5,4.5
2002,5,reg,Indianapolis Colts,Cincinnati Bengals,IND,28,21,7,13.5,49,43,FALSE,1,0,DOME,6.5,6
2002,5,reg,Jacksonville Jaguars,Philadelphia Eagles,PHI,28,25,3,3,53,42.5,FALSE,0,0,"",0,10.5
2002,5,reg,Miami Dolphins,New England Patriots,MIA,26,13,13,3,39,43.5,FALSE,0,0,"",10,4.5
2002,5,reg,New Orleans Saints,Pittsburgh Steelers,NO,32,29,3,3,61,43.5,FALSE,1,0,DOME,0,17.5
2002,5,reg,New York Jets,Kansas City Chiefs,KC,25,29,4,3,54,46.5,FALSE,0,0,"",1,7.5
2002,5,reg,San Francisco 49ers,St. Louis Rams,SF,37,13,24,6,50,41.5,FALSE,0,0,"",18,8.5
2002,5,reg,Tennessee Titans,Washington Redskins,TEN,14,31,17,3.5,45,43.5,FALSE,0,0,"",13.5,1.5
2002,5,reg,Chicago Bears,Green Bay Packers,CHI,21,34,13,1,55,44,FALSE,0,0,"",12,11
2002,6,reg,Cincinnati Bengals,Pittsburgh Steelers,PIT,7,34,27,6.5,41,40.5,FALSE,0,0,"",20.5,0.5
2002,6,reg,Dallas Cowboys,Carolina Panthers,DAL,14,13,1,2,27,35,FALSE,0,0,"",1,8
2002,6,reg,Denver Broncos,Miami Dolphins,DEN,22,24,2,3.5,46,41,FALSE,0,0,"",1.5,5
2002,6,reg,Houston Texans,Buffalo Bills,BUF,24,31,7,7,55,44,FALSE,1,0,DOME,0,11
2002,6,reg,Indianapolis Colts,Baltimore Ravens,IND,22,20,2,6.5,42,42,FALSE,1,0,DOME,4.5,0
2002,6,reg,Minnesota Vikings,Detroit Lions,MIN,31,24,7,4.5,55,49,FALSE,1,0,DOME,2.5,6
2002,6,reg,New England Patriots,Green Bay Packers,NE,10,28,18,4.5,38,47,FALSE,0,0,"",13.5,9
2002,6,reg,New York Giants,Atlanta Falcons,NYG,10,17,7,6,27,35.5,FALSE,0,0,"",1,8.5
2002,6,reg,San Diego Chargers,Kansas City Chiefs,LAC,35,34,1,3,69,46.5,FALSE,0,0,"",2,22.5
2002,6,reg,St. Louis Rams,Oakland Raiders,OAK,28,13,15,7,41,49,FALSE,1,0,DOME,8,8
2002,6,reg,Tampa Bay Buccaneers,Cleveland Browns,TB,17,3,14,7.5,20,36.5,FALSE,0,0,"",6.5,16.5
2002,6,reg,Tennessee Titans,Jacksonville Jaguars,JAX,23,14,9,1.5,37,44,FALSE,0,0,"",7.5,7
2002,6,reg,Washington Redskins,New Orleans Saints,NO,27,43,16,1.5,70,45.5,FALSE,0,0,"",14.5,24.5
2002,6,reg,Seattle Seahawks,San Francisco 49ers,SF,21,28,7,3,49,43.5,FALSE,0,0,"",4,5.5
2002,7,reg,Arizona Cardinals,Dallas Cowboys,ARI,9,6,3,3.5,15,36.5,FALSE,0,0,"",0.5,21.5
2002,7,reg,Atlanta Falcons,Carolina Panthers,ATL,30,0,30,4,30,35.5,FALSE,1,0,DOME,26,5.5
2002,7,reg,Baltimore Ravens,Jacksonville Jaguars,JAX,17,10,7,1.5,27,38,FALSE,0,0,"",5.5,11
2002,7,reg,Cleveland Browns,Houston Texans,CLE,34,17,17,8.5,51,36.5,FALSE,0,0,"",8.5,14.5
2002,7,reg,Detroit Lions,Chicago Bears,CHI,23,20,3,3,43,44.5,FALSE,1,0,DOME,0,1.5
2002,7,reg,Green Bay Packers,Washington Redskins,GB,30,9,21,7,39,48,FALSE,0,0,"",14,9
2002,7,reg,Kansas City Chiefs,Denver Broncos,DEN,34,37,3,3,71,50.5,FALSE,0,0,"",0,20.5
2002,7,reg,Miami Dolphins,Buffalo Bills,MIA,10,23,13,6,33,45.5,FALSE,0,0,"",7,12.5
2002,7,reg,New Orleans Saints,San Francisco 49ers,NO,35,27,8,1.5,62,48.5,FALSE,1,0,DOME,6.5,13.5
2002,7,reg,New York Jets,Minnesota Vikings,NYJ,20,7,13,3,27,49,FALSE,0,0,"",10,22
2002,7,reg,Oakland Raiders,San Diego Chargers,OAK,21,27,6,7,48,47,FALSE,0,0,"",1,1
2002,7,reg,Philadelphia Eagles,Tampa Bay Buccaneers,PHI,20,10,10,3,30,37,FALSE,0,0,"",7,7
2002,7,reg,St. Louis Rams,Seattle Seahawks,LAR,37,20,17,6.5,57,44.5,FALSE,1,0,DOME,10.5,12.5
2002,7,reg,Pittsburgh Steelers,Indianapolis Colts,PIT,28,10,18,4.5,38,46,FALSE,0,0,"",13.5,8
2002,8,reg,Baltimore Ravens,Pittsburgh Steelers,PIT,18,31,13,3,49,37.5,FALSE,0,0,"",10,11.5
2002,8,reg,Buffalo Bills,Detroit Lions,BUF,24,17,7,7.5,41,50,FALSE,0,0,"",0.5,9
2002,8,reg,Carolina Panthers,Tampa Bay Buccaneers,TB,9,12,3,8,21,31.5,FALSE,0,0,"",5,10.5
2002,8,reg,Cincinnati Bengals,Tennessee Titans,TEN,24,30,6,4.5,54,42,FALSE,0,0,"",1.5,12
2002,8,reg,Dallas Cowboys,Seattle Seahawks,DAL,14,17,3,2,31,37,FALSE,0,0,"",1,6
2002,8,reg,Jacksonville Jaguars,Houston Texans,JAX,19,21,2,11,40,38,FALSE,0,0,"",9,2
2002,8,reg,Kansas City Chiefs,Oakland Raiders,OAK,20,10,10,2.5,30,55.5,FALSE,0,0,"",7.5,25.5
2002,8,reg,Minnesota Vikings,Chicago Bears,MIN,25,7,18,2,32,46,FALSE,1,0,DOME,16,14
2002,8,reg,New England Patriots,Denver Broncos,NE,16,24,8,3,40,46,FALSE,0,0,"",5,6
2002,8,reg,New Orleans Saints,Atlanta Falcons,NO,35,37,2,3.5,72,47,FALSE,1,0,DOME,1.5,25
2002,8,reg,New York Jets,Cleveland Browns,NYJ,21,24,3,3,45,44,FALSE,0,0,"",0,1
2002,8,reg,San Francisco 49ers,Arizona Cardinals,SF,38,28,10,8.5,66,40.5,FALSE,0,0,"",1.5,25.5
2002,8,reg,Washington Redskins,Indianapolis Colts,WAS,26,21,5,1,47,46,FALSE,0,0,"",4,1
2002,8,reg,Philadelphia Eagles,New York Giants,PHI,17,3,14,7,20,38.5,FALSE,0,0,"",7,18.5
2002,9,reg,Arizona Cardinals,St. Louis Rams,LAR,14,27,13,5,41,43.5,FALSE,0,0,"",8,2.5
2002,9,reg,Atlanta Falcons,Baltimore Ravens,ATL,20,17,3,7,37,40.5,FALSE,1,0,DOME,4,3.5
2002,9,reg,Buffalo Bills,New England Patriots,BUF,7,38,31,3,45,47.5,FALSE,0,0,"",28,2.5
2002,9,reg,Chicago Bears,Philadelphia Eagles,PHI,13,19,6,7,32,37.5,FALSE,0,0,"",1,5.5
2002,9,reg,Cleveland Browns,Pittsburgh Steelers,PIT,20,23,3,3.5,43,44,FALSE,0,0,"",0.5,1
2002,9,reg,Detroit Lions,Dallas Cowboys,DET,9,7,2,3,16,37,FALSE,1,0,DOME,1,21
2002,9,reg,Houston Texans,Cincinnati Bengals,HOU,3,38,35,2.5,41,36.5,FALSE,1,0,DOME,32.5,4.5
2002,9,reg,Indianapolis Colts,Tennessee Titans,IND,15,23,8,3,38,47,FALSE,1,0,DOME,5,9
2002,9,reg,New York Giants,Jacksonville Jaguars,NYG,24,17,7,3,41,35.5,FALSE,0,0,"",4,5.5
2002,9,reg,Oakland Raiders,San Francisco 49ers,OAK,20,23,3,3,43,49.5,FALSE,0,0,"",0,6.5
2002,9,reg,San Diego Chargers,New York Jets,LAC,13,44,31,8.5,57,41,FALSE,0,0,"",22.5,16
2002,9,reg,Seattle Seahawks,Washington Redskins,SEA,3,14,11,2,17,41.5,FALSE,0,0,"",9,24.5
2002,9,reg,Tampa Bay Buccaneers,Minnesota Vikings,TB,38,24,14,7.5,62,37,FALSE,0,0,"",6.5,25
2002,9,reg,Green Bay Packers,Miami Dolphins,GB,24,10,14,4.5,34,41.5,FALSE,0,0,"",9.5,7.5
2002,10,reg,Arizona Cardinals,Seattle Seahawks,ARI,6,27,21,3,33,37,FALSE,0,0,"",18,4
2002,10,reg,Baltimore Ravens,Cincinnati Bengals,BAL,38,27,11,4,65,37,FALSE,0,0,"",7,28
2002,10,reg,Carolina Panthers,New Orleans Saints,NO,24,34,10,4,58,39.5,FALSE,0,0,"",6,18.5
2002,10,reg,Chicago Bears,New England Patriots,NE,30,33,3,5,63,39,FALSE,0,0,"",2,24
2002,10,reg,Green Bay Packers,Detroit Lions,GB,40,14,26,10.5,54,42,FALSE,0,0,"",15.5,12
2002,10,reg,Jacksonville Jaguars,Washington Redskins,JAX,26,7,19,1.5,33,39.5,FALSE,0,0,"",17.5,6.5
2002,10,reg,Minnesota Vikings,New York Giants,NYG,20,27,7,1.5,47,45,FALSE,1,0,DOME,5.5,2
2002,10,reg,New York Jets,Miami Dolphins,NYJ,13,10,3,2.5,23,39.5,FALSE,0,0,"",0.5,16.5
2002,10,reg,Philadelphia Eagles,Indianapolis Colts,PHI,13,35,22,9.5,48,41.5,FALSE,0,0,"",12.5,6.5
2002,10,reg,Pittsburgh Steelers,Atlanta Falcons,PIT,34,34,0,5.5,68,42.5,FALSE,0,0,"",5.5,25.5
2002,10,reg,San Francisco 49ers,Kansas City Chiefs,SF,17,13,4,5,30,49,FALSE,0,0,"",1,19
2002,10,reg,St. Louis Rams,San Diego Chargers,LAR,28,24,4,6,52,44,FALSE,1,0,DOME,2,8
2002,10,reg,Tennessee Titans,Houston Texans,TEN,17,10,7,9,27,39.5,FALSE,0,0,"",2,12.5
2002,10,reg,Denver Broncos,Oakland Raiders,DEN,10,34,24,6,44,45.5,FALSE,0,0,"",18,1.5
2002,11,reg,Atlanta Falcons,New Orleans Saints,ATL,24,17,7,1.5,41,51,FALSE,1,0,DOME,5.5,10
2002,11,reg,Cincinnati Bengals,Cleveland Browns,CLE,20,27,7,3,47,41.5,FALSE,0,0,"",4,5.5
2002,11,reg,Detroit Lions,New York Jets,NYJ,14,31,17,3,45,43,FALSE,1,0,DOME,14,2
2002,11,reg,Houston Texans,Jacksonville Jaguars,JAX,21,24,3,6.5,45,36.5,FALSE,1,0,DOME,3.5,8.5
2002,11,reg,Indianapolis Colts,Dallas Cowboys,IND,20,3,17,6.5,23,39.5,FALSE,1,0,DOME,10.5,16.5
2002,11,reg,Kansas City Chiefs,Buffalo Bills,KC,17,16,1,3.5,33,52.5,FALSE,0,0,"",2.5,19.5
2002,11,reg,Miami Dolphins,Baltimore Ravens,MIA,26,7,19,5,33,34.5,FALSE,0,0,"",14,1.5
2002,11,reg,Minnesota Vikings,Green Bay Packers,GB,31,21,10,6.5,52,50.5,FALSE,1,0,DOME,3.5,1.5
2002,11,reg,New York Giants,Washington Redskins,NYG,19,17,2,3.5,36,34.5,FALSE,0,0,"",1.5,1.5
2002,11,reg,Oakland Raiders,New England Patriots,OAK,27,20,7,4.5,47,48,FALSE,0,0,"",2.5,1
2002,11,reg,Philadelphia Eagles,Arizona Cardinals,PHI,38,14,24,12,52,37.5,FALSE,0,0,"",12,14.5
2002,11,reg,San Diego Chargers,San Francisco 49ers,SF,20,17,3,2.5,37,43,FALSE,0,0,"",0.5,6
2002,11,reg,Seattle Seahawks,Denver Broncos,DEN,9,31,22,5.5,40,42.5,FALSE,0,0,"",16.5,2.5
2002,11,reg,Tampa Bay Buccaneers,Carolina Panthers,TB,23,10,13,8,33,34.5,FALSE,0,0,"",5,1.5
2002,11,reg,Tennessee Titans,Pittsburgh Steelers,PIT,31,23,8,3,54,44,FALSE,0,0,"",5,10
2002,11,reg,St. Louis Rams,Chicago Bears,LAR,21,16,5,10.5,37,43.5,FALSE,1,0,DOME,5.5,6.5
2002,12,reg,Arizona Cardinals,Oakland Raiders,OAK,20,41,21,9.5,61,44,FALSE,0,0,"",11.5,17
2002,12,reg,Baltimore Ravens,Tennessee Titans,TEN,13,12,1,2.5,25,38.5,FALSE,0,0,"",1.5,13.5
2002,12,reg,Carolina Panthers,Atlanta Falcons,ATL,0,41,41,3.5,41,37,FALSE,0,0,"",37.5,4
2002,12,reg,Chicago Bears,Detroit Lions,CHI,20,17,3,5,37,37.5,FALSE,0,0,"",2,0.5
2002,12,reg,Dallas Cowboys,Jacksonville Jaguars,JAX,21,19,2,2.5,40,34,FALSE,0,0,"",0.5,6
2002,12,reg,Denver Broncos,Indianapolis Colts,DEN,20,23,3,6,43,43,FALSE,0,0,"",3,0
2002,12,reg,Houston Texans,New York Giants,NYG,16,14,2,5.5,30,34,FALSE,1,0,DOME,3.5,4
2002,12,reg,Miami Dolphins,San Diego Chargers,MIA,30,3,27,4,33,36.5,FALSE,0,0,"",23,3.5
2002,12,reg,New England Patriots,Minnesota Vikings,NE,24,17,7,8,41,47,FALSE,0,0,"",1,6
2002,12,reg,New Orleans Saints,Cleveland Browns,NO,15,24,9,5.5,39,48.5,FALSE,1,0,DOME,3.5,9.5
2002,12,reg,New York Jets,Buffalo Bills,NYJ,31,13,18,3,44,45.5,FALSE,0,0,"",15,1.5
2002,12,reg,Pittsburgh Steelers,Cincinnati Bengals,PIT,29,21,8,10.5,50,44,FALSE,0,0,"",2.5,6
2002,12,reg,Seattle Seahawks,Kansas City Chiefs,KC,39,32,7,3.5,71,44,FALSE,0,0,"",3.5,27
2002,12,reg,Tampa Bay Buccaneers,Green Bay Packers,TB,21,7,14,3,28,38.5,FALSE,0,0,"",11,10.5
2002,12,reg,Washington Redskins,St. Louis Rams,LAR,20,17,3,3.5,37,41,FALSE,0,0,"",0.5,4
2002,12,reg,San Francisco 49ers,Philadelphia Eagles,SF,17,38,21,7,55,37.5,FALSE,0,0,"",14,17.5
2002,13,reg,Dallas Cowboys,Washington Redskins,WAS,27,20,7,1,47,36.5,FALSE,0,0,"",6,10.5
2002,13,reg,Detroit Lions,New England Patriots,NE,12,20,8,6,32,46,FALSE,1,0,DOME,2,14
2002,13,reg,Buffalo Bills,Miami Dolphins,MIA,38,21,17,2,59,37,FALSE,0,0,"",15,22
2002,13,reg,Cincinnati Bengals,Baltimore Ravens,BAL,23,27,4,2.5,50,37.5,FALSE,0,0,"",1.5,12.5
2002,13,reg,Cleveland Browns,Carolina Panthers,CLE,6,13,7,7.5,19,34.5,FALSE,0,0,"",0.5,15.5
2002,13,reg,Green Bay Packers,Chicago Bears,GB,30,20,10,9.5,50,37.5,FALSE,0,0,"",0.5,12.5
2002,13,reg,Indianapolis Colts,Houston Texans,IND,19,3,16,11.5,22,39.5,FALSE,1,0,DOME,4.5,17.5
2002,13,reg,Jacksonville Jaguars,Pittsburgh Steelers,PIT,23,25,2,3,48,44,FALSE,0,0,"",1,4
2002,13,reg,Kansas City Chiefs,Arizona Cardinals,KC,49,0,49,9,49,47,FALSE,0,0,"",40,2
2002,13,reg,Minnesota Vikings,Atlanta Falcons,ATL,24,30,6,3.5,54,47.5,FALSE,1,0,DOME,2.5,6.5
2002,13,reg,New Orleans Saints,Tampa Bay Buccaneers,TB,23,20,3,1.5,43,40,FALSE,1,0,DOME,1.5,3
2002,13,reg,New York Giants,Tennessee Titans,NYG,29,32,3,3,61,34,FALSE,0,0,"",0,27
2002,13,reg,Philadelphia Eagles,St. Louis Rams,LAR,10,3,7,2,13,38,FALSE,0,0,"",5,25
2002,13,reg,San Diego Chargers,Denver Broncos,DEN,30,27,3,3,57,40,FALSE,0,0,"",0,17
2002,13,reg,San Francisco 49ers,Seattle Seahawks,SF,31,24,7,8.5,55,43.5,FALSE,0,0,"",1.5,11.5
2002,13,reg,Oakland Raiders,New York Jets,OAK,26,20,6,6,46,47.5,FALSE,0,0,"",0,1.5
2002,14,reg,Arizona Cardinals,Detroit Lions,DET,23,20,3,1,43,39.5,FALSE,0,0,"",2,3.5
2002,14,reg,Baltimore Ravens,New Orleans Saints,NO,25,37,12,2,62,42.5,FALSE,0,0,"",10,19.5
2002,14,reg,Carolina Panthers,Cincinnati Bengals,CAR,52,31,21,3,83,37.5,FALSE,0,0,"",18,45.5
2002,14,reg,Dallas Cowboys,San Francisco 49ers,SF,27,31,4,4.5,58,40,FALSE,0,0,"",0.5,18
2002,14,reg,Green Bay Packers,Minnesota Vikings,GB,26,22,4,9.5,48,43.5,FALSE,0,0,"",5.5,4.5
2002,14,reg,Jacksonville Jaguars,Cleveland Browns,JAX,20,21,1,2.5,41,41.5,FALSE,0,0,"",1.5,0.5
2002,14,reg,Kansas City Chiefs,St. Louis Rams,KC,49,10,39,4.5,59,45.5,FALSE,0,0,"",34.5,13.5
2002,14,reg,New England Patriots,Buffalo Bills,NE,27,17,10,3.5,44,45,FALSE,0,0,"",6.5,1
2002,14,reg,New York Jets,Denver Broncos,DEN,19,13,6,1.5,32,43,FALSE,0,0,"",4.5,11
2002,14,reg,Pittsburgh Steelers,Houston Texans,PIT,6,24,18,14,30,37.5,FALSE,0,0,"",4,7.5
2002,14,reg,San Diego Chargers,Oakland Raiders,OAK,7,27,20,3.5,34,45.5,FALSE,0,0,"",16.5,11.5
2002,14,reg,Seattle Seahawks,Philadelphia Eagles,PHI,20,27,7,3,47,37.5,FALSE,0,0,"",4,9.5
2002,14,reg,Tampa Bay Buccaneers,Atlanta Falcons,TB,34,10,24,3.5,44,37,FALSE,0,0,"",20.5,7
2002,14,reg,Tennessee Titans,Indianapolis Colts,IND,27,17,10,1,44,43,FALSE,0,0,"",9,1
2002,14,reg,Washington Redskins,New York Giants,WAS,21,27,6,3,48,37.5,FALSE,0,0,"",3,10.5
2002,14,reg,Miami Dolphins,Chicago Bears,MIA,27,9,18,10.5,36,37,FALSE,0,0,"",7.5,1
2002,15,reg,Atlanta Falcons,Seattle Seahawks,ATL,24,30,6,9.5,54,46,FALSE,1,0,DOME,3.5,8
2002,15,reg,Buffalo Bills,San Diego Chargers,BUF,20,13,7,3,33,42.5,FALSE,0,0,"",4,9.5
2002,15,reg,Chicago Bears,New York Jets,NYJ,20,13,7,6.5,33,38,FALSE,0,0,"",0.5,5
2002,15,reg,Cincinnati Bengals,Jacksonville Jaguars,JAX,15,29,14,3,44,45,FALSE,0,0,"",11,1
2002,15,reg,Cleveland Browns,Indianapolis Colts,IND,23,28,5,2,51,41.5,FALSE,0,0,"",3,9.5
2002,15,reg,Denver Broncos,Kansas City Chiefs,DEN,31,24,7,3.5,55,47.5,FALSE,0,0,"",3.5,7.5
2002,15,reg,Detroit Lions,Tampa Bay Buccaneers,TB,20,23,3,9.5,43,37,FALSE,1,0,DOME,6.5,6
2002,15,reg,Houston Texans,Baltimore Ravens,BAL,19,23,4,3,42,35,FALSE,1,0,DOME,1,7
2002,15,reg,Miami Dolphins,Oakland Raiders,MIA,23,17,6,1.5,40,43.5,FALSE,0,0,"",4.5,3.5
2002,15,reg,New Orleans Saints,Minnesota Vikings,NO,31,32,1,7,63,51,FALSE,1,0,DOME,6,12
2002,15,reg,New York Giants,Dallas Cowboys,NYG,37,7,30,5,44,35,FALSE,0,0,"",25,9
2002,15,reg,Philadelphia Eagles,Washington Redskins,PHI,34,21,13,7.5,55,38,FALSE,0,0,"",5.5,17
2002,15,reg,Pittsburgh Steelers,Carolina Panthers,PIT,30,14,16,9,44,39,FALSE,0,0,"",7,5
2002,15,reg,San Francisco 49ers,Green Bay Packers,SF,14,20,6,3,34,42.5,FALSE,0,0,"",3,8.5
2002,15,reg,St. Louis Rams,Arizona Cardinals,LAR,30,28,2,11,58,43,FALSE,1,0,DOME,9,15
2002,15,reg,Tennessee Titans,New England Patriots,TEN,24,7,17,2.5,31,43.5,FALSE,0,0,"",14.5,12.5
2002,16,reg,Arizona Cardinals,San Francisco 49ers,SF,14,17,3,3.5,31,41,FALSE,0,0,"",0.5,10
2002,16,reg,Dallas Cowboys,Philadelphia Eagles,PHI,3,27,24,7,30,36.5,FALSE,0,0,"",17,6.5
2002,16,reg,Minnesota Vikings,Miami Dolphins,MIA,20,17,3,3,37,45,FALSE,1,0,DOME,0,8
2002,16,reg,Atlanta Falcons,Detroit Lions,ATL,36,15,21,10.5,51,44,FALSE,1,0,DOME,10.5,7
2002,16,reg,Baltimore Ravens,Cleveland Browns,BAL,13,14,1,2.5,27,39.5,FALSE,0,0,"",1.5,12.5
2002,16,reg,Carolina Panthers,Chicago Bears,CAR,24,14,10,4,38,36.5,FALSE,0,0,"",6,1.5
2002,16,reg,Cincinnati Bengals,New Orleans Saints,NO,20,13,7,7,33,49,FALSE,0,0,"",0,16
2002,16,reg,Green Bay Packers,Buffalo Bills,GB,10,0,10,6.5,10,43.5,FALSE,0,0,"",3.5,33.5
2002,16,reg,Indianapolis Colts,New York Giants,IND,27,44,17,4.5,71,41,FALSE,1,0,DOME,12.5,30
2002,16,reg,Jacksonville Jaguars,Tennessee Titans,TEN,10,28,18,3,38,41.5,FALSE,0,0,"",15,3.5
2002,16,reg,Kansas City Chiefs,San Diego Chargers,KC,24,22,2,1.5,46,44,FALSE,0,0,"",0.5,2
2002,16,reg,New England Patriots,New York Jets,NE,17,30,13,3.5,47,41,FALSE,0,0,"",9.5,6
2002,16,reg,Oakland Raiders,Denver Broncos,OAK,28,16,12,3.5,44,46.5,FALSE,0,0,"",8.5,2.5
2002,16,reg,Seattle Seahawks,St. Louis Rams,SEA,30,10,20,2.5,40,48,FALSE,0,0,"",17.5,8
2002,16,reg,Washington Redskins,Houston Texans,WAS,26,10,16,6.5,36,36.5,FALSE,0,0,"",9.5,0.5
2002,16,reg,Tampa Bay Buccaneers,Pittsburgh Steelers,TB,7,17,10,4.5,24,38,FALSE,0,0,"",5.5,14
2002,17,reg,New York Giants,Philadelphia Eagles,NYG,10,7,3,1,17,37.5,FALSE,0,0,"",2,20.5
2002,17,reg,Oakland Raiders,Kansas City Chiefs,OAK,24,0,24,8.5,24,44.5,FALSE,0,0,"",15.5,20.5
2002,17,reg,Buffalo Bills,Cincinnati Bengals,BUF,27,9,18,7.5,36,45,FALSE,0,0,"",10.5,9
2002,17,reg,Chicago Bears,Tampa Bay Buccaneers,TB,0,15,15,7,15,32,FALSE,0,0,"",8,17
2002,17,reg,Cleveland Browns,Atlanta Falcons,ATL,24,16,8,2.5,40,41,FALSE,0,0,"",5.5,1
2002,17,reg,Denver Broncos,Arizona Cardinals,DEN,37,7,30,13.5,44,42,FALSE,0,0,"",16.5,2
2002,17,reg,Detroit Lions,Minnesota Vikings,MIN,36,38,2,3.5,74,47,FALSE,1,0,DOME,1.5,27
2002,17,reg,Houston Texans,Tennessee Titans,TEN,3,13,10,9.5,16,35.5,FALSE,1,0,DOME,0.5,19.5
2002,17,reg,Indianapolis Colts,Jacksonville Jaguars,IND,20,13,7,8.5,33,40.5,FALSE,1,0,DOME,1.5,7.5
2002,17,reg,New England Patriots,Miami Dolphins,MIA,27,24,3,2,51,38,FALSE,0,0,"",1,13
2002,17,reg,New Orleans Saints,Carolina Panthers,NO,6,10,4,6,16,43.5,FALSE,1,0,DOME,2,27.5
2002,17,reg,New York Jets,Green Bay Packers,GB,42,17,25,1.5,59,39.5,FALSE,0,0,"",23.5,19.5
2002,17,reg,Pittsburgh Steelers,Baltimore Ravens,PIT,34,31,3,8,65,39,FALSE,0,0,"",5,26
2002,17,reg,San Diego Chargers,Seattle Seahawks,LAC,28,31,3,3,59,42.5,FALSE,0,0,"",0,16.5
2002,17,reg,Washington Redskins,Dallas Cowboys,WAS,20,14,6,7.5,34,36.5,FALSE,0,0,"",1.5,2.5
2002,17,reg,St. Louis Rams,San Francisco 49ers,LAR,31,20,11,2,51,39.5,FALSE,1,0,DOME,9,11.5
2002,Wildcard,post,Green Bay Packers,Atlanta Falcons,GB,7,27,20,6.5,34,40.5,FALSE,0,0,"",13.5,6.5
2002,Wildcard,post,New York Jets,Indianapolis Colts,NYJ,41,0,41,6,41,42,FALSE,0,0,"",35,1
2002,Wildcard,post,Pittsburgh Steelers,Cleveland Browns,PIT,36,33,3,8,69,43,FALSE,0,0,"",5,26
2002,Wildcard,post,San Francisco 49ers,New York Giants,SF,39,38,1,3,77,41,FALSE,0,0,"",2,36
2002,Division,post,Philadelphia Eagles,Atlanta Falcons,PHI,20,6,14,7.5,26,38.5,FALSE,0,0,"",6.5,12.5
2002,Division,post,Tennessee Titans,Pittsburgh Steelers,TEN,34,31,3,4.5,65,44,FALSE,0,0,"",1.5,21
2002,Division,post,Oakland Raiders,New York Jets,OAK,30,10,20,5.5,40,47,FALSE,0,0,"",14.5,7
2002,Division,post,Tampa Bay Buccaneers,San Francisco 49ers,TB,31,6,25,6,37,39.5,FALSE,0,0,"",19,2.5
2002,Conference,post,Oakland Raiders,Tennessee Titans,OAK,41,24,17,9,65,46,FALSE,0,0,"",8,19
2002,Conference,post,Philadelphia Eagles,Tampa Bay Buccaneers,PHI,10,27,17,4,37,33.5,FALSE,0,0,"",13,3.5
2002,Superbowl,post,Oakland Raiders,Tampa Bay Buccaneers,OAK,21,48,27,4,69,44,TRUE,0,0,"",23,25
2003,1,reg,Washington Redskins,New York Jets,WAS,16,13,3,3,29,40,FALSE,0,0,"",0,11
2003,1,reg,Buffalo Bills,New England Patriots,BUF,31,0,31,1,31,44.5,FALSE,0,0,"",30,13.5
2003,1,reg,Carolina Panthers,Jacksonville Jaguars,CAR,24,23,1,4,47,34.5,FALSE,0,0,"",3,12.5
2003,1,reg,Cincinnati Bengals,Denver Broncos,DEN,10,30,20,6,40,43.5,FALSE,0,0,"",14,3.5
2003,1,reg,Cleveland Browns,Indianapolis Colts,IND,6,9,3,2,15,48,FALSE,0,0,"",1,33
2003,1,reg,Dallas Cowboys,Atlanta Falcons,DAL,13,27,14,2,40,36.5,FALSE,0,0,"",12,3.5
2003,1,reg,Detroit Lions,Arizona Cardinals,DET,42,24,18,3.5,66,39,FALSE,1,0,DOME,14.5,27
2003,1,reg,Green Bay Packers,Minnesota Vikings,GB,25,30,5,4,55,47,FALSE,0,0,"",1,8
2003,1,reg,Kansas City Chiefs,San Diego Chargers,KC,27,14,13,4.5,41,47,FALSE,0,0,"",8.5,6
2003,1,reg,Miami Dolphins,Houston Texans,MIA,20,21,1,14,41,34.5,FALSE,0,0,"",13,6.5
2003,1,reg,New York Giants,St. Louis Rams,LAR,23,13,10,1,36,46.5,FALSE,0,0,"",9,10.5
2003,1,reg,Pittsburgh Steelers,Baltimore Ravens,PIT,34,15,19,4,49,38.5,FALSE,0,0,"",15,10.5
2003,1,reg,San Francisco 49ers,Chicago Bears,SF,49,7,42,6.5,56,40.5,FALSE,0,0,"",35.5,15.5
2003,1,reg,Seattle Seahawks,New Orleans Saints,SEA,27,10,17,3,37,48.5,FALSE,0,0,"",14,11.5
2003,1,reg,Tennessee Titans,Oakland Raiders,TEN,25,20,5,3.5,45,46,FALSE,0,0,"",1.5,1
2003,1,reg,Philadelphia Eagles,Tampa Bay Buccaneers,PHI,0,17,17,3,17,36,FALSE,0,0,"",14,19
2003,2,reg,Arizona Cardinals,Seattle Seahawks,SEA,0,38,38,5,38,44.5,FALSE,0,0,"",33,6.5
2003,2,reg,Atlanta Falcons,Washington Redskins,ATL,31,33,2,3,64,39.5,FALSE,1,0,DOME,1,24.5
2003,2,reg,Baltimore Ravens,Cleveland Browns,BAL,33,13,20,2.5,46,39,FALSE,0,0,"",17.5,7
2003,2,reg,Green Bay Packers,Detroit Lions,GB,31,6,25,7,37,45.5,FALSE,0,0,"",18,8.5
2003,2,reg,Indianapolis Colts,Tennessee Titans,IND,33,7,26,2.5,40,44,FALSE,1,0,DOME,23.5,4
2003,2,reg,Jacksonville Jaguars,Buffalo Bills,BUF,17,38,21,3,55,42,FALSE,0,0,"",18,13
2003,2,reg,Kansas City Chiefs,Pittsburgh Steelers,KC,41,20,21,3.5,61,48,FALSE,0,0,"",17.5,13
2003,2,reg,Minnesota Vikings,Chicago Bears,MIN,24,13,11,9,37,44.5,FALSE,1,0,DOME,2,7.5
2003,2,reg,New Orleans Saints,Houston Texans,NO,31,10,21,8,41,40.5,FALSE,1,0,DOME,13,0.5
2003,2,reg,New York Jets,Miami Dolphins,MIA,10,21,11,3,31,37,FALSE,0,0,"",8,6
2003,2,reg,Oakland Raiders,Cincinnati Bengals,OAK,23,20,3,12,43,45,FALSE,0,0,"",9,2
2003,2,reg,Philadelphia Eagles,New England Patriots,PHI,10,31,21,4,41,38,FALSE,0,0,"",17,3
2003,2,reg,San Diego Chargers,Denver Broncos,DEN,13,37,24,3,50,43,FALSE,0,0,"",21,7
2003,2,reg,St. Louis Rams,San Francisco 49ers,LAR,27,24,3,3,51,47.5,FALSE,1,0,DOME,0,3.5
2003,2,reg,Tampa Bay Buccaneers,Carolina Panthers,TB,9,12,3,9,21,34.5,FALSE,0,0,"",6,13.5
2003,2,reg,New York Giants,Dallas Cowboys,NYG,32,35,3,7.5,67,36.5,FALSE,0,0,"",4.5,30.5
2003,3,reg,Arizona Cardinals,Green Bay Packers,GB,20,13,7,7.5,33,42.5,FALSE,0,0,"",0.5,9.5
2003,3,reg,Atlanta Falcons,Tampa Bay Buccaneers,TB,10,31,21,6.5,41,35.5,FALSE,1,0,DOME,14.5,5.5
2003,3,reg,Cincinnati Bengals,Pittsburgh Steelers,PIT,10,17,7,4.5,27,44.5,FALSE,0,0,"",2.5,17.5
2003,3,reg,Detroit Lions,Minnesota Vikings,MIN,13,23,10,4,36,47.5,FALSE,1,0,DOME,6,11.5
2003,3,reg,Houston Texans,Kansas City Chiefs,KC,14,42,28,7.5,56,44,FALSE,1,0,DOME,20.5,12
2003,3,reg,Indianapolis Colts,Jacksonville Jaguars,IND,23,13,10,7.5,36,42,FALSE,1,0,DOME,2.5,6
2003,3,reg,Miami Dolphins,Buffalo Bills,MIA,17,7,10,3,24,40.5,FALSE,0,0,"",7,16.5
2003,3,reg,New England Patriots,New York Jets,NE,23,16,7,6,39,38,FALSE,0,0,"",1,1
2003,3,reg,San Diego Chargers,Baltimore Ravens,LAC,10,24,14,1.5,34,38.5,FALSE,0,0,"",12.5,4.5
2003,3,reg,San Francisco 49ers,Cleveland Browns,SF,12,13,1,7,25,44.5,FALSE,0,0,"",6,19.5
2003,3,reg,Seattle Seahawks,St. Louis Rams,SEA,24,23,1,3,47,47,FALSE,0,0,"",2,0
2003,3,reg,Tennessee Titans,New Orleans Saints,TEN,27,12,15,4.5,39,43.5,FALSE,0,0,"",10.5,4.5
2003,3,reg,Washington Redskins,New York Giants,WAS,21,24,3,1.5,45,43.5,FALSE,0,0,"",1.5,1.5
2003,3,reg,Denver Broncos,Oakland Raiders,DEN,31,10,21,5.5,41,45,FALSE,0,0,"",15.5,4
2003,4,reg,Baltimore Ravens,Kansas City Chiefs,KC,10,17,7,3,27,43.5,FALSE,0,0,"",4,16.5
2003,4,reg,Buffalo Bills,Philadelphia Eagles,BUF,13,23,10,3,36,39.5,FALSE,0,0,"",7,3.5
2003,4,reg,Carolina Panthers,Atlanta Falcons,CAR,23,3,20,6,26,35.5,FALSE,0,0,"",14,9.5
2003,4,reg,Cleveland Browns,Cincinnati Bengals,CLE,14,21,7,4.5,35,40,FALSE,0,0,"",2.5,5
2003,4,reg,Denver Broncos,Detroit Lions,DEN,20,16,4,12,36,44,FALSE,0,0,"",8,8
2003,4,reg,Houston Texans,Jacksonville Jaguars,JAX,24,20,4,2.5,44,37.5,FALSE,1,0,DOME,1.5,6.5
2003,4,reg,Minnesota Vikings,San Francisco 49ers,PICK,35,7,28,0,42,43,FALSE,1,0,DOME,28,1
2003,4,reg,New Orleans Saints,Indianapolis Colts,IND,21,55,34,1.5,76,42,FALSE,1,0,DOME,32.5,34
2003,4,reg,New York Jets,Dallas Cowboys,NYJ,6,17,11,3,23,37,FALSE,0,0,"",8,14
2003,4,reg,Oakland Raiders,San Diego Chargers,OAK,34,31,3,7,65,41.5,FALSE,0,0,"",4,23.5
2003,4,reg,Pittsburgh Steelers,Tennessee Titans,PIT,13,30,17,3.5,43,44,FALSE,0,0,"",13.5,1
2003,4,reg,St. Louis Rams,Arizona Cardinals,LAR,37,13,24,11.5,50,45.5,FALSE,1,0,DOME,12.5,4.5
2003,4,reg,Washington Redskins,New England Patriots,WAS,20,17,3,3.5,37,43,FALSE,0,0,"",0.5,6
2003,4,reg,Chicago Bears,Green Bay Packers,GB,23,38,15,4,61,41.5,FALSE,0,0,"",11,19.5
2003,5,reg,Atlanta Falcons,Minnesota Vikings,MIN,26,39,13,4.5,65,43.5,FALSE,1,0,DOME,8.5,21.5
2003,5,reg,Buffalo Bills,Cincinnati Bengals,BUF,22,16,6,7,38,40,FALSE,0,0,"",1,2
2003,5,reg,Carolina Panthers,New Orleans Saints,CAR,19,13,6,7,32,37.5,FALSE,0,0,"",1,5.5
2003,5,reg,Chicago Bears,Oakland Raiders,OAK,24,21,3,3.5,45,43.5,FALSE,0,0,"",0.5,1.5
2003,5,reg,Dallas Cowboys,Arizona Cardinals,DAL,24,7,17,7.5,31,39.5,FALSE,0,0,"",9.5,8.5
2003,5,reg,Green Bay Packers,Seattle Seahawks,GB,35,13,22,1,48,45,FALSE,0,0,"",21,3
2003,5,reg,Jacksonville Jaguars,San Diego Chargers,JAX,27,21,6,3,48,42.5,FALSE,0,0,"",3,5.5
2003,5,reg,Kansas City Chiefs,Denver Broncos,KC,24,23,1,3.5,47,46.5,FALSE,0,0,"",2.5,0.5
2003,5,reg,New England Patriots,Tennessee Titans,NE,38,30,8,1,68,40.5,FALSE,0,0,"",7,27.5
2003,5,reg,New York Giants,Miami Dolphins,NYG,10,23,13,1.5,33,38,FALSE,0,0,"",11.5,5
2003,5,reg,Philadelphia Eagles,Washington Redskins,PHI,27,25,2,4.5,52,40.5,FALSE,0,0,"",2.5,11.5
2003,5,reg,Pittsburgh Steelers,Cleveland Browns,PIT,13,33,20,7,46,42,FALSE,0,0,"",13,4
2003,5,reg,San Francisco 49ers,Detroit Lions,SF,24,17,7,7.5,41,42.5,FALSE,0,0,"",0.5,1.5
2003,5,reg,Tampa Bay Buccaneers,Indianapolis Colts,TB,35,38,3,4.5,73,37.5,FALSE,0,0,"",1.5,35.5
2003,6,reg,Arizona Cardinals,Baltimore Ravens,BAL,18,26,8,6.5,44,37,FALSE,0,0,"",1.5,7
2003,6,reg,Cleveland Browns,Oakland Raiders,CLE,13,7,6,3.5,20,43.5,FALSE,0,0,"",2.5,23.5
2003,6,reg,Dallas Cowboys,Philadelphia Eagles,DAL,23,21,2,1,44,37.5,FALSE,0,0,"",1,6.5
2003,6,reg,Denver Broncos,Pittsburgh Steelers,DEN,17,14,3,6.5,31,45,FALSE,0,0,"",3.5,14
2003,6,reg,Green Bay Packers,Kansas City Chiefs,GB,34,40,6,2.5,74,47.5,FALSE,0,0,"",3.5,26.5
2003,6,reg,Indianapolis Colts,Carolina Panthers,IND,20,23,3,4,43,37.5,FALSE,1,0,DOME,1,5.5
2003,6,reg,Jacksonville Jaguars,Miami Dolphins,MIA,10,24,14,3.5,34,38,FALSE,0,0,"",10.5,4
2003,6,reg,New England Patriots,New York Giants,NE,17,6,11,2.5,23,42.5,FALSE,0,0,"",8.5,19.5
2003,6,reg,New Orleans Saints,Chicago Bears,NO,20,13,7,6.5,33,43,FALSE,1,0,DOME,0.5,10
2003,6,reg,New York Jets,Buffalo Bills,BUF,30,3,27,1,33,36.5,FALSE,0,0,"",26,3.5
2003,6,reg,Seattle Seahawks,San Francisco 49ers,SEA,20,19,1,3.5,39,44.5,FALSE,0,0,"",2.5,5.5
2003,6,reg,Tennessee Titans,Houston Texans,TEN,38,17,21,8.5,55,39.5,FALSE,0,0,"",12.5,15.5
2003,6,reg,Washington Redskins,Tampa Bay Buccaneers,TB,13,35,22,3.5,48,37,FALSE,0,0,"",18.5,11
2003,6,reg,St. Louis Rams,Atlanta Falcons,LAR,36,0,36,10,36,46,FALSE,1,0,DOME,26,10
2003,7,reg,Atlanta Falcons,New Orleans Saints,NO,17,45,28,3,62,42,FALSE,1,0,DOME,25,20
2003,7,reg,Buffalo Bills,Washington Redskins,BUF,24,7,17,3,31,38,FALSE,0,0,"",14,7
2003,7,reg,Carolina Panthers,Tennessee Titans,PICK,17,37,20,0,54,37.5,FALSE,0,0,"",20,16.5
2003,7,reg,Cincinnati Bengals,Baltimore Ravens,BAL,34,26,8,1,60,36,FALSE,0,0,"",7,24
2003,7,reg,Cleveland Browns,San Diego Chargers,CLE,20,26,6,3.5,46,41,FALSE,0,0,"",2.5,5
2003,7,reg,Detroit Lions,Dallas Cowboys,DAL,7,38,31,3,45,39,FALSE,1,0,DOME,28,6
2003,7,reg,Houston Texans,New York Jets,NYJ,14,19,5,3.5,33,38,FALSE,1,0,DOME,1.5,5
2003,7,reg,Miami Dolphins,New England Patriots,MIA,13,19,6,6.5,32,37,FALSE,0,0,"",0.5,5
2003,7,reg,Minnesota Vikings,Denver Broncos,MIN,28,20,8,4,48,44,FALSE,1,0,DOME,4,4
2003,7,reg,New York Giants,Philadelphia Eagles,NYG,10,14,4,3,24,37,FALSE,0,0,"",1,13
2003,7,reg,San Francisco 49ers,Tampa Bay Buccaneers,TB,24,7,17,5,31,39,FALSE,0,0,"",12,8
2003,7,reg,Seattle Seahawks,Chicago Bears,SEA,24,17,7,11,41,41.5,FALSE,0,0,"",4,0.5
2003,7,reg,St. Louis Rams,Green Bay Packers,LAR,34,24,10,4,58,48.5,FALSE,1,0,DOME,6,9.5
2003,7,reg,Oakland Raiders,Kansas City Chiefs,KC,10,17,7,4.5,27,47.5,FALSE,0,0,"",2.5,20.5
2003,8,reg,Arizona Cardinals,San Francisco 49ers,SF,16,13,3,7,29,41,FALSE,0,0,"",4,12
2003,8,reg,Baltimore Ravens,Denver Broncos,BAL,26,6,20,2.5,32,36.5,FALSE,0,0,"",17.5,4.5
2003,8,reg,Chicago Bears,Detroit Lions,CHI,24,16,8,3,40,37.5,FALSE,0,0,"",5,2.5
2003,8,reg,Cincinnati Bengals,Seattle Seahawks,SEA,27,24,3,3,51,41.5,FALSE,0,0,"",0,9.5
2003,8,reg,Indianapolis Colts,Houston Texans,IND,30,21,9,13,51,44,FALSE,1,0,DOME,4,7
2003,8,reg,Jacksonville Jaguars,Tennessee Titans,TEN,17,30,13,4.5,47,43.5,FALSE,0,0,"",8.5,3.5
2003,8,reg,Kansas City Chiefs,Buffalo Bills,KC,38,5,33,5.5,43,43.5,FALSE,0,0,"",27.5,0.5
2003,8,reg,Minnesota Vikings,New York Giants,MIN,17,29,12,5.5,46,44.5,FALSE,1,0,DOME,6.5,1.5
2003,8,reg,New England Patriots,Cleveland Browns,NE,9,3,6,4.5,12,37.5,FALSE,0,0,"",1.5,25.5
2003,8,reg,New Orleans Saints,Carolina Panthers,NO,20,23,3,3,43,39.5,FALSE,1,0,DOME,0,3.5
2003,8,reg,Philadelphia Eagles,New York Jets,PHI,24,17,7,3,41,36,FALSE,0,0,"",4,5
2003,8,reg,Pittsburgh Steelers,St. Louis Rams,PIT,21,33,12,1,54,45.5,FALSE,0,0,"",11,8.5
2003,8,reg,Tampa Bay Buccaneers,Dallas Cowboys,TB,16,0,16,6,16,37,FALSE,0,0,"",10,21
2003,8,reg,San Diego Chargers,Miami Dolphins,MIA,10,26,16,6.5,36,38.5,TRUE,0,0,"",9.5,2.5
2003,9,reg,Arizona Cardinals,Cincinnati Bengals,CIN,17,14,3,3,31,39,FALSE,0,0,"",0,8
2003,9,reg,Atlanta Falcons,Philadelphia Eagles,PHI,16,23,7,6,39,39.5,FALSE,1,0,DOME,1,0.5
2003,9,reg,Baltimore Ravens,Jacksonville Jaguars,BAL,24,17,7,7,41,37.5,FALSE,0,0,"",0,3.5
2003,9,reg,Chicago Bears,San Diego Chargers,CHI,20,7,13,1,27,39,FALSE,0,0,"",12,12
2003,9,reg,Dallas Cowboys,Washington Redskins,DAL,21,14,7,6,35,38.5,FALSE,0,0,"",1,3.5
2003,9,reg,Detroit Lions,Oakland Raiders,OAK,23,13,10,3.5,36,39.5,FALSE,1,0,DOME,6.5,3.5
2003,9,reg,Houston Texans,Carolina Panthers,CAR,14,10,4,6,24,37,FALSE,1,0,DOME,2,13
2003,9,reg,Miami Dolphins,Indianapolis Colts,MIA,17,23,6,3,40,39.5,FALSE,0,0,"",3,0.5
2003,9,reg,Minnesota Vikings,Green Bay Packers,MIN,27,30,3,5.5,57,49,FALSE,1,0,DOME,2.5,8
2003,9,reg,New York Jets,New York Giants,NYG,28,31,3,3.5,59,40,FALSE,0,0,"",0.5,19
2003,9,reg,San Francisco 49ers,St. Louis Rams,LAR,30,10,20,5,40,44,FALSE,0,0,"",15,4
2003,9,reg,Seattle Seahawks,Pittsburgh Steelers,SEA,23,16,7,5,39,44,FALSE,0,0,"",2,5
2003,9,reg,Tampa Bay Buccaneers,New Orleans Saints,TB,14,17,3,8,31,39,FALSE,0,0,"",5,8
2003,9,reg,Denver Broncos,New England Patriots,DEN,26,30,4,2,56,36,FALSE,0,0,"",2,20
2003,10,reg,Carolina Panthers,Tampa Bay Buccaneers,TB,27,24,3,3.5,51,34.5,FALSE,0,0,"",0.5,16.5
2003,10,reg,Cincinnati Bengals,Houston Texans,CIN,34,27,7,4,61,40,FALSE,0,0,"",3,21
2003,10,reg,Dallas Cowboys,Buffalo Bills,DAL,10,6,4,4,16,37,FALSE,0,0,"",0,21
2003,10,reg,Detroit Lions,Chicago Bears,PICK,12,10,2,0,22,37.5,FALSE,1,0,DOME,2,15.5
2003,10,reg,Jacksonville Jaguars,Indianapolis Colts,IND,28,23,5,6,51,44,FALSE,0,0,"",1,7
2003,10,reg,Kansas City Chiefs,Cleveland Browns,KC,41,20,21,9,61,43.5,FALSE,0,0,"",12,17.5
2003,10,reg,New York Giants,Atlanta Falcons,NYG,7,27,20,11.5,34,41,FALSE,0,0,"",8.5,7
2003,10,reg,Oakland Raiders,New York Jets,NYJ,24,27,3,3,51,38,FALSE,0,0,"",0,13
2003,10,reg,Pittsburgh Steelers,Arizona Cardinals,PIT,28,15,13,7,43,40.5,FALSE,0,0,"",6,2.5
2003,10,reg,San Diego Chargers,Minnesota Vikings,MIN,42,28,14,5.5,70,45,FALSE,0,0,"",8.5,25
2003,10,reg,St. Louis Rams,Baltimore Ravens,LAR,33,22,11,6.5,55,43,FALSE,1,0,DOME,4.5,12
2003,10,reg,Tennessee Titans,Miami Dolphins,TEN,31,7,24,5.5,38,39.5,FALSE,0,0,"",18.5,1.5
2003,10,reg,Washington Redskins,Seattle Seahawks,SEA,27,20,7,3,47,41,FALSE,0,0,"",4,6
2003,10,reg,Green Bay Packers,Philadelphia Eagles,GB,14,17,3,4.5,31,43,FALSE,0,0,"",1.5,12
2003,11,reg,Buffalo Bills,Houston Texans,BUF,10,12,2,7,22,37.5,FALSE,0,0,"",5,15.5
2003,11,reg,Carolina Panthers,Washington Redskins,CAR,20,17,3,6,37,37,FALSE,0,0,"",3,0
2003,11,reg,Chicago Bears,St. Louis Rams,LAR,21,23,2,6,44,41,FALSE,0,0,"",4,3
2003,11,reg,Cincinnati Bengals,Kansas City Chiefs,KC,24,19,5,6,43,48,FALSE,0,0,"",1,5
2003,11,reg,Cleveland Browns,Arizona Cardinals,CLE,44,6,38,5,50,37.5,FALSE,0,0,"",33,12.5
2003,11,reg,Denver Broncos,San Diego Chargers,DEN,37,8,29,8.5,45,44,FALSE,0,0,"",20.5,1
2003,11,reg,Indianapolis Colts,New York Jets,IND,38,31,7,6,69,43.5,FALSE,1,0,DOME,1,25.5
2003,11,reg,Miami Dolphins,Baltimore Ravens,MIA,9,6,3,5,15,33,FALSE,0,0,"",2,18
2003,11,reg,New England Patriots,Dallas Cowboys,NE,12,0,12,4,12,35,FALSE,0,0,"",8,23
2003,11,reg,New Orleans Saints,Atlanta Falcons,NO,23,20,3,9,43,44,FALSE,1,0,DOME,6,1
2003,11,reg,Oakland Raiders,Minnesota Vikings,MIN,28,18,10,4.5,46,46,FALSE,0,0,"",5.5,0
2003,11,reg,Philadelphia Eagles,New York Giants,PHI,28,10,18,3,38,38,FALSE,0,0,"",15,0
2003,11,reg,Seattle Seahawks,Detroit Lions,SEA,35,14,21,11,49,39.5,FALSE,0,0,"",10,9.5
2003,11,reg,Tampa Bay Buccaneers,Green Bay Packers,TB,13,20,7,3.5,33,41,FALSE,0,0,"",3.5,8
2003,11,reg,Tennessee Titans,Jacksonville Jaguars,TEN,10,3,7,9,13,44.5,FALSE,0,0,"",2,31.5
2003,11,reg,San Francisco 49ers,Pittsburgh Steelers,SF,30,14,16,4,44,41.5,FALSE,0,0,"",12,2.5
2003,12,reg,Arizona Cardinals,St. Louis Rams,LAR,27,30,3,7,57,44,FALSE,0,0,"",4,13
2003,12,reg,Atlanta Falcons,Tennessee Titans,TEN,31,38,7,6.5,69,44,FALSE,1,0,DOME,0.5,25
2003,12,reg,Baltimore Ravens,Seattle Seahawks,BAL,44,41,3,3,85,36,FALSE,0,0,"",0,49
2003,12,reg,Buffalo Bills,Indianapolis Colts,IND,14,17,3,3,31,38.5,FALSE,0,0,"",0,7.5
2003,12,reg,Cleveland Browns,Pittsburgh Steelers,CLE,6,13,7,3,19,40.5,FALSE,0,0,"",4,21.5
2003,12,reg,Dallas Cowboys,Carolina Panthers,DAL,24,20,4,3,44,33,FALSE,0,0,"",1,11
2003,12,reg,Denver Broncos,Chicago Bears,DEN,10,19,9,10.5,29,38.5,FALSE,0,0,"",1.5,9.5
2003,12,reg,Green Bay Packers,San Francisco 49ers,GB,20,10,10,3.5,30,40,FALSE,0,0,"",6.5,10
2003,12,reg,Houston Texans,New England Patriots,NE,20,23,3,5,43,37,FALSE,1,0,DOME,2,6
2003,12,reg,Kansas City Chiefs,Oakland Raiders,KC,27,24,3,11,51,44.5,FALSE,0,0,"",8,6.5
2003,12,reg,Miami Dolphins,Washington Redskins,MIA,24,23,1,7,47,35,FALSE,0,0,"",6,12
2003,12,reg,Minnesota Vikings,Detroit Lions,MIN,24,14,10,10.5,38,47.5,FALSE,1,0,DOME,0.5,9.5
2003,12,reg,New York Jets,Jacksonville Jaguars,NYJ,13,10,3,4,23,43,FALSE,0,0,"",1,20
2003,12,reg,Philadelphia Eagles,New Orleans Saints,PHI,33,20,13,5.5,53,39.5,FALSE,0,0,"",7.5,13.5
2003,12,reg,San Diego Chargers,Cincinnati Bengals,CIN,27,34,7,3,61,43,FALSE,0,0,"",4,18
2003,12,reg,Tampa Bay Buccaneers,New York Giants,TB,19,13,6,6,32,38,FALSE,0,0,"",0,6
2003,13,reg,Dallas Cowboys,Miami Dolphins,DAL,21,40,19,3,61,34.5,FALSE,0,0,"",16,26.5
2003,13,reg,Detroit Lions,Green Bay Packers,GB,22,14,8,6.5,36,44,FALSE,1,0,DOME,1.5,8
2003,13,reg,Baltimore Ravens,San Francisco 49ers,BAL,44,6,38,3,50,37,FALSE,0,0,"",35,13
2003,13,reg,Carolina Panthers,Philadelphia Eagles,CAR,16,25,9,1.5,41,37,FALSE,0,0,"",7.5,4
2003,13,reg,Chicago Bears,Arizona Cardinals,CHI,28,3,25,4.5,31,36,FALSE,0,0,"",20.5,5
2003,13,reg,Houston Texans,Atlanta Falcons,HOU,17,13,4,3,30,42.5,FALSE,1,0,DOME,1,12.5
2003,13,reg,Indianapolis Colts,New England Patriots,IND,34,38,4,3.5,72,43.5,FALSE,1,0,DOME,0.5,28.5
2003,13,reg,Jacksonville Jaguars,Tampa Bay Buccaneers,TB,17,10,7,3,27,37,FALSE,0,0,"",4,10
2003,13,reg,New York Giants,Buffalo Bills,NYG,7,24,17,3,31,35.5,FALSE,0,0,"",14,4.5
2003,13,reg,Oakland Raiders,Denver Broncos,DEN,8,22,14,3,30,42,FALSE,0,0,"",11,12
2003,13,reg,Pittsburgh Steelers,Cincinnati Bengals,PIT,20,24,4,3,44,42,FALSE,0,0,"",1,2
2003,13,reg,San Diego Chargers,Kansas City Chiefs,KC,24,28,4,7.5,52,48.5,FALSE,0,0,"",3.5,3.5
2003,13,reg,Seattle Seahawks,Cleveland Browns,SEA,34,7,27,6.5,41,42,FALSE,0,0,"",20.5,1
2003,13,reg,St. Louis Rams,Minnesota Vikings,LAR,48,17,31,6,65,51,FALSE,1,0,DOME,25,14
2003,13,reg,Washington Redskins,New Orleans Saints,NO,20,24,4,1,44,42.5,FALSE,0,0,"",3,1.5
2003,13,reg,New York Jets,Tennessee Titans,TEN,24,17,7,3,41,42,FALSE,0,0,"",4,1
2003,14,reg,Atlanta Falcons,Carolina Panthers,CAR,20,14,6,1,34,41,FALSE,1,0,DOME,5,7
2003,14,reg,Baltimore Ravens,Cincinnati Bengals,BAL,31,13,18,5,44,38.5,FALSE,0,0,"",13,5.5
2003,14,reg,Buffalo Bills,New York Jets,BUF,17,6,11,3,23,37,FALSE,0,0,"",8,14
2003,14,reg,Denver Broncos,Kansas City Chiefs,DEN,45,27,18,3,72,46.5,FALSE,0,0,"",15,25.5
2003,14,reg,Detroit Lions,San Diego Chargers,DET,7,14,7,3,21,43.5,FALSE,1,0,DOME,4,22.5
2003,14,reg,Green Bay Packers,Chicago Bears,GB,34,21,13,7.5,55,39,FALSE,0,0,"",5.5,16
2003,14,reg,Jacksonville Jaguars,Houston Texans,JAX,27,0,27,9.5,27,37.5,FALSE,0,0,"",17.5,10.5
2003,14,reg,Minnesota Vikings,Seattle Seahawks,SEA,34,7,27,1,41,52.5,FALSE,1,0,DOME,26,11.5
2003,14,reg,New England Patriots,Miami Dolphins,NE,12,0,12,3,12,33.5,FALSE,0,0,"",9,21.5
2003,14,reg,New Orleans Saints,Tampa Bay Buccaneers,NO,7,14,7,3,21,40.5,FALSE,1,0,DOME,4,19.5
2003,14,reg,New York Giants,Washington Redskins,NYG,7,20,13,3,27,36,FALSE,0,0,"",10,9
2003,14,reg,Philadelphia Eagles,Dallas Cowboys,PHI,36,10,26,5.5,46,35.5,FALSE,0,0,"",20.5,10.5
2003,14,reg,Pittsburgh Steelers,Oakland Raiders,PIT,27,7,20,5.5,34,40.5,FALSE,0,0,"",14.5,6.5
2003,14,reg,San Francisco 49ers,Arizona Cardinals,SF,50,14,36,10.5,64,40.5,FALSE,0,0,"",25.5,23.5
2003,14,reg,Tennessee Titans,Indianapolis Colts,TEN,27,29,2,3.5,56,46.5,FALSE,0,0,"",1.5,9.5
2003,14,reg,Cleveland Browns,St. Louis Rams,LAR,20,26,6,5.5,46,43.5,FALSE,0,0,"",0.5,2.5
2003,15,reg,Arizona Cardinals,Carolina Panthers,CAR,17,20,3,7,37,38.5,FALSE,0,0,"",4,1.5
2003,15,reg,Chicago Bears,Minnesota Vikings,MIN,13,10,3,3,23,39.5,FALSE,0,0,"",0,16.5
2003,15,reg,Cincinnati Bengals,San Francisco 49ers,CIN,41,38,3,3,79,42,FALSE,0,0,"",0,37
2003,15,reg,Denver Broncos,Cleveland Browns,DEN,23,20,3,11.5,43,42,FALSE,0,0,"",8.5,1
2003,15,reg,Indianapolis Colts,Atlanta Falcons,IND,38,7,31,7.5,45,48,FALSE,1,0,DOME,23.5,3
2003,15,reg,Kansas City Chiefs,Detroit Lions,KC,45,17,28,14.5,62,45,FALSE,0,0,"",13.5,17
2003,15,reg,New England Patriots,Jacksonville Jaguars,NE,27,13,14,6,40,33,FALSE,0,0,"",8,7
2003,15,reg,New Orleans Saints,New York Giants,NO,45,7,38,7.5,52,40.5,FALSE,1,0,DOME,30.5,11.5
2003,15,reg,New York Jets,Pittsburgh Steelers,NYJ,6,0,6,3,6,36,FALSE,0,0,"",3,30
2003,15,reg,Oakland Raiders,Baltimore Ravens,BAL,20,12,8,7,32,38,FALSE,0,0,"",1,6
2003,15,reg,San Diego Chargers,Green Bay Packers,GB,21,38,17,5,59,45.5,FALSE,0,0,"",12,13.5
2003,15,reg,St. Louis Rams,Seattle Seahawks,LAR,27,22,5,7,49,52,FALSE,1,0,DOME,2,3
2003,15,reg,Tampa Bay Buccaneers,Houston Texans,TB,16,3,13,11.5,19,36,FALSE,0,0,"",1.5,17
2003,15,reg,Tennessee Titans,Buffalo Bills,TEN,28,26,2,5,54,37,FALSE,0,0,"",3,17
2003,15,reg,Washington Redskins,Dallas Cowboys,DAL,0,27,27,3,27,34,FALSE,0,0,"",24,7
2003,15,reg,Miami Dolphins,Philadelphia Eagles,MIA,27,34,7,3,61,37,FALSE,0,0,"",4,24
2003,16,reg,Minnesota Vikings,Kansas City Chiefs,KC,45,20,25,3,65,54,FALSE,1,0,DOME,22,11
2003,16,reg,New York Jets,New England Patriots,NE,16,21,5,3,37,35,FALSE,0,0,"",2,2
2003,16,reg,Tampa Bay Buccaneers,Atlanta Falcons,TB,28,30,2,6.5,58,38.5,FALSE,0,0,"",4.5,19.5
2003,16,reg,Buffalo Bills,Miami Dolphins,BUF,3,20,17,3,23,33,FALSE,0,0,"",14,10
2003,16,reg,Carolina Panthers,Detroit Lions,CAR,20,14,6,7.5,34,37,FALSE,0,0,"",1.5,3
2003,16,reg,Chicago Bears,Washington Redskins,CHI,27,24,3,4,51,35,FALSE,0,0,"",1,16
2003,16,reg,Cleveland Browns,Baltimore Ravens,BAL,0,35,35,3,35,35.5,FALSE,0,0,"",32,0.5
2003,16,reg,Dallas Cowboys,New York Giants,DAL,19,3,16,12.5,22,35.5,FALSE,0,0,"",3.5,13.5
2003,16,reg,Houston Texans,Tennessee Titans,TEN,24,27,3,5.5,51,39,FALSE,1,0,DOME,2.5,12
2003,16,reg,Indianapolis Colts,Denver Broncos,IND,17,31,14,6.5,48,48.5,FALSE,1,0,DOME,7.5,0.5
2003,16,reg,Jacksonville Jaguars,New Orleans Saints,JAX,20,19,1,3,39,42,FALSE,0,0,"",2,3
2003,16,reg,Philadelphia Eagles,San Francisco 49ers,PHI,28,31,3,7,59,44,FALSE,0,0,"",4,15
2003,16,reg,Pittsburgh Steelers,San Diego Chargers,PIT,40,24,16,6.5,64,42,FALSE,0,0,"",9.5,22
2003,16,reg,Seattle Seahawks,Arizona Cardinals,SEA,28,10,18,15.5,38,44.5,FALSE,0,0,"",2.5,6.5
2003,16,reg,St. Louis Rams,Cincinnati Bengals,LAR,27,10,17,7,37,54,FALSE,1,0,DOME,10,17
2003,16,reg,Oakland Raiders,Green Bay Packers,GB,7,41,34,5.5,48,44,FALSE,0,0,"",28.5,4
2003,17,reg,New England Patriots,Buffalo Bills,NE,31,0,31,9.5,31,34.5,FALSE,0,0,"",21.5,3.5
2003,17,reg,San Francisco 49ers,Seattle Seahawks,SF,17,24,7,2.5,41,46.5,FALSE,0,0,"",4.5,5.5
2003,17,reg,Washington Redskins,Philadelphia Eagles,PHI,7,31,24,9,38,42,FALSE,0,0,"",15,4
2003,17,reg,Arizona Cardinals,Minnesota Vikings,MIN,18,17,1,7.5,35,45.5,FALSE,0,0,"",6.5,10.5
2003,17,reg,Atlanta Falcons,Jacksonville Jaguars,ATL,21,14,7,2.5,35,44,FALSE,1,0,DOME,4.5,9
2003,17,reg,Baltimore Ravens,Pittsburgh Steelers,BAL,13,10,3,6,23,37.5,FALSE,0,0,"",3,14.5
2003,17,reg,Cincinnati Bengals,Cleveland Browns,CIN,14,22,8,8.5,36,42,FALSE,0,0,"",0.5,6
2003,17,reg,Detroit Lions,St. Louis Rams,LAR,30,20,10,12,50,45,FALSE,1,0,DOME,2,5
2003,17,reg,Green Bay Packers,Denver Broncos,GB,31,3,28,10,34,41.5,FALSE,0,0,"",18,7.5
2003,17,reg,Houston Texans,Indianapolis Colts,IND,17,20,3,9,37,46.5,FALSE,1,0,DOME,6,9.5
2003,17,reg,Kansas City Chiefs,Chicago Bears,KC,31,3,28,7.5,34,43.5,FALSE,0,0,"",20.5,9.5
2003,17,reg,Miami Dolphins,New York Jets,MIA,23,21,2,3.5,44,37.5,FALSE,0,0,"",1.5,6.5
2003,17,reg,New Orleans Saints,Dallas Cowboys,DAL,13,7,6,1,20,38,FALSE,1,0,DOME,5,18
2003,17,reg,New York Giants,Carolina Panthers,CAR,24,37,13,4.5,61,34.5,FALSE,0,0,"",8.5,26.5
2003,17,reg,San Diego Chargers,Oakland Raiders,LAC,21,14,7,6,35,46,FALSE,0,0,"",1,11
2003,17,reg,Tennessee Titans,Tampa Bay Buccaneers,TEN,33,13,20,4,46,39,FALSE,0,0,"",16,7
2003,Wildcard,post,Baltimore Ravens,Tennessee Titans,TEN,17,20,3,1,37,38,FALSE,0,0,"",2,1
2003,Wildcard,post,Carolina Panthers,Dallas Cowboys,CAR,29,10,19,3,39,34,FALSE,0,0,"",16,5
2003,Wildcard,post,Green Bay Packers,Seattle Seahawks,GB,33,27,6,7.5,60,43.5,FALSE,0,0,"",1.5,16.5
2003,Wildcard,post,Indianapolis Colts,Denver Broncos,IND,41,10,31,3,51,49,FALSE,1,0,DOME,28,2
2003,Division,post,New England Patriots,Tennessee Titans,NE,17,14,3,6,31,34,FALSE,0,0,"",3,3
2003,Division,post,St. Louis Rams,Carolina Panthers,LAR,23,29,6,7,52,46,FALSE,1,0,DOME,1,6
2003,Division,post,Kansas City Chiefs,Indianapolis Colts,KC,31,38,7,3,69,53,FALSE,0,0,"",4,16
2003,Division,post,Philadelphia Eagles,Green Bay Packers,PHI,20,17,3,4,37,43,FALSE,0,0,"",1,6
2003,Conference,post,New England Patriots,Indianapolis Colts,NE,24,14,10,3.5,38,42,FALSE,0,0,"",6.5,4
2003,Conference,post,Philadelphia Eagles,Carolina Panthers,PHI,3,14,11,4,17,36.5,FALSE,0,0,"",7,19.5
2003,Superbowl,post,New England Patriots,Carolina Panthers,NE,32,29,3,7,61,37.5,TRUE,1,0,DOME,4,23.5
2004,1,reg,New England Patriots,Indianapolis Colts,NE,27,24,3,3,51,44.5,FALSE,0,0,"",0,6.5
2004,1,reg,Miami Dolphins,Tennessee Titans,TEN,7,17,10,3,24,38,FALSE,0,0,"",7,14
2004,1,reg,Buffalo Bills,Jacksonville Jaguars,BUF,10,13,3,3,23,35,FALSE,0,0,"",0,12
2004,1,reg,Chicago Bears,Detroit Lions,CHI,16,20,4,1.5,36,38.5,FALSE,0,0,"",2.5,2.5
2004,1,reg,Cleveland Browns,Baltimore Ravens,BAL,20,3,17,3.5,23,37,FALSE,0,0,"",13.5,14
2004,1,reg,Denver Broncos,Kansas City Chiefs,DEN,34,24,10,3,58,48.5,FALSE,0,0,"",7,9.5
2004,1,reg,Houston Texans,San Diego Chargers,HOU,20,27,7,4.5,47,44,FALSE,1,0,DOME,2.5,3
2004,1,reg,Minnesota Vikings,Dallas Cowboys,MIN,35,17,18,6.5,52,44,FALSE,1,0,DOME,11.5,8
2004,1,reg,New Orleans Saints,Seattle Seahawks,SEA,7,21,14,2.5,28,45,FALSE,1,0,DOME,11.5,17
2004,1,reg,New York Jets,Cincinnati Bengals,NYJ,31,24,7,5.5,55,42,FALSE,0,0,"",1.5,13
2004,1,reg,Philadelphia Eagles,New York Giants,PHI,31,17,14,9.5,48,41.5,FALSE,0,0,"",4.5,6.5
2004,1,reg,Pittsburgh Steelers,Oakland Raiders,PIT,24,21,3,3.5,45,41.5,FALSE,0,0,"",0.5,3.5
2004,1,reg,San Francisco 49ers,Atlanta Falcons,ATL,19,21,2,3,40,44.5,FALSE,0,0,"",1,4.5
2004,1,reg,St. Louis Rams,Arizona Cardinals,LAR,17,10,7,11,27,46,FALSE,1,0,DOME,4,19
2004,1,reg,Washington Redskins,Tampa Bay Buccaneers,WAS,16,10,6,2.5,26,38.5,FALSE,0,0,"",3.5,12.5
2004,1,reg,Carolina Panthers,Green Bay Packers,CAR,14,24,10,3,38,43.5,FALSE,0,0,"",7,5.5
2004,2,reg,Arizona Cardinals,New England Patriots,NE,12,23,11,8,35,41.5,FALSE,0,0,"",3,6.5
2004,2,reg,Atlanta Falcons,St. Louis Rams,ATL,34,17,17,2,51,46,FALSE,1,0,DOME,15,5
2004,2,reg,Baltimore Ravens,Pittsburgh Steelers,BAL,30,13,17,4,43,35.5,FALSE,0,0,"",13,7.5
2004,2,reg,Cincinnati Bengals,Miami Dolphins,CIN,16,13,3,5.5,29,40,FALSE,0,0,"",2.5,11
2004,2,reg,Dallas Cowboys,Cleveland Browns,DAL,19,12,7,4.5,31,38,FALSE,0,0,"",2.5,7
2004,2,reg,Detroit Lions,Houston Texans,DET,28,16,12,3,44,43.5,FALSE,1,0,DOME,9,0.5
2004,2,reg,Green Bay Packers,Chicago Bears,GB,10,21,11,9,31,41,FALSE,0,0,"",2,10
2004,2,reg,Jacksonville Jaguars,Denver Broncos,DEN,7,6,1,3,13,38,FALSE,0,0,"",2,25
2004,2,reg,Kansas City Chiefs,Carolina Panthers,KC,17,28,11,7,45,46,FALSE,0,0,"",4,1
2004,2,reg,New Orleans Saints,San Francisco 49ers,NO,30,27,3,7.5,57,42,FALSE,1,0,DOME,4.5,15
2004,2,reg,New York Giants,Washington Redskins,WAS,20,14,6,3,34,40,FALSE,0,0,"",3,6
2004,2,reg,Oakland Raiders,Buffalo Bills,OAK,13,10,3,3.5,23,37.5,FALSE,0,0,"",0.5,14.5
2004,2,reg,San Diego Chargers,New York Jets,NYJ,28,34,6,3,62,47,FALSE,0,0,"",3,15
2004,2,reg,Tampa Bay Buccaneers,Seattle Seahawks,SEA,6,10,4,3,16,37,FALSE,0,0,"",1,21
2004,2,reg,Tennessee Titans,Indianapolis Colts,IND,17,31,14,1.5,48,47,FALSE,0,0,"",12.5,1
2004,2,reg,Philadelphia Eagles,Minnesota Vikings,PHI,27,16,11,3,43,51,FALSE,0,0,"",8,8
2004,3,reg,Atlanta Falcons,Arizona Cardinals,ATL,6,3,3,11,9,44,FALSE,1,0,DOME,8,35
2004,3,reg,Cincinnati Bengals,Baltimore Ravens,BAL,9,23,14,1.5,32,35,FALSE,0,0,"",12.5,3
2004,3,reg,Denver Broncos,San Diego Chargers,DEN,23,13,10,9.5,36,46,FALSE,0,0,"",0.5,10
2004,3,reg,Detroit Lions,Philadelphia Eagles,PHI,13,30,17,4.5,43,44,FALSE,1,0,DOME,12.5,1
2004,3,reg,Indianapolis Colts,Green Bay Packers,IND,45,31,14,6,76,50,FALSE,1,0,DOME,8,26
2004,3,reg,Kansas City Chiefs,Houston Texans,KC,21,24,3,7.5,45,48,FALSE,0,0,"",4.5,3
2004,3,reg,Miami Dolphins,Pittsburgh Steelers,MIA,3,13,10,2.5,16,31,FALSE,0,0,"",7.5,15
2004,3,reg,Minnesota Vikings,Chicago Bears,MIN,27,22,5,12,49,45,FALSE,1,0,DOME,7,4
2004,3,reg,New York Giants,Cleveland Browns,NYG,27,10,17,3,37,38,FALSE,0,0,"",14,1
2004,3,reg,Oakland Raiders,Tampa Bay Buccaneers,OAK,30,20,10,3,50,35.5,FALSE,0,0,"",7,14.5
2004,3,reg,Seattle Seahawks,San Francisco 49ers,SEA,34,0,34,10,34,41.5,FALSE,0,0,"",24,7.5
2004,3,reg,St. Louis Rams,New Orleans Saints,LAR,25,28,3,6,53,49,FALSE,1,0,DOME,3,4
2004,3,reg,Tennessee Titans,Jacksonville Jaguars,TEN,12,15,3,6,27,34.5,FALSE,0,0,"",3,7.5
2004,3,reg,Washington Redskins,Dallas Cowboys,WAS,18,21,3,1.5,39,35.5,FALSE,0,0,"",1.5,3.5
2004,4,reg,Arizona Cardinals,New Orleans Saints,NO,34,10,24,3.5,44,40,FALSE,0,0,"",20.5,4
2004,4,reg,Buffalo Bills,New England Patriots,NE,17,31,14,5.5,48,35,FALSE,0,0,"",8.5,13
2004,4,reg,Carolina Panthers,Atlanta Falcons,CAR,10,27,17,3.5,37,39,FALSE,0,0,"",13.5,2
2004,4,reg,Chicago Bears,Philadelphia Eagles,PHI,9,19,10,8.5,28,40.5,FALSE,0,0,"",1.5,12.5
2004,4,reg,Cleveland Browns,Washington Redskins,WAS,17,13,4,2.5,30,36,FALSE,0,0,"",1.5,6
2004,4,reg,Green Bay Packers,New York Giants,GB,7,14,7,7,21,44,FALSE,0,0,"",0,23
2004,4,reg,Houston Texans,Oakland Raiders,OAK,30,17,13,2,47,42,FALSE,1,0,DOME,11,5
2004,4,reg,Jacksonville Jaguars,Indianapolis Colts,IND,17,24,7,4,41,42,FALSE,0,0,"",3,1
2004,4,reg,Miami Dolphins,New York Jets,NYJ,9,17,8,5.5,26,36,FALSE,0,0,"",2.5,10
2004,4,reg,Pittsburgh Steelers,Cincinnati Bengals,PIT,28,17,11,4,45,39.5,FALSE,0,0,"",7,5.5
2004,4,reg,San Diego Chargers,Tennessee Titans,TEN,38,17,21,3,55,41,FALSE,0,0,"",18,14
2004,4,reg,San Francisco 49ers,St. Louis Rams,LAR,14,24,10,4,38,44,FALSE,0,0,"",6,6
2004,4,reg,Tampa Bay Buccaneers,Denver Broncos,DEN,13,16,3,3,29,35,FALSE,0,0,"",0,6
2004,4,reg,Baltimore Ravens,Kansas City Chiefs,BAL,24,27,3,6,51,41.5,FALSE,0,0,"",3,9.5
2004,5,reg,Atlanta Falcons,Detroit Lions,ATL,10,17,7,6.5,27,41,FALSE,1,0,DOME,0.5,14
2004,5,reg,Dallas Cowboys,New York Giants,DAL,10,26,16,3.5,36,38.5,FALSE,0,0,"",12.5,2.5
2004,5,reg,Denver Broncos,Carolina Panthers,DEN,20,17,3,4,37,38,FALSE,0,0,"",1,1
2004,5,reg,Houston Texans,Minnesota Vikings,MIN,28,34,6,3.5,62,50,FALSE,1,0,DOME,2.5,12
2004,5,reg,Indianapolis Colts,Oakland Raiders,IND,35,14,21,8.5,49,52,FALSE,1,0,DOME,12.5,3
2004,5,reg,New England Patriots,Miami Dolphins,NE,24,10,14,11,34,34,FALSE,0,0,"",3,0
2004,5,reg,New Orleans Saints,Tampa Bay Buccaneers,NO,17,20,3,3,37,38.5,FALSE,1,0,DOME,0,1.5
2004,5,reg,New York Jets,Buffalo Bills,NYJ,16,14,2,6.5,30,37,FALSE,0,0,"",4.5,7
2004,5,reg,Pittsburgh Steelers,Cleveland Browns,PIT,34,23,11,4.5,57,36,FALSE,0,0,"",6.5,21
2004,5,reg,San Diego Chargers,Jacksonville Jaguars,JAX,34,21,13,2.5,55,37,FALSE,0,0,"",10.5,18
2004,5,reg,San Francisco 49ers,Arizona Cardinals,SF,31,28,3,1,59,36.5,FALSE,0,0,"",2,22.5
2004,5,reg,Seattle Seahawks,St. Louis Rams,SEA,27,33,6,8,60,44,FALSE,0,0,"",2,16
2004,5,reg,Washington Redskins,Baltimore Ravens,PICK,10,17,7,0,27,34,FALSE,0,0,"",7,7
2004,5,reg,Green Bay Packers,Tennessee Titans,GB,27,48,21,3,75,44,FALSE,0,0,"",18,31
2004,6,reg,Atlanta Falcons,San Diego Chargers,ATL,21,20,1,5.5,41,43,FALSE,1,0,DOME,4.5,2
2004,6,reg,Buffalo Bills,Miami Dolphins,BUF,20,13,7,4.5,33,30,FALSE,0,0,"",2.5,3
2004,6,reg,Chicago Bears,Washington Redskins,CHI,10,13,3,1.5,23,33.5,FALSE,0,0,"",1.5,10.5
2004,6,reg,Cleveland Browns,Cincinnati Bengals,CLE,34,17,17,3,51,40,FALSE,0,0,"",14,11
2004,6,reg,Dallas Cowboys,Pittsburgh Steelers,DAL,20,24,4,3,44,39,FALSE,0,0,"",1,5
2004,6,reg,Detroit Lions,Green Bay Packers,DET,10,38,28,3,48,45,FALSE,1,0,DOME,25,3
2004,6,reg,Jacksonville Jaguars,Kansas City Chiefs,KC,22,16,6,2.5,38,44,FALSE,0,0,"",3.5,6
2004,6,reg,New England Patriots,Seattle Seahawks,NE,30,20,10,3.5,50,42,FALSE,0,0,"",6.5,8
2004,6,reg,New Orleans Saints,Minnesota Vikings,MIN,31,38,7,3.5,69,53,FALSE,1,0,DOME,3.5,16
2004,6,reg,New York Jets,San Francisco 49ers,NYJ,22,14,8,9.5,36,43,FALSE,0,0,"",1.5,7
2004,6,reg,Oakland Raiders,Denver Broncos,DEN,3,31,28,2.5,34,42,FALSE,0,0,"",25.5,8
2004,6,reg,Philadelphia Eagles,Carolina Panthers,PHI,30,8,22,10,38,42,FALSE,0,0,"",12,4
2004,6,reg,Tennessee Titans,Houston Texans,TEN,10,20,10,5.5,30,46,FALSE,0,0,"",4.5,16
2004,6,reg,St. Louis Rams,Tampa Bay Buccaneers,LAR,28,21,7,6.5,49,42.5,FALSE,1,0,DOME,0.5,6.5
2004,7,reg,Arizona Cardinals,Seattle Seahawks,SEA,25,17,8,6.5,42,40,FALSE,0,0,"",1.5,2
2004,7,reg,Baltimore Ravens,Buffalo Bills,BAL,20,6,14,4.5,26,31,FALSE,0,0,"",9.5,5
2004,7,reg,Carolina Panthers,San Diego Chargers,CAR,6,17,11,3,23,42,FALSE,0,0,"",8,19
2004,7,reg,Cleveland Browns,Philadelphia Eagles,PHI,31,34,3,7,65,41.5,FALSE,0,0,"",4,23.5
2004,7,reg,Green Bay Packers,Dallas Cowboys,GB,41,20,21,4,61,44,FALSE,0,0,"",17,17
2004,7,reg,Indianapolis Colts,Jacksonville Jaguars,IND,24,27,3,9,51,47,FALSE,1,0,DOME,6,4
2004,7,reg,Kansas City Chiefs,Atlanta Falcons,KC,56,10,46,3.5,66,44.5,FALSE,0,0,"",42.5,21.5
2004,7,reg,Miami Dolphins,St. Louis Rams,LAR,31,14,17,5,45,37.5,FALSE,0,0,"",12,7.5
2004,7,reg,Minnesota Vikings,Tennessee Titans,MIN,20,3,17,6,23,53,FALSE,1,0,DOME,11,30
2004,7,reg,New England Patriots,New York Jets,NE,13,7,6,6,20,43.5,FALSE,0,0,"",0,23.5
2004,7,reg,New York Giants,Detroit Lions,NYG,13,28,15,7,41,40,FALSE,0,0,"",8,1
2004,7,reg,Oakland Raiders,New Orleans Saints,OAK,26,31,5,3,57,45.5,FALSE,0,0,"",2,11.5
2004,7,reg,Tampa Bay Buccaneers,Chicago Bears,TB,19,7,12,7,26,32,FALSE,0,0,"",5,6
2004,7,reg,Cincinnati Bengals,Denver Broncos,DEN,23,10,13,7,33,42.5,FALSE,0,0,"",6,9.5
2004,8,reg,Buffalo Bills,Arizona Cardinals,BUF,38,14,24,4.5,52,33.5,FALSE,0,0,"",19.5,18.5
2004,8,reg,Chicago Bears,San Francisco 49ers,CHI,23,13,10,2,36,35.5,FALSE,0,0,"",8,0.5
2004,8,reg,Dallas Cowboys,Detroit Lions,DAL,31,21,10,3,52,40,FALSE,0,0,"",7,12
2004,8,reg,Denver Broncos,Atlanta Falcons,DEN,28,41,13,7,69,39.5,FALSE,0,0,"",6,29.5
2004,8,reg,Houston Texans,Jacksonville Jaguars,HOU,20,6,14,2,26,42,FALSE,1,0,DOME,12,16
2004,8,reg,Kansas City Chiefs,Indianapolis Colts,IND,45,35,10,1,80,56.5,FALSE,0,0,"",9,23.5
2004,8,reg,Minnesota Vikings,New York Giants,MIN,13,34,21,6.5,47,48.5,FALSE,1,0,DOME,14.5,1.5
2004,8,reg,Philadelphia Eagles,Baltimore Ravens,PHI,15,10,5,7.5,25,37,FALSE,0,0,"",2.5,12
2004,8,reg,Pittsburgh Steelers,New England Patriots,NE,34,20,14,3,54,42,FALSE,0,0,"",11,12
2004,8,reg,San Diego Chargers,Oakland Raiders,LAC,42,14,28,6,56,46,FALSE,0,0,"",22,10
2004,8,reg,Seattle Seahawks,Carolina Panthers,SEA,23,17,6,8,40,39,FALSE,0,0,"",2,1
2004,8,reg,Tennessee Titans,Cincinnati Bengals,TEN,27,20,7,3,47,39.5,FALSE,0,0,"",4,7.5
2004,8,reg,Washington Redskins,Green Bay Packers,GB,14,28,14,1,42,40.5,FALSE,0,0,"",13,1.5
2004,8,reg,New York Jets,Miami Dolphins,NYJ,41,14,27,7,55,35.5,FALSE,0,0,"",20,19.5
2004,9,reg,Baltimore Ravens,Cleveland Browns,BAL,27,13,14,6,40,35,FALSE,0,0,"",8,5
2004,9,reg,Buffalo Bills,New York Jets,NYJ,22,17,5,3,39,34,FALSE,0,0,"",2,5
2004,9,reg,Carolina Panthers,Oakland Raiders,CAR,24,27,3,6,51,41,FALSE,0,0,"",3,10
2004,9,reg,Cincinnati Bengals,Dallas Cowboys,PICK,26,3,23,0,29,44,FALSE,0,0,"",23,15
2004,9,reg,Denver Broncos,Houston Texans,DEN,31,13,18,7,44,44,FALSE,0,0,"",11,0
2004,9,reg,Detroit Lions,Washington Redskins,DET,10,17,7,3.5,27,37,FALSE,1,0,DOME,3.5,10
2004,9,reg,Miami Dolphins,Arizona Cardinals,MIA,23,24,1,3,47,34.5,FALSE,0,0,"",2,12.5
2004,9,reg,New York Giants,Chicago Bears,NYG,21,28,7,9,49,34.5,FALSE,0,0,"",2,14.5
2004,9,reg,Pittsburgh Steelers,Philadelphia Eagles,PHI,27,3,24,1.5,30,44.5,FALSE,0,0,"",22.5,14.5
2004,9,reg,San Diego Chargers,New Orleans Saints,LAC,43,17,26,6.5,60,49.5,FALSE,0,0,"",19.5,10.5
2004,9,reg,San Francisco 49ers,Seattle Seahawks,SEA,27,42,15,7,69,40.5,FALSE,0,0,"",8,28.5
2004,9,reg,St. Louis Rams,New England Patriots,LAR,22,40,18,2.5,62,49.5,FALSE,1,0,DOME,15.5,12.5
2004,9,reg,Tampa Bay Buccaneers,Kansas City Chiefs,KC,34,31,3,3,65,45.5,FALSE,0,0,"",0,19.5
2004,9,reg,Indianapolis Colts,Minnesota Vikings,IND,31,28,3,7,59,58,FALSE,1,0,DOME,4,1
2004,10,reg,Arizona Cardinals,New York Giants,ARI,17,14,3,1,31,39,FALSE,0,0,"",2,8
2004,10,reg,Atlanta Falcons,Tampa Bay Buccaneers,ATL,24,14,10,3.5,38,41,FALSE,1,0,DOME,6.5,3
2004,10,reg,Cleveland Browns,Pittsburgh Steelers,PIT,10,24,14,3.5,34,41,FALSE,0,0,"",10.5,7
2004,10,reg,Green Bay Packers,Minnesota Vikings,GB,34,31,3,4.5,65,50,FALSE,0,0,"",1.5,15
2004,10,reg,Indianapolis Colts,Houston Texans,IND,49,14,35,8.5,63,54.5,FALSE,1,0,DOME,26.5,8.5
2004,10,reg,Jacksonville Jaguars,Detroit Lions,JAX,23,17,6,3.5,40,34.5,FALSE,0,0,"",2.5,5.5
2004,10,reg,New England Patriots,Buffalo Bills,NE,29,6,23,7,35,38,FALSE,0,0,"",16,3
2004,10,reg,New Orleans Saints,Kansas City Chiefs,KC,27,20,7,3.5,47,56.5,FALSE,1,0,DOME,3.5,9.5
2004,10,reg,New York Jets,Baltimore Ravens,BAL,17,20,3,1,37,32,FALSE,0,0,"",2,5
2004,10,reg,San Francisco 49ers,Carolina Panthers,SF,27,37,10,1.5,64,41.5,FALSE,0,0,"",8.5,22.5
2004,10,reg,St. Louis Rams,Seattle Seahawks,SEA,23,12,11,2.5,35,50.5,FALSE,1,0,DOME,8.5,15.5
2004,10,reg,Tennessee Titans,Chicago Bears,TEN,17,19,2,5.5,36,34,FALSE,0,0,"",3.5,2
2004,10,reg,Washington Redskins,Cincinnati Bengals,WAS,10,17,7,4,27,36.5,FALSE,0,0,"",3,9.5
2004,10,reg,Dallas Cowboys,Philadelphia Eagles,PHI,21,49,28,7,70,43,FALSE,0,0,"",21,27
2004,11,reg,Baltimore Ravens,Dallas Cowboys,BAL,30,10,20,7.5,40,36,FALSE,0,0,"",12.5,4
2004,11,reg,Buffalo Bills,St. Louis Rams,BUF,37,17,20,2,54,40,FALSE,0,0,"",18,14
2004,11,reg,Carolina Panthers,Arizona Cardinals,CAR,35,10,25,3,45,38,FALSE,0,0,"",22,7
2004,11,reg,Chicago Bears,Indianapolis Colts,IND,10,41,31,8,51,44.5,FALSE,0,0,"",23,6.5
2004,11,reg,Cincinnati Bengals,Pittsburgh Steelers,PIT,14,19,5,4,33,40.5,FALSE,0,0,"",1,7.5
2004,11,reg,Cleveland Browns,New York Jets,NYJ,7,10,3,1.5,17,38,FALSE,0,0,"",1.5,21
2004,11,reg,Houston Texans,Green Bay Packers,GB,13,16,3,3,29,51,FALSE,1,0,DOME,0,22
2004,11,reg,Jacksonville Jaguars,Tennessee Titans,JAX,15,18,3,3,33,36,FALSE,0,0,"",0,3
2004,11,reg,Minnesota Vikings,Detroit Lions,MIN,22,19,3,8,41,48,FALSE,1,0,DOME,5,7
2004,11,reg,New Orleans Saints,Denver Broncos,DEN,13,34,21,6,47,48.5,FALSE,1,0,DOME,15,1.5
2004,11,reg,New York Giants,Atlanta Falcons,ATL,10,14,4,3,24,40,FALSE,0,0,"",1,16
2004,11,reg,Oakland Raiders,San Diego Chargers,LAC,17,23,6,4.5,40,47.5,FALSE,0,0,"",1.5,7.5
2004,11,reg,Philadelphia Eagles,Washington Redskins,PHI,28,6,22,10,34,38.5,FALSE,0,0,"",12,4.5
2004,11,reg,Seattle Seahawks,Miami Dolphins,SEA,24,17,7,9.5,41,37,FALSE,0,0,"",2.5,4
2004,11,reg,Tampa Bay Buccaneers,San Francisco 49ers,TB,35,3,32,8,38,42,FALSE,0,0,"",24,4
2004,11,reg,Kansas City Chiefs,New England Patriots,NE,19,27,8,3,46,52,FALSE,0,0,"",5,6
2004,12,reg,Dallas Cowboys,Chicago Bears,DAL,21,7,14,3.5,28,36,FALSE,0,0,"",10.5,8
2004,12,reg,Detroit Lions,Indianapolis Colts,IND,9,41,32,8.5,50,54,FALSE,1,0,DOME,23.5,4
2004,12,reg,Arizona Cardinals,New York Jets,NYJ,3,13,10,3,16,36.5,FALSE,0,0,"",7,20.5
2004,12,reg,Atlanta Falcons,New Orleans Saints,ATL,24,21,3,9,45,47.5,FALSE,1,0,DOME,6,2.5
2004,12,reg,Carolina Panthers,Tampa Bay Buccaneers,TB,21,14,7,3,35,39,FALSE,0,0,"",4,4
2004,12,reg,Cincinnati Bengals,Cleveland Browns,CIN,58,48,10,6,106,37.5,FALSE,0,0,"",4,68.5
2004,12,reg,Denver Broncos,Oakland Raiders,DEN,24,25,1,11.5,49,42.5,FALSE,0,0,"",10.5,6.5
2004,12,reg,Houston Texans,Tennessee Titans,HOU,31,21,10,2,52,43,FALSE,1,0,DOME,8,9
2004,12,reg,Kansas City Chiefs,San Diego Chargers,KC,31,34,3,3,65,54,FALSE,0,0,"",0,11
2004,12,reg,Minnesota Vikings,Jacksonville Jaguars,MIN,27,16,11,6,43,45.5,FALSE,1,0,DOME,5,2.5
2004,12,reg,New England Patriots,Baltimore Ravens,NE,24,3,21,7,27,34.5,FALSE,0,0,"",14,7.5
2004,12,reg,New York Giants,Philadelphia Eagles,PHI,6,27,21,7,33,35.5,FALSE,0,0,"",14,2.5
2004,12,reg,Pittsburgh Steelers,Washington Redskins,PIT,16,7,9,10,23,34.5,FALSE,0,0,"",1,11.5
2004,12,reg,San Francisco 49ers,Miami Dolphins,PICK,17,24,7,0,41,37.5,FALSE,0,0,"",7,3.5
2004,12,reg,Seattle Seahawks,Buffalo Bills,SEA,9,38,29,4,47,38,FALSE,0,0,"",25,9
2004,12,reg,Green Bay Packers,St. Louis Rams,GB,45,17,28,7,62,51,FALSE,0,0,"",21,11
2004,13,reg,Baltimore Ravens,Cincinnati Bengals,BAL,26,27,1,6.5,53,37,FALSE,0,0,"",5.5,16
2004,13,reg,Chicago Bears,Minnesota Vikings,MIN,24,14,10,7,38,40.5,FALSE,0,0,"",3,2.5
2004,13,reg,Cleveland Browns,New England Patriots,NE,15,42,27,11,57,41,FALSE,0,0,"",16,16
2004,13,reg,Detroit Lions,Arizona Cardinals,DET,26,12,14,6,38,37,FALSE,1,0,DOME,8,1
2004,13,reg,Indianapolis Colts,Tennessee Titans,IND,51,24,27,12,75,54,FALSE,1,0,DOME,15,21
2004,13,reg,Jacksonville Jaguars,Pittsburgh Steelers,PIT,16,17,1,3,33,35.5,FALSE,0,0,"",2,2.5
2004,13,reg,Miami Dolphins,Buffalo Bills,BUF,32,42,10,5,74,34,FALSE,0,0,"",5,40
2004,13,reg,New Orleans Saints,Carolina Panthers,CAR,21,32,11,2,53,46.5,FALSE,1,0,DOME,9,6.5
2004,13,reg,New York Jets,Houston Texans,NYJ,29,7,22,7,36,42,FALSE,0,0,"",15,6
2004,13,reg,Oakland Raiders,Kansas City Chiefs,KC,27,34,7,1,61,52,FALSE,0,0,"",6,9
2004,13,reg,Philadelphia Eagles,Green Bay Packers,PHI,47,17,30,5.5,64,48.5,FALSE,0,0,"",24.5,15.5
2004,13,reg,San Diego Chargers,Denver Broncos,LAC,20,17,3,3,37,46.5,FALSE,0,0,"",0,9.5
2004,13,reg,St. Louis Rams,San Francisco 49ers,LAR,16,6,10,11,22,49,FALSE,1,0,DOME,1,27
2004,13,reg,Tampa Bay Buccaneers,Atlanta Falcons,TB,27,0,27,2,27,39.5,FALSE,0,0,"",25,12.5
2004,13,reg,Washington Redskins,New York Giants,WAS,31,7,24,3,38,33,FALSE,0,0,"",21,5
2004,13,reg,Seattle Seahawks,Dallas Cowboys,SEA,39,43,4,7,82,42,FALSE,0,0,"",3,40
2004,14,reg,Arizona Cardinals,San Francisco 49ers,ARI,28,31,3,7,59,36,FALSE,0,0,"",4,23
2004,14,reg,Atlanta Falcons,Oakland Raiders,ATL,35,10,25,7.5,45,46,FALSE,1,0,DOME,17.5,1
2004,14,reg,Baltimore Ravens,New York Giants,BAL,37,14,23,10,51,34,FALSE,0,0,"",13,17
2004,14,reg,Buffalo Bills,Cleveland Browns,BUF,37,7,30,11,44,38.5,FALSE,0,0,"",19,5.5
2004,14,reg,Carolina Panthers,St. Louis Rams,CAR,20,7,13,7,27,44.5,FALSE,0,0,"",6,17.5
2004,14,reg,Dallas Cowboys,New Orleans Saints,DAL,13,27,14,7,40,49,FALSE,0,0,"",7,9
2004,14,reg,Denver Broncos,Miami Dolphins,DEN,20,17,3,11.5,37,41,FALSE,0,0,"",8.5,4
2004,14,reg,Green Bay Packers,Detroit Lions,GB,16,13,3,9,29,41,FALSE,0,0,"",6,12
2004,14,reg,Houston Texans,Indianapolis Colts,IND,14,23,9,10,37,57,FALSE,1,0,DOME,1,20
2004,14,reg,Jacksonville Jaguars,Chicago Bears,JAX,22,3,19,7,25,34,FALSE,0,0,"",12,9
2004,14,reg,Minnesota Vikings,Seattle Seahawks,MIN,23,27,4,6.5,50,54,FALSE,1,0,DOME,2.5,4
2004,14,reg,New England Patriots,Cincinnati Bengals,NE,35,28,7,10.5,63,47,FALSE,0,0,"",3.5,16
2004,14,reg,Pittsburgh Steelers,New York Jets,PIT,17,6,11,4.5,23,35,FALSE,0,0,"",6.5,12
2004,14,reg,San Diego Chargers,Tampa Bay Buccaneers,LAC,31,24,7,4,55,42.5,FALSE,0,0,"",3,12.5
2004,14,reg,Washington Redskins,Philadelphia Eagles,PHI,14,17,3,8,31,38.5,FALSE,0,0,"",5,7.5
2004,14,reg,Tennessee Titans,Kansas City Chiefs,KC,38,49,11,2.5,87,53,FALSE,0,0,"",8.5,34
2004,15,reg,Atlanta Falcons,Carolina Panthers,ATL,34,31,3,3.5,65,41,FALSE,1,0,DOME,0.5,24
2004,15,reg,New York Giants,Pittsburgh Steelers,PIT,30,33,3,10,63,36.5,FALSE,0,0,"",7,26.5
2004,15,reg,San Francisco 49ers,Washington Redskins,WAS,16,26,10,6.5,42,36.5,FALSE,0,0,"",3.5,5.5
2004,15,reg,Arizona Cardinals,St. Louis Rams,LAR,31,7,24,3,38,41.5,FALSE,0,0,"",21,3.5
2004,15,reg,Chicago Bears,Houston Texans,CHI,5,24,19,1,29,34,FALSE,0,0,"",18,5
2004,15,reg,Cincinnati Bengals,Buffalo Bills,BUF,17,33,16,3,50,41,FALSE,0,0,"",13,9
2004,15,reg,Cleveland Browns,San Diego Chargers,LAC,0,21,21,8,21,35,FALSE,0,0,"",13,14
2004,15,reg,Detroit Lions,Minnesota Vikings,MIN,27,28,1,3,55,48.5,FALSE,1,0,DOME,2,6.5
2004,15,reg,Green Bay Packers,Jacksonville Jaguars,GB,25,28,3,3.5,53,37,FALSE,0,0,"",0.5,16
2004,15,reg,Indianapolis Colts,Baltimore Ravens,IND,20,10,10,7.5,30,48.5,FALSE,1,0,DOME,2.5,18.5
2004,15,reg,Kansas City Chiefs,Denver Broncos,DEN,45,17,28,3,62,52.5,FALSE,0,0,"",25,9.5
2004,15,reg,New York Jets,Seattle Seahawks,NYJ,37,14,23,6.5,51,41.5,FALSE,0,0,"",16.5,9.5
2004,15,reg,Oakland Raiders,Tennessee Titans,OAK,40,35,5,3.5,75,49.5,FALSE,0,0,"",1.5,25.5
2004,15,reg,Philadelphia Eagles,Dallas Cowboys,PHI,12,7,5,11.5,19,45,FALSE,0,0,"",6.5,26
2004,15,reg,Tampa Bay Buccaneers,New Orleans Saints,TB,17,21,4,7.5,38,43.5,FALSE,0,0,"",3.5,5.5
2004,15,reg,Miami Dolphins,New England Patriots,NE,29,28,1,10,57,44,FALSE,0,0,"",9,13
2004,16,reg,Minnesota Vikings,Green Bay Packers,MIN,31,34,3,3.5,65,56,FALSE,1,0,DOME,0.5,9
2004,16,reg,Kansas City Chiefs,Oakland Raiders,KC,31,30,1,9.5,61,60,FALSE,0,0,"",8.5,1
2004,16,reg,Tennessee Titans,Denver Broncos,DEN,16,37,21,4,53,50.5,FALSE,0,0,"",17,2.5
2004,16,reg,Cincinnati Bengals,New York Giants,CIN,23,22,1,6.5,45,46.5,FALSE,0,0,"",5.5,1.5
2004,16,reg,Dallas Cowboys,Washington Redskins,WAS,13,10,3,2.5,23,35,FALSE,0,0,"",0.5,12
2004,16,reg,Detroit Lions,Chicago Bears,DET,19,13,6,6,32,37,FALSE,1,0,DOME,0,5
2004,16,reg,Indianapolis Colts,San Diego Chargers,IND,34,31,3,7,65,56,FALSE,1,0,DOME,4,9
2004,16,reg,Jacksonville Jaguars,Houston Texans,JAX,0,21,21,6.5,21,36.5,FALSE,0,0,"",14.5,15.5
2004,16,reg,Miami Dolphins,Cleveland Browns,MIA,10,7,3,9,17,40.5,FALSE,0,0,"",6,23.5
2004,16,reg,New Orleans Saints,Atlanta Falcons,NO,26,13,13,6.5,39,44,FALSE,1,0,DOME,6.5,5
2004,16,reg,New York Jets,New England Patriots,PICK,7,23,16,0,30,41.5,FALSE,0,0,"",16,11.5
2004,16,reg,Pittsburgh Steelers,Baltimore Ravens,PIT,20,7,13,5,27,34,FALSE,0,0,"",8,7
2004,16,reg,San Francisco 49ers,Buffalo Bills,BUF,7,41,34,10,48,41.5,FALSE,0,0,"",24,6.5
2004,16,reg,Seattle Seahawks,Arizona Cardinals,SEA,24,21,3,7,45,44,FALSE,0,0,"",4,1
2004,16,reg,Tampa Bay Buccaneers,Carolina Panthers,TB,20,37,17,1.5,57,39,FALSE,0,0,"",15.5,18
2004,16,reg,St. Louis Rams,Philadelphia Eagles,LAR,20,7,13,4,27,42.5,FALSE,1,0,DOME,9,15.5
2004,17,reg,Arizona Cardinals,Tampa Bay Buccaneers,ARI,12,7,5,4,19,38.5,FALSE,0,0,"",1,19.5
2004,17,reg,Baltimore Ravens,Miami Dolphins,BAL,30,23,7,11,53,33,FALSE,0,0,"",4,20
2004,17,reg,Buffalo Bills,Pittsburgh Steelers,BUF,24,29,5,9.5,53,33,FALSE,0,0,"",4.5,20
2004,17,reg,Carolina Panthers,New Orleans Saints,CAR,18,21,3,7,39,46,FALSE,0,0,"",4,7
2004,17,reg,Chicago Bears,Green Bay Packers,CHI,14,31,17,3,45,34,FALSE,0,0,"",14,11
2004,17,reg,Denver Broncos,Indianapolis Colts,DEN,33,14,19,10,47,44,FALSE,0,0,"",9,3
2004,17,reg,Houston Texans,Cleveland Browns,HOU,14,22,8,10,36,41,FALSE,1,0,DOME,2,5
2004,17,reg,New England Patriots,San Francisco 49ers,NE,21,7,14,13,28,37,FALSE,0,0,"",1,9
2004,17,reg,New York Giants,Dallas Cowboys,NYG,28,24,4,1,52,38.5,FALSE,0,0,"",3,13.5
2004,17,reg,Oakland Raiders,Jacksonville Jaguars,JAX,6,13,7,2.5,19,43,FALSE,0,0,"",4.5,24
2004,17,reg,Philadelphia Eagles,Cincinnati Bengals,CIN,10,38,28,4,48,37.5,FALSE,0,0,"",24,10.5
2004,17,reg,San Diego Chargers,Kansas City Chiefs,KC,24,17,7,6.5,41,51.5,FALSE,0,0,"",0.5,10.5
2004,17,reg,Seattle Seahawks,Atlanta Falcons,SEA,28,26,2,5.5,54,41,FALSE,0,0,"",3.5,13
2004,17,reg,St. Louis Rams,New York Jets,NYJ,32,29,3,3.5,61,46,FALSE,1,0,DOME,0.5,15
2004,17,reg,Tennessee Titans,Detroit Lions,DET,24,19,5,2.5,43,45.5,FALSE,0,0,"",2.5,2.5
2004,17,reg,Washington Redskins,Minnesota Vikings,MIN,21,18,3,4,39,41,FALSE,0,0,"",1,2
2004,Wildcard,post,San Diego Chargers,New York Jets,LAC,17,20,3,6.5,37,42.5,FALSE,0,0,"",3.5,5.5
2004,Wildcard,post,Seattle Seahawks,St. Louis Rams,SEA,20,27,7,4,47,51,FALSE,0,0,"",3,4
2004,Wildcard,post,Green Bay Packers,Minnesota Vikings,GB,17,31,14,6,48,52.5,FALSE,0,0,"",8,4.5
2004,Wildcard,post,Indianapolis Colts,Denver Broncos,IND,49,24,25,10,73,56,FALSE,1,0,DOME,15,17
2004,Division,post,Atlanta Falcons,St. Louis Rams,ATL,47,17,30,6.5,64,49,FALSE,1,0,DOME,23.5,15
2004,Division,post,Pittsburgh Steelers,New York Jets,PIT,20,17,3,9,37,35.5,FALSE,0,0,"",6,1.5
2004,Division,post,New England Patriots,Indianapolis Colts,NE,20,3,17,1,23,51,FALSE,0,0,"",16,28
2004,Division,post,Philadelphia Eagles,Minnesota Vikings,PHI,27,14,13,8,41,47,FALSE,0,0,"",5,6
2004,Conference,post,Philadelphia Eagles,Atlanta Falcons,PHI,27,10,17,6,37,37,FALSE,0,0,"",11,0
2004,Conference,post,Pittsburgh Steelers,New England Patriots,NE,27,41,14,3,68,36.5,FALSE,0,0,"",11,31.5
2004,Superbowl,post,Philadelphia Eagles,New England Patriots,NE,21,24,3,7,45,46.5,TRUE,0,0,"",4,1.5
2005,1,reg,New England Patriots,Oakland Raiders,NE,30,20,10,7.5,50,50,FALSE,0,0,"",2.5,0
2005,1,reg,Baltimore Ravens,Indianapolis Colts,IND,7,24,17,3,31,47,FALSE,0,0,"",14,16
2005,1,reg,Buffalo Bills,Houston Texans,BUF,22,7,15,4.5,29,39,FALSE,0,0,"",10.5,10
2005,1,reg,Carolina Panthers,New Orleans Saints,CAR,20,23,3,6.5,43,45.5,FALSE,0,0,"",3.5,2.5
2005,1,reg,Cleveland Browns,Cincinnati Bengals,CIN,13,27,14,3.5,40,44.5,FALSE,0,0,"",10.5,4.5
2005,1,reg,Detroit Lions,Green Bay Packers,DET,17,3,14,3,20,46,FALSE,1,0,DOME,11,26
2005,1,reg,Jacksonville Jaguars,Seattle Seahawks,JAX,26,14,12,3,40,40,FALSE,0,0,"",9,0
2005,1,reg,Kansas City Chiefs,New York Jets,KC,27,7,20,3,34,48.5,FALSE,0,0,"",17,14.5
2005,1,reg,Miami Dolphins,Denver Broncos,DEN,34,10,24,4.5,44,38.5,FALSE,0,0,"",19.5,5.5
2005,1,reg,Minnesota Vikings,Tampa Bay Buccaneers,MIN,13,24,11,6,37,43.5,FALSE,1,0,DOME,5,6.5
2005,1,reg,New York Giants,Arizona Cardinals,NYG,42,19,23,1.5,61,37.5,FALSE,0,0,"",21.5,23.5
2005,1,reg,Pittsburgh Steelers,Tennessee Titans,PIT,34,7,27,7,41,40.5,FALSE,0,0,"",20,0.5
2005,1,reg,San Diego Chargers,Dallas Cowboys,LAC,24,28,4,5,52,41,FALSE,0,0,"",1,11
2005,1,reg,San Francisco 49ers,St. Louis Rams,LAR,28,25,3,4.5,53,46,FALSE,0,0,"",1.5,7
2005,1,reg,Washington Redskins,Chicago Bears,WAS,9,7,2,6,16,33,FALSE,0,0,"",4,17
2005,1,reg,Atlanta Falcons,Philadelphia Eagles,PHI,14,10,4,2,24,41.5,FALSE,1,0,DOME,2,17.5
2005,2,reg,Arizona Cardinals,St. Louis Rams,LAR,12,17,5,1,29,44,FALSE,0,0,"",4,15
2005,2,reg,Carolina Panthers,New England Patriots,NE,27,17,10,3,44,44,FALSE,0,0,"",7,0
2005,2,reg,Chicago Bears,Detroit Lions,DET,38,6,32,2.5,44,34,FALSE,0,0,"",29.5,10
2005,2,reg,Cincinnati Bengals,Minnesota Vikings,CIN,37,8,29,3,45,47,FALSE,0,0,"",26,2
2005,2,reg,Denver Broncos,San Diego Chargers,DEN,20,17,3,3,37,44,FALSE,0,0,"",0,7
2005,2,reg,Green Bay Packers,Cleveland Browns,GB,24,26,2,7,50,43,FALSE,0,0,"",5,7
2005,2,reg,Houston Texans,Pittsburgh Steelers,PIT,7,27,20,4.5,34,39.5,FALSE,1,0,DOME,15.5,5.5
2005,2,reg,Indianapolis Colts,Jacksonville Jaguars,IND,10,3,7,9,13,46,FALSE,1,0,DOME,2,33
2005,2,reg,New York Jets,Miami Dolphins,NYJ,17,7,10,6,24,37,FALSE,0,0,"",4,13
2005,2,reg,Oakland Raiders,Kansas City Chiefs,KC,17,23,6,1.5,40,53,FALSE,0,0,"",4.5,13
2005,2,reg,Philadelphia Eagles,San Francisco 49ers,PHI,42,3,39,11.5,45,43,FALSE,0,0,"",27.5,2
2005,2,reg,Seattle Seahawks,Atlanta Falcons,SEA,21,18,3,1,39,41.5,FALSE,0,0,"",2,2.5
2005,2,reg,Tampa Bay Buccaneers,Buffalo Bills,TB,19,3,16,2.5,22,35,FALSE,0,0,"",13.5,13
2005,2,reg,Tennessee Titans,Baltimore Ravens,BAL,25,10,15,3.5,35,36,FALSE,0,0,"",11.5,1
2005,2,reg,Dallas Cowboys,Washington Redskins,DAL,13,14,1,6,27,36,FALSE,0,0,"",5,9
2005,2,reg,New York Giants,New Orleans Saints,NYG,27,10,17,3,37,43,FALSE,0,0,"",14,6
2005,3,reg,Buffalo Bills,Atlanta Falcons,BUF,16,24,8,3,40,36,FALSE,0,0,"",5,4
2005,3,reg,Chicago Bears,Cincinnati Bengals,CIN,7,24,17,3,31,39,FALSE,0,0,"",14,8
2005,3,reg,Green Bay Packers,Tampa Bay Buccaneers,TB,16,17,1,3,33,38,FALSE,0,0,"",2,5
2005,3,reg,Indianapolis Colts,Cleveland Browns,IND,13,6,7,13.5,19,47,FALSE,1,0,DOME,6.5,28
2005,3,reg,Miami Dolphins,Carolina Panthers,CAR,27,24,3,3.5,51,37.5,FALSE,0,0,"",0.5,13.5
2005,3,reg,Minnesota Vikings,New Orleans Saints,MIN,33,16,17,3.5,49,44.5,FALSE,1,0,DOME,13.5,4.5
2005,3,reg,New York Jets,Jacksonville Jaguars,NYJ,20,26,6,2.5,46,34.5,FALSE,0,0,"",3.5,11.5
2005,3,reg,Philadelphia Eagles,Oakland Raiders,PHI,23,20,3,8.5,43,47,FALSE,0,0,"",5.5,4
2005,3,reg,Pittsburgh Steelers,New England Patriots,PIT,20,23,3,3,43,41.5,FALSE,0,0,"",0,1.5
2005,3,reg,San Diego Chargers,New York Giants,LAC,45,23,22,5.5,68,42.5,FALSE,0,0,"",16.5,25.5
2005,3,reg,San Francisco 49ers,Dallas Cowboys,DAL,31,34,3,6.5,65,41,FALSE,0,0,"",3.5,24
2005,3,reg,Seattle Seahawks,Arizona Cardinals,SEA,37,12,25,6.5,49,42,FALSE,0,0,"",18.5,7
2005,3,reg,St. Louis Rams,Tennessee Titans,LAR,31,27,4,6.5,58,46,FALSE,1,0,DOME,2.5,12
2005,3,reg,Denver Broncos,Kansas City Chiefs,DEN,30,10,20,2.5,40,49,FALSE,0,0,"",17.5,9
2005,4,reg,Arizona Cardinals,San Francisco 49ers,ARI,31,14,17,3,45,42,TRUE,0,0,"",14,3
2005,4,reg,Atlanta Falcons,Minnesota Vikings,ATL,30,10,20,6,40,44.5,FALSE,1,0,DOME,14,4.5
2005,4,reg,Baltimore Ravens,New York Jets,BAL,13,3,10,7.5,16,31.5,FALSE,0,0,"",2.5,15.5
2005,4,reg,Cincinnati Bengals,Houston Texans,CIN,16,10,6,9.5,26,41.5,FALSE,0,0,"",3.5,15.5
2005,4,reg,Jacksonville Jaguars,Denver Broncos,JAX,7,20,13,4,27,37.5,FALSE,0,0,"",9,10.5
2005,4,reg,Kansas City Chiefs,Philadelphia Eagles,KC,31,37,6,2.5,68,46.5,FALSE,0,0,"",3.5,21.5
2005,4,reg,New England Patriots,San Diego Chargers,NE,17,41,24,5.5,58,47,FALSE,0,0,"",18.5,11
2005,4,reg,New Orleans Saints,Buffalo Bills,BUF,19,7,12,1,26,38.5,TRUE,1,0,DOME,11,12.5
2005,4,reg,New York Giants,St. Louis Rams,NYG,44,24,20,3,68,46,FALSE,0,0,"",17,22
2005,4,reg,Oakland Raiders,Dallas Cowboys,OAK,19,13,6,3,32,46,FALSE,0,0,"",3,14
2005,4,reg,Tampa Bay Buccaneers,Detroit Lions,TB,17,13,4,6.5,30,35,FALSE,0,0,"",2.5,5
2005,4,reg,Tennessee Titans,Indianapolis Colts,IND,10,31,21,7,41,45,FALSE,0,0,"",14,4
2005,4,reg,Washington Redskins,Seattle Seahawks,WAS,20,17,3,2,37,37,FALSE,0,0,"",1,0
2005,4,reg,Carolina Panthers,Green Bay Packers,CAR,32,29,3,3,61,43,FALSE,0,0,"",0,18
2005,5,reg,Arizona Cardinals,Carolina Panthers,CAR,20,24,4,3,44,42,FALSE,0,0,"",1,2
2005,5,reg,Atlanta Falcons,New England Patriots,ATL,28,31,3,2.5,59,43.5,FALSE,1,0,DOME,0.5,15.5
2005,5,reg,Buffalo Bills,Miami Dolphins,BUF,20,14,6,2.5,34,33,FALSE,0,0,"",3.5,1
2005,5,reg,Cleveland Browns,Chicago Bears,CLE,20,10,10,3,30,35,FALSE,0,0,"",7,5
2005,5,reg,Dallas Cowboys,Philadelphia Eagles,PHI,33,10,23,3.5,43,44,FALSE,0,0,"",19.5,1
2005,5,reg,Denver Broncos,Washington Redskins,DEN,21,19,2,7,40,34.5,FALSE,0,0,"",5,5.5
2005,5,reg,Detroit Lions,Baltimore Ravens,DET,35,17,18,2,52,33,FALSE,1,0,DOME,16,19
2005,5,reg,Green Bay Packers,New Orleans Saints,GB,52,3,49,3,55,41,FALSE,0,0,"",46,14
2005,5,reg,Houston Texans,Tennessee Titans,HOU,20,34,14,1.5,54,40.5,FALSE,1,0,DOME,12.5,13.5
2005,5,reg,Jacksonville Jaguars,Cincinnati Bengals,JAX,23,20,3,3,43,38,FALSE,0,0,"",0,5
2005,5,reg,New York Jets,Tampa Bay Buccaneers,TB,14,12,2,3.5,26,32,FALSE,0,0,"",1.5,6
2005,5,reg,San Francisco 49ers,Indianapolis Colts,IND,3,28,25,14,31,47,FALSE,0,0,"",11,16
2005,5,reg,St. Louis Rams,Seattle Seahawks,LAR,31,37,6,3,68,48,FALSE,1,0,DOME,3,20
2005,5,reg,San Diego Chargers,Pittsburgh Steelers,LAC,22,24,2,3,46,45.5,FALSE,0,0,"",1,0.5
2005,6,reg,Baltimore Ravens,Cleveland Browns,BAL,16,3,13,4,19,33.5,FALSE,0,0,"",9,14.5
2005,6,reg,Buffalo Bills,New York Jets,BUF,27,17,10,3,44,33,FALSE,0,0,"",7,11
2005,6,reg,Chicago Bears,Minnesota Vikings,CHI,28,3,25,2,31,37.5,FALSE,0,0,"",23,6.5
2005,6,reg,Dallas Cowboys,New York Giants,DAL,16,13,3,3.5,29,45.5,FALSE,0,0,"",0.5,16.5
2005,6,reg,Denver Broncos,New England Patriots,DEN,28,20,8,3,48,44,FALSE,0,0,"",5,4
2005,6,reg,Detroit Lions,Carolina Panthers,PICK,20,21,1,0,41,42,FALSE,1,0,DOME,1,1
2005,6,reg,Kansas City Chiefs,Washington Redskins,KC,28,21,7,6.5,49,42.5,FALSE,0,0,"",0.5,6.5
2005,6,reg,New Orleans Saints,Atlanta Falcons,ATL,31,34,3,4,65,42,TRUE,1,0,DOME,1,23
2005,6,reg,Oakland Raiders,San Diego Chargers,PICK,14,27,13,0,41,50.5,FALSE,0,0,"",13,9.5
2005,6,reg,Pittsburgh Steelers,Jacksonville Jaguars,PIT,17,23,6,5,40,36,FALSE,0,0,"",1,4
2005,6,reg,Seattle Seahawks,Houston Texans,SEA,42,10,32,8.5,52,45.5,FALSE,0,0,"",23.5,6.5
2005,6,reg,Tampa Bay Buccaneers,Miami Dolphins,TB,27,13,14,4.5,40,33,FALSE,0,0,"",9.5,7
2005,6,reg,Tennessee Titans,Cincinnati Bengals,CIN,23,31,8,3,54,44.5,FALSE,0,0,"",5,9.5
2005,6,reg,Indianapolis Colts,St. Louis Rams,IND,45,28,17,13,73,50.5,FALSE,1,0,DOME,4,22.5
2005,7,reg,Miami Dolphins,Kansas City Chiefs,KC,20,30,10,1,50,42.5,FALSE,0,0,"",9,7.5
2005,7,reg,Arizona Cardinals,Tennessee Titans,ARI,20,10,10,3,30,45,FALSE,0,0,"",7,15
2005,7,reg,Chicago Bears,Baltimore Ravens,CHI,10,6,4,1,16,32,FALSE,0,0,"",3,16
2005,7,reg,Cincinnati Bengals,Pittsburgh Steelers,CIN,13,27,14,3,40,43,FALSE,0,0,"",11,3
2005,7,reg,Cleveland Browns,Detroit Lions,CLE,10,13,3,3,23,36,FALSE,0,0,"",0,13
2005,7,reg,Houston Texans,Indianapolis Colts,IND,20,38,18,14.5,58,44.5,FALSE,1,0,DOME,3.5,13.5
2005,7,reg,Minnesota Vikings,Green Bay Packers,MIN,23,20,3,2,43,46,FALSE,1,0,DOME,1,3
2005,7,reg,New York Giants,Denver Broncos,NYG,24,23,1,2,47,46.5,FALSE,0,0,"",1,0.5
2005,7,reg,Oakland Raiders,Buffalo Bills,OAK,38,17,21,3,55,42,FALSE,0,0,"",18,13
2005,7,reg,Philadelphia Eagles,San Diego Chargers,PHI,20,17,3,4,37,47,FALSE,0,0,"",1,10
2005,7,reg,Seattle Seahawks,Dallas Cowboys,SEA,13,10,3,3,23,45.5,FALSE,0,0,"",0,22.5
2005,7,reg,St. Louis Rams,New Orleans Saints,LAR,28,17,11,5,45,50,FALSE,1,0,DOME,6,5
2005,7,reg,Washington Redskins,San Francisco 49ers,WAS,52,17,35,11.5,69,38,FALSE,0,0,"",23.5,31
2005,7,reg,Atlanta Falcons,New York Jets,ATL,27,14,13,7.5,41,41,FALSE,1,0,DOME,5.5,0
2005,8,reg,Carolina Panthers,Minnesota Vikings,CAR,38,13,25,8,51,44,FALSE,0,0,"",17,7
2005,8,reg,Cincinnati Bengals,Green Bay Packers,CIN,21,14,7,7,35,46,FALSE,0,0,"",0,11
2005,8,reg,Dallas Cowboys,Arizona Cardinals,DAL,34,13,21,7,47,41,FALSE,0,0,"",14,6
2005,8,reg,Denver Broncos,Philadelphia Eagles,DEN,49,21,28,3,70,44,FALSE,0,0,"",25,26
2005,8,reg,Detroit Lions,Chicago Bears,DET,13,19,6,3,32,32.5,FALSE,1,0,DOME,3,0.5
2005,8,reg,Houston Texans,Cleveland Browns,HOU,19,16,3,2,35,37.5,FALSE,1,0,DOME,1,2.5
2005,8,reg,New England Patriots,Buffalo Bills,NE,21,16,5,7,37,43.5,FALSE,0,0,"",2,6.5
2005,8,reg,New Orleans Saints,Miami Dolphins,NO,6,21,15,2,27,41,FALSE,0,0,"",13,14
2005,8,reg,New York Giants,Washington Redskins,NYG,36,0,36,3,36,41,FALSE,0,0,"",33,5
2005,8,reg,San Diego Chargers,Kansas City Chiefs,LAC,28,20,8,5,48,51,FALSE,0,0,"",3,3
2005,8,reg,San Francisco 49ers,Tampa Bay Buccaneers,TB,15,10,5,11.5,25,37,FALSE,0,0,"",6.5,12
2005,8,reg,St. Louis Rams,Jacksonville Jaguars,JAX,24,21,3,3,45,43,FALSE,1,0,DOME,0,2
2005,8,reg,Tennessee Titans,Oakland Raiders,OAK,25,34,9,2,59,46,FALSE,0,0,"",7,13
2005,8,reg,Pittsburgh Steelers,Baltimore Ravens,PIT,20,19,1,8.5,39,33,FALSE,0,0,"",7.5,6
2005,9,reg,Arizona Cardinals,Seattle Seahawks,SEA,19,33,14,4.5,52,44,FALSE,0,0,"",9.5,8
2005,9,reg,Baltimore Ravens,Cincinnati Bengals,CIN,9,21,12,3.5,30,36,FALSE,0,0,"",8.5,6
2005,9,reg,Cleveland Browns,Tennessee Titans,CLE,20,14,6,3,34,39,FALSE,0,0,"",3,5
2005,9,reg,Green Bay Packers,Pittsburgh Steelers,PIT,10,20,10,6.5,30,42,FALSE,0,0,"",3.5,12
2005,9,reg,Jacksonville Jaguars,Houston Texans,JAX,21,14,7,11,35,37.5,FALSE,0,0,"",4,2.5
2005,9,reg,Kansas City Chiefs,Oakland Raiders,KC,27,23,4,4.5,50,51.5,FALSE,0,0,"",0.5,1.5
2005,9,reg,Miami Dolphins,Atlanta Falcons,ATL,10,17,7,2,27,39.5,FALSE,0,0,"",5,12.5
2005,9,reg,Minnesota Vikings,Detroit Lions,DET,27,14,13,1.5,41,37.5,FALSE,1,0,DOME,11.5,3.5
2005,9,reg,New Orleans Saints,Chicago Bears,CHI,17,20,3,2.5,37,34.5,FALSE,0,0,"",0.5,2.5
2005,9,reg,New York Jets,San Diego Chargers,LAC,26,31,5,5.5,57,41.5,FALSE,0,0,"",0.5,15.5
2005,9,reg,San Francisco 49ers,New York Giants,NYG,6,24,18,9.5,30,42,FALSE,0,0,"",8.5,12
2005,9,reg,Tampa Bay Buccaneers,Carolina Panthers,PICK,14,34,20,0,48,36.5,FALSE,0,0,"",20,11.5
2005,9,reg,Washington Redskins,Philadelphia Eagles,PICK,17,10,7,0,27,41,FALSE,0,0,"",7,14
2005,9,reg,New England Patriots,Indianapolis Colts,IND,21,40,19,3,61,46.5,FALSE,0,0,"",16,14.5
2005,10,reg,Atlanta Falcons,Green Bay Packers,ATL,25,33,8,9.5,58,42,FALSE,1,0,DOME,1.5,16
2005,10,reg,Buffalo Bills,Kansas City Chiefs,BUF,14,3,11,2.5,17,42.5,FALSE,0,0,"",8.5,25.5
2005,10,reg,Carolina Panthers,New York Jets,CAR,30,3,27,9.5,33,40.5,FALSE,0,0,"",17.5,7.5
2005,10,reg,Chicago Bears,San Francisco 49ers,CHI,17,9,8,12,26,33,FALSE,0,0,"",4,7
2005,10,reg,Detroit Lions,Arizona Cardinals,DET,29,21,8,4,50,40,FALSE,1,0,DOME,4,10
2005,10,reg,Indianapolis Colts,Houston Texans,IND,31,17,14,17,48,45,FALSE,1,0,DOME,3,3
2005,10,reg,Jacksonville Jaguars,Baltimore Ravens,JAX,30,3,27,8,33,34,FALSE,0,0,"",19,1
2005,10,reg,Miami Dolphins,New England Patriots,NE,16,23,7,2.5,39,40,FALSE,0,0,"",4.5,1
2005,10,reg,New York Giants,Minnesota Vikings,NYG,21,24,3,10,45,45,FALSE,0,0,"",7,0
2005,10,reg,Oakland Raiders,Denver Broncos,DEN,17,31,14,2.5,48,47,FALSE,0,0,"",11.5,1
2005,10,reg,Pittsburgh Steelers,Cleveland Browns,PIT,34,21,13,7.5,55,34.5,FALSE,0,0,"",5.5,20.5
2005,10,reg,Seattle Seahawks,St. Louis Rams,SEA,31,16,15,7,47,48.5,FALSE,0,0,"",8,1.5
2005,10,reg,Tampa Bay Buccaneers,Washington Redskins,WAS,36,35,1,1,71,34,FALSE,0,0,"",0,37
2005,10,reg,Philadelphia Eagles,Dallas Cowboys,PHI,20,21,1,3,41,40,FALSE,0,0,"",2,1
2005,11,reg,Atlanta Falcons,Tampa Bay Buccaneers,ATL,27,30,3,6,57,38,FALSE,1,0,DOME,3,19
2005,11,reg,Baltimore Ravens,Pittsburgh Steelers,PIT,16,13,3,4,29,34.5,FALSE,0,0,"",1,5.5
2005,11,reg,Chicago Bears,Carolina Panthers,CAR,13,3,10,3,16,34.5,FALSE,0,0,"",7,18.5
2005,11,reg,Cincinnati Bengals,Indianapolis Colts,IND,37,45,8,4.5,82,48.5,FALSE,0,0,"",3.5,33.5
2005,11,reg,Cleveland Browns,Miami Dolphins,CLE,22,0,22,2.5,22,34.5,FALSE,0,0,"",19.5,12.5
2005,11,reg,Dallas Cowboys,Detroit Lions,DAL,20,7,13,8,27,39,FALSE,0,0,"",5,12
2005,11,reg,Denver Broncos,New York Jets,DEN,27,0,27,13,27,41,FALSE,0,0,"",14,14
2005,11,reg,Houston Texans,Kansas City Chiefs,KC,17,45,28,6.5,62,44.5,FALSE,1,0,DOME,21.5,17.5
2005,11,reg,New England Patriots,New Orleans Saints,NE,24,17,7,10,41,45,FALSE,0,0,"",3,4
2005,11,reg,New York Giants,Philadelphia Eagles,NYG,27,17,10,3.5,44,43,FALSE,0,0,"",6.5,1
2005,11,reg,San Diego Chargers,Buffalo Bills,LAC,48,10,38,9,58,42,FALSE,0,0,"",29,16
2005,11,reg,San Francisco 49ers,Seattle Seahawks,SEA,25,27,2,12,52,42.5,FALSE,0,0,"",10,9.5
2005,11,reg,St. Louis Rams,Arizona Cardinals,LAR,28,38,10,9,66,48,FALSE,1,0,DOME,1,18
2005,11,reg,Tennessee Titans,Jacksonville Jaguars,JAX,28,31,3,4,59,38,FALSE,0,0,"",1,21
2005,11,reg,Washington Redskins,Oakland Raiders,WAS,13,16,3,6,29,42,FALSE,0,0,"",3,13
2005,11,reg,Green Bay Packers,Minnesota Vikings,GB,17,20,3,3.5,37,45,FALSE,0,0,"",0.5,8
2005,12,reg,Dallas Cowboys,Denver Broncos,DAL,21,24,3,1.5,45,41,FALSE,0,0,"",1.5,4
2005,12,reg,Detroit Lions,Atlanta Falcons,ATL,7,27,20,3,34,40.5,FALSE,1,0,DOME,17,6.5
2005,12,reg,Arizona Cardinals,Jacksonville Jaguars,JAX,17,24,7,3.5,41,41.5,FALSE,0,0,"",3.5,0.5
2005,12,reg,Buffalo Bills,Carolina Panthers,CAR,9,13,4,4,22,36.5,FALSE,0,0,"",0,14.5
2005,12,reg,Cincinnati Bengals,Baltimore Ravens,CIN,42,29,13,9,71,36.5,FALSE,0,0,"",4,34.5
2005,12,reg,Houston Texans,St. Louis Rams,LAR,27,33,6,3.5,60,44.5,FALSE,1,0,DOME,2.5,15.5
2005,12,reg,Kansas City Chiefs,New England Patriots,KC,26,16,10,3,42,51,FALSE,0,0,"",7,9
2005,12,reg,Minnesota Vikings,Cleveland Browns,MIN,24,12,12,3.5,36,40,FALSE,1,0,DOME,8.5,4
2005,12,reg,New York Jets,New Orleans Saints,NO,19,21,2,1,40,37,FALSE,0,0,"",1,3
2005,12,reg,Oakland Raiders,Miami Dolphins,OAK,21,33,12,7,54,42.5,FALSE,0,0,"",5,11.5
2005,12,reg,Philadelphia Eagles,Green Bay Packers,PHI,19,14,5,3.5,33,41.5,FALSE,0,0,"",1.5,8.5
2005,12,reg,Seattle Seahawks,New York Giants,SEA,24,21,3,5.5,45,47.5,FALSE,0,0,"",2.5,2.5
2005,12,reg,Tampa Bay Buccaneers,Chicago Bears,TB,10,13,3,3,23,33,FALSE,0,0,"",0,10
2005,12,reg,Tennessee Titans,San Francisco 49ers,TEN,33,22,11,7,55,42.5,FALSE,0,0,"",4,12.5
2005,12,reg,Washington Redskins,San Diego Chargers,LAC,17,23,6,3,40,44,FALSE,0,0,"",3,4
2005,12,reg,Indianapolis Colts,Pittsburgh Steelers,IND,26,7,19,8,33,47,FALSE,1,0,DOME,11,14
2005,13,reg,Baltimore Ravens,Houston Texans,BAL,16,15,1,7,31,37,FALSE,0,0,"",6,6
2005,13,reg,Carolina Panthers,Atlanta Falcons,CAR,24,6,18,3,30,43.5,FALSE,0,0,"",15,13.5
2005,13,reg,Chicago Bears,Green Bay Packers,CHI,19,7,12,7,26,32,FALSE,0,0,"",5,6
2005,13,reg,Cleveland Browns,Jacksonville Jaguars,JAX,14,20,6,3,34,36.5,FALSE,0,0,"",3,2.5
2005,13,reg,Detroit Lions,Minnesota Vikings,MIN,16,21,5,3,37,38,FALSE,1,0,DOME,2,1
2005,13,reg,Indianapolis Colts,Tennessee Titans,IND,35,3,32,14,38,47.5,FALSE,1,0,DOME,18,9.5
2005,13,reg,Kansas City Chiefs,Denver Broncos,PICK,31,27,4,0,58,47,FALSE,0,0,"",4,11
2005,13,reg,Miami Dolphins,Buffalo Bills,MIA,24,23,1,3,47,35.5,FALSE,0,0,"",2,11.5
2005,13,reg,New England Patriots,New York Jets,NE,16,3,13,7.5,19,42.5,FALSE,0,0,"",5.5,23.5
2005,13,reg,New Orleans Saints,Tampa Bay Buccaneers,TB,3,10,7,3.5,13,39,FALSE,0,0,"",3.5,26
2005,13,reg,New York Giants,Dallas Cowboys,NYG,17,10,7,3,27,41,FALSE,0,0,"",4,14
2005,13,reg,Pittsburgh Steelers,Cincinnati Bengals,PIT,31,38,7,4,69,43,FALSE,0,0,"",3,26
2005,13,reg,San Diego Chargers,Oakland Raiders,LAC,34,10,24,10,44,50.5,FALSE,0,0,"",14,6.5
2005,13,reg,San Francisco 49ers,Arizona Cardinals,ARI,10,17,7,3,27,43.5,FALSE,0,0,"",4,16.5
2005,13,reg,St. Louis Rams,Washington Redskins,WAS,9,24,15,3,33,45,FALSE,1,0,DOME,12,12
2005,13,reg,Philadelphia Eagles,Seattle Seahawks,SEA,0,42,42,3,42,44,FALSE,0,0,"",39,2
2005,14,reg,Arizona Cardinals,Washington Redskins,WAS,13,17,4,3,30,41.5,FALSE,0,0,"",1,11.5
2005,14,reg,Buffalo Bills,New England Patriots,NE,7,35,28,3.5,42,38,FALSE,0,0,"",24.5,4
2005,14,reg,Carolina Panthers,Tampa Bay Buccaneers,CAR,10,20,10,5.5,30,37,FALSE,0,0,"",4.5,7
2005,14,reg,Cincinnati Bengals,Cleveland Browns,CIN,23,20,3,12.5,43,41.5,FALSE,0,0,"",9.5,1.5
2005,14,reg,Dallas Cowboys,Kansas City Chiefs,DAL,31,28,3,3,59,44,FALSE,0,0,"",0,15
2005,14,reg,Denver Broncos,Baltimore Ravens,DEN,12,10,2,14,22,40.5,FALSE,0,0,"",12,18.5
2005,14,reg,Green Bay Packers,Detroit Lions,GB,16,13,3,5.5,29,37,FALSE,0,0,"",2.5,8
2005,14,reg,Jacksonville Jaguars,Indianapolis Colts,IND,18,26,8,7.5,44,43,FALSE,0,0,"",0.5,1
2005,14,reg,Minnesota Vikings,St. Louis Rams,MIN,27,13,14,7,40,45.5,FALSE,1,0,DOME,7,5.5
2005,14,reg,New York Jets,Oakland Raiders,OAK,26,10,16,3,36,37.5,FALSE,0,0,"",13,1.5
2005,14,reg,Philadelphia Eagles,New York Giants,NYG,23,26,3,3,49,40,FALSE,0,0,"",0,9
2005,14,reg,Pittsburgh Steelers,Chicago Bears,PIT,21,9,12,4,30,32,FALSE,0,0,"",8,2
2005,14,reg,San Diego Chargers,Miami Dolphins,LAC,21,23,2,13.5,44,45,FALSE,0,0,"",11.5,1
2005,14,reg,Seattle Seahawks,San Francisco 49ers,SEA,41,3,38,15.5,44,45,FALSE,0,0,"",22.5,1
2005,14,reg,Tennessee Titans,Houston Texans,TEN,13,10,3,6.5,23,44,FALSE,0,0,"",3.5,21
2005,14,reg,Atlanta Falcons,New Orleans Saints,ATL,36,17,19,10,53,44,FALSE,1,0,DOME,9,9
2005,15,reg,Buffalo Bills,Denver Broncos,DEN,17,28,11,8,45,35,FALSE,0,0,"",3,10
2005,15,reg,New England Patriots,Tampa Bay Buccaneers,NE,28,0,28,4.5,28,36,FALSE,0,0,"",23.5,8
2005,15,reg,New York Giants,Kansas City Chiefs,NYG,27,17,10,3,44,45.5,FALSE,0,0,"",7,1.5
2005,15,reg,Chicago Bears,Atlanta Falcons,CHI,16,3,13,3,19,30.5,FALSE,0,0,"",10,11.5
2005,15,reg,Detroit Lions,Cincinnati Bengals,CIN,17,41,24,7.5,58,44,FALSE,1,0,DOME,16.5,14
2005,15,reg,Houston Texans,Arizona Cardinals,ARI,30,19,11,1,49,43.5,FALSE,1,0,DOME,10,5.5
2005,15,reg,Indianapolis Colts,San Diego Chargers,IND,17,26,9,7.5,43,51,FALSE,1,0,DOME,1.5,8
2005,15,reg,Jacksonville Jaguars,San Francisco 49ers,JAX,10,9,1,14.5,19,39.5,FALSE,0,0,"",13.5,20.5
2005,15,reg,Miami Dolphins,New York Jets,MIA,24,20,4,7.5,44,35.5,FALSE,0,0,"",3.5,8.5
2005,15,reg,Minnesota Vikings,Pittsburgh Steelers,PIT,3,18,15,3,21,41.5,FALSE,1,0,DOME,12,20.5
2005,15,reg,New Orleans Saints,Carolina Panthers,CAR,10,27,17,7,37,40.5,FALSE,0,0,"",10,3.5
2005,15,reg,Oakland Raiders,Cleveland Browns,OAK,7,9,2,3,16,40.5,FALSE,0,0,"",1,24.5
2005,15,reg,St. Louis Rams,Philadelphia Eagles,LAR,16,17,1,3,33,44,FALSE,1,0,DOME,2,11
2005,15,reg,Tennessee Titans,Seattle Seahawks,SEA,24,28,4,7.5,52,45,FALSE,0,0,"",3.5,7
2005,15,reg,Washington Redskins,Dallas Cowboys,WAS,35,7,28,3,42,36,FALSE,0,0,"",25,6
2005,15,reg,Baltimore Ravens,Green Bay Packers,BAL,48,3,45,3.5,51,33,FALSE,0,0,"",41.5,18
2005,16,reg,Arizona Cardinals,Philadelphia Eagles,ARI,27,21,6,1,48,39.5,FALSE,0,0,"",5,8.5
2005,16,reg,Carolina Panthers,Dallas Cowboys,CAR,20,24,4,5.5,44,38.5,FALSE,0,0,"",1.5,5.5
2005,16,reg,Cincinnati Bengals,Buffalo Bills,CIN,27,37,10,13,64,44,FALSE,0,0,"",3,20
2005,16,reg,Cleveland Browns,Pittsburgh Steelers,PIT,0,41,41,7,41,33,FALSE,0,0,"",34,8
2005,16,reg,Denver Broncos,Oakland Raiders,DEN,22,3,19,12.5,25,42.5,FALSE,0,0,"",6.5,17.5
2005,16,reg,Houston Texans,Jacksonville Jaguars,JAX,20,38,18,6,58,38,FALSE,1,0,DOME,12,20
2005,16,reg,Kansas City Chiefs,San Diego Chargers,KC,20,7,13,1,27,49.5,FALSE,0,0,"",12,22.5
2005,16,reg,Miami Dolphins,Tennessee Titans,MIA,24,10,14,5.5,34,43,FALSE,0,0,"",8.5,9
2005,16,reg,New Orleans Saints,Detroit Lions,NO,12,13,1,3,25,37.5,TRUE,1,0,DOME,2,12.5
2005,16,reg,Seattle Seahawks,Indianapolis Colts,SEA,28,13,15,7,41,47,FALSE,0,0,"",8,6
2005,16,reg,St. Louis Rams,San Francisco 49ers,LAR,20,24,4,9,44,42,FALSE,1,0,DOME,5,2
2005,16,reg,Tampa Bay Buccaneers,Atlanta Falcons,TB,27,24,3,3,51,37.5,FALSE,0,0,"",0,13.5
2005,16,reg,Washington Redskins,New York Giants,WAS,35,20,15,3,55,38,FALSE,0,0,"",12,17
2005,16,reg,Baltimore Ravens,Minnesota Vikings,BAL,30,23,7,2.5,53,34,FALSE,0,0,"",4.5,19
2005,16,reg,Green Bay Packers,Chicago Bears,CHI,17,24,7,7,41,31,FALSE,0,0,"",0,10
2005,16,reg,New York Jets,New England Patriots,NE,21,31,10,4,52,37.5,FALSE,0,0,"",6,14.5
2005,17,reg,Oakland Raiders,New York Giants,NYG,21,30,9,7.5,51,44,FALSE,0,0,"",1.5,7
2005,17,reg,San Diego Chargers,Denver Broncos,LAC,7,23,16,7,30,44,FALSE,0,0,"",9,14
2005,17,reg,Atlanta Falcons,Carolina Panthers,CAR,11,44,33,3.5,55,42,FALSE,1,0,DOME,29.5,13
2005,17,reg,Cleveland Browns,Baltimore Ravens,BAL,20,16,4,3,36,37,FALSE,0,0,"",1,1
2005,17,reg,Dallas Cowboys,St. Louis Rams,DAL,10,20,10,12.5,30,43,FALSE,0,0,"",2.5,13
2005,17,reg,Green Bay Packers,Seattle Seahawks,GB,23,17,6,3,40,40.5,FALSE,0,0,"",3,0.5
2005,17,reg,Indianapolis Colts,Arizona Cardinals,IND,17,13,4,6,30,43.5,FALSE,1,0,DOME,2,13.5
2005,17,reg,Jacksonville Jaguars,Tennessee Titans,JAX,40,13,27,4,53,38,FALSE,0,0,"",23,15
2005,17,reg,Kansas City Chiefs,Cincinnati Bengals,KC,37,3,34,7.5,40,47,FALSE,0,0,"",26.5,7
2005,17,reg,Minnesota Vikings,Chicago Bears,MIN,34,10,24,3,44,35,FALSE,1,0,DOME,21,9
2005,17,reg,New England Patriots,Miami Dolphins,NE,26,28,2,3,54,37,FALSE,0,0,"",1,17
2005,17,reg,New York Jets,Buffalo Bills,NYJ,30,26,4,1.5,56,37.5,FALSE,0,0,"",2.5,18.5
2005,17,reg,Philadelphia Eagles,Washington Redskins,WAS,20,31,11,7,51,37,FALSE,0,0,"",4,14
2005,17,reg,Pittsburgh Steelers,Detroit Lions,PIT,35,21,14,15.5,56,35.5,FALSE,0,0,"",1.5,20.5
2005,17,reg,San Francisco 49ers,Houston Texans,HOU,20,17,3,1,37,37.5,FALSE,0,0,"",2,0.5
2005,17,reg,Tampa Bay Buccaneers,New Orleans Saints,TB,27,13,14,13,40,37.5,FALSE,0,0,"",1,2.5
2005,Wildcard,post,New England Patriots,Jacksonville Jaguars,NE,28,3,25,8,31,37.5,FALSE,0,0,"",17,6.5
2005,Wildcard,post,Tampa Bay Buccaneers,Washington Redskins,TB,10,17,7,2.5,27,37.5,FALSE,0,0,"",4.5,10.5
2005,Wildcard,post,Cincinnati Bengals,Pittsburgh Steelers,PIT,17,31,14,3,48,44,FALSE,0,0,"",11,4
2005,Wildcard,post,New York Giants,Carolina Panthers,NYG,0,23,23,3,23,43.5,FALSE,0,0,"",20,20.5
2005,Division,post,Denver Broncos,New England Patriots,DEN,27,13,14,3,40,44,FALSE,0,0,"",11,4
2005,Division,post,Seattle Seahawks,Washington Redskins,SEA,20,10,10,8.5,30,41,FALSE,0,0,"",1.5,11
2005,Division,post,Chicago Bears,Carolina Panthers,CHI,21,29,8,3,50,31,FALSE,0,0,"",5,19
2005,Division,post,Indianapolis Colts,Pittsburgh Steelers,IND,18,21,3,8.5,39,46.5,FALSE,1,0,DOME,5.5,7.5
2005,Conference,post,Denver Broncos,Pittsburgh Steelers,DEN,17,34,17,3.5,51,41,FALSE,0,0,"",13.5,10
2005,Conference,post,Seattle Seahawks,Carolina Panthers,SEA,34,14,20,5.5,48,43,FALSE,0,0,"",14.5,5
2005,Superbowl,post,Pittsburgh Steelers,Seattle Seahawks,PIT,21,10,11,4,31,47,TRUE,1,0,DOME,7,16
2006,1,reg,Pittsburgh Steelers,Miami Dolphins,PIT,28,17,11,1.5,45,34.5,FALSE,0,0,"",9.5,10.5
2006,1,reg,Arizona Cardinals,San Francisco 49ers,ARI,34,27,7,9.5,61,44,FALSE,1,0,DOME,2.5,17
2006,1,reg,Carolina Panthers,Atlanta Falcons,CAR,6,20,14,4.5,26,39,FALSE,0,0,"",9.5,13
2006,1,reg,Cleveland Browns,New Orleans Saints,CLE,14,19,5,3,33,36,FALSE,0,0,"",2,3
2006,1,reg,Detroit Lions,Seattle Seahawks,SEA,6,9,3,6,15,44,FALSE,1,0,DOME,3,29
2006,1,reg,Green Bay Packers,Chicago Bears,CHI,0,26,26,3.5,26,35,FALSE,0,0,"",22.5,9
2006,1,reg,Houston Texans,Philadelphia Eagles,PHI,10,24,14,6,34,37,FALSE,1,0,DOME,8,3
2006,1,reg,Jacksonville Jaguars,Dallas Cowboys,DAL,24,17,7,2.5,41,36.5,FALSE,0,0,"",4.5,4.5
2006,1,reg,Kansas City Chiefs,Cincinnati Bengals,CIN,10,23,13,1.5,33,49.5,FALSE,0,0,"",11.5,16.5
2006,1,reg,New England Patriots,Buffalo Bills,NE,19,17,2,10,36,41,FALSE,0,0,"",8,5
2006,1,reg,New York Giants,Indianapolis Colts,IND,21,26,5,3,47,47.5,FALSE,0,0,"",2,0.5
2006,1,reg,St. Louis Rams,Denver Broncos,DEN,18,10,8,3.5,28,46,FALSE,1,0,DOME,4.5,18
2006,1,reg,Tampa Bay Buccaneers,Baltimore Ravens,TB,0,27,27,3,27,33,FALSE,0,0,"",24,6
2006,1,reg,Tennessee Titans,New York Jets,TEN,16,23,7,2.5,39,35,FALSE,0,0,"",4.5,4
2006,1,reg,Oakland Raiders,San Diego Chargers,LAC,0,27,27,3,27,41.5,FALSE,0,0,"",24,14.5
2006,1,reg,Washington Redskins,Minnesota Vikings,WAS,16,19,3,4,35,35.5,FALSE,0,0,"",1,0.5
2006,2,reg,Atlanta Falcons,Tampa Bay Buccaneers,ATL,14,3,11,4.5,17,36,FALSE,1,0,DOME,6.5,19
2006,2,reg,Baltimore Ravens,Oakland Raiders,BAL,28,6,22,13,34,34,FALSE,0,0,"",9,0
2006,2,reg,Chicago Bears,Detroit Lions,CHI,34,7,27,7,41,32,FALSE,0,0,"",20,9
2006,2,reg,Cincinnati Bengals,Cleveland Browns,CIN,34,17,17,10.5,51,40.5,FALSE,0,0,"",6.5,10.5
2006,2,reg,Dallas Cowboys,Washington Redskins,DAL,27,10,17,7,37,37,FALSE,0,0,"",10,0
2006,2,reg,Denver Broncos,Kansas City Chiefs,DEN,9,6,3,11,15,38,FALSE,0,0,"",8,23
2006,2,reg,Green Bay Packers,New Orleans Saints,NO,27,34,7,1,61,40.5,FALSE,0,0,"",6,20.5
2006,2,reg,Indianapolis Colts,Houston Texans,IND,43,24,19,12.5,67,47,FALSE,1,0,DOME,6.5,20
2006,2,reg,Miami Dolphins,Buffalo Bills,MIA,6,16,10,6.5,22,37,FALSE,0,0,"",3.5,15
2006,2,reg,Minnesota Vikings,Carolina Panthers,MIN,16,13,3,2,29,37.5,FALSE,1,0,DOME,1,8.5
2006,2,reg,New York Jets,New England Patriots,NE,17,24,7,6,41,38.5,FALSE,0,0,"",1,2.5
2006,2,reg,Philadelphia Eagles,New York Giants,PHI,24,30,6,3,54,42,FALSE,0,0,"",3,12
2006,2,reg,San Diego Chargers,Tennessee Titans,LAC,40,7,33,12,47,38.5,FALSE,0,0,"",21,8.5
2006,2,reg,San Francisco 49ers,St. Louis Rams,LAR,20,13,7,3,33,44.5,FALSE,0,0,"",4,11.5
2006,2,reg,Seattle Seahawks,Arizona Cardinals,SEA,21,10,11,7,31,48,FALSE,0,0,"",4,17
2006,2,reg,Jacksonville Jaguars,Pittsburgh Steelers,PIT,9,0,9,2.5,9,36.5,FALSE,0,0,"",6.5,27.5
2006,3,reg,Arizona Cardinals,St. Louis Rams,ARI,14,16,2,5.5,30,45,FALSE,1,0,DOME,3.5,15
2006,3,reg,Buffalo Bills,New York Jets,BUF,20,28,8,6,48,33,FALSE,0,0,"",2,15
2006,3,reg,Cleveland Browns,Baltimore Ravens,BAL,14,15,1,6.5,29,33,FALSE,0,0,"",5.5,4
2006,3,reg,Detroit Lions,Green Bay Packers,DET,24,31,7,6.5,55,41,FALSE,1,0,DOME,0.5,14
2006,3,reg,Houston Texans,Washington Redskins,WAS,15,31,16,3.5,46,37.5,FALSE,1,0,DOME,12.5,8.5
2006,3,reg,Indianapolis Colts,Jacksonville Jaguars,IND,21,14,7,6.5,35,41.5,FALSE,1,0,DOME,0.5,6.5
2006,3,reg,Miami Dolphins,Tennessee Titans,MIA,13,10,3,10.5,23,36,FALSE,0,0,"",7.5,13
2006,3,reg,Minnesota Vikings,Chicago Bears,CHI,16,19,3,3.5,35,35,FALSE,1,0,DOME,0.5,0
2006,3,reg,New England Patriots,Denver Broncos,NE,7,17,10,6.5,24,38.5,FALSE,0,0,"",3.5,14.5
2006,3,reg,Pittsburgh Steelers,Cincinnati Bengals,PIT,20,28,8,2,48,42,FALSE,0,0,"",6,6
2006,3,reg,San Francisco 49ers,Philadelphia Eagles,PHI,24,38,14,6,62,42.5,FALSE,0,0,"",8,19.5
2006,3,reg,Seattle Seahawks,New York Giants,SEA,42,30,12,4,72,43,FALSE,0,0,"",8,29
2006,3,reg,Tampa Bay Buccaneers,Carolina Panthers,CAR,24,26,2,3,50,33.5,FALSE,0,0,"",1,16.5
2006,3,reg,New Orleans Saints,Atlanta Falcons,ATL,23,3,20,4,26,45,FALSE,1,0,DOME,16,19
2006,4,reg,Atlanta Falcons,Arizona Cardinals,ATL,32,10,22,7.5,42,42,FALSE,1,0,DOME,14.5,0
2006,4,reg,Baltimore Ravens,San Diego Chargers,LAC,16,13,3,1,29,33.5,FALSE,0,0,"",2,4.5
2006,4,reg,Buffalo Bills,Minnesota Vikings,BUF,17,12,5,1,29,34.5,FALSE,0,0,"",4,5.5
2006,4,reg,Carolina Panthers,New Orleans Saints,CAR,21,18,3,7.5,39,41,FALSE,0,0,"",4.5,2
2006,4,reg,Chicago Bears,Seattle Seahawks,CHI,37,6,31,3.5,43,37,FALSE,0,0,"",27.5,6
2006,4,reg,Cincinnati Bengals,New England Patriots,CIN,13,38,25,6,51,46,FALSE,0,0,"",19,5
2006,4,reg,Houston Texans,Miami Dolphins,MIA,17,15,2,4,32,40,FALSE,1,0,DOME,2,8
2006,4,reg,Kansas City Chiefs,San Francisco 49ers,KC,41,0,41,7,41,39.5,FALSE,0,0,"",34,1.5
2006,4,reg,New York Jets,Indianapolis Colts,IND,28,31,3,8,59,46,FALSE,0,0,"",5,13
2006,4,reg,Oakland Raiders,Cleveland Browns,CLE,21,24,3,2.5,45,33.5,FALSE,0,0,"",0.5,11.5
2006,4,reg,St. Louis Rams,Detroit Lions,LAR,41,34,7,5,75,42.5,FALSE,1,0,DOME,2,32.5
2006,4,reg,Tennessee Titans,Dallas Cowboys,DAL,14,45,31,9.5,59,37,FALSE,0,0,"",21.5,22
2006,4,reg,Washington Redskins,Jacksonville Jaguars,JAX,36,30,6,3,66,34,FALSE,0,0,"",3,32
2006,4,reg,Philadelphia Eagles,Green Bay Packers,PHI,31,9,22,11.5,40,49.5,FALSE,0,0,"",10.5,9.5
2006,5,reg,Arizona Cardinals,Kansas City Chiefs,KC,20,23,3,3.5,43,40,FALSE,1,0,DOME,0.5,3
2006,5,reg,Carolina Panthers,Cleveland Browns,CAR,20,12,8,7.5,32,38,FALSE,0,0,"",0.5,6
2006,5,reg,Chicago Bears,Buffalo Bills,CHI,40,7,33,9.5,47,34.5,FALSE,0,0,"",23.5,12.5
2006,5,reg,Green Bay Packers,St. Louis Rams,LAR,20,23,3,2.5,43,46.5,FALSE,0,0,"",0.5,3.5
2006,5,reg,Indianapolis Colts,Tennessee Titans,IND,14,13,1,18,27,47.5,FALSE,1,0,DOME,17,20.5
2006,5,reg,Jacksonville Jaguars,New York Jets,JAX,41,0,41,7,41,38,FALSE,0,0,"",34,3
2006,5,reg,Minnesota Vikings,Detroit Lions,MIN,26,17,9,6,43,41,FALSE,1,0,DOME,3,2
2006,5,reg,New England Patriots,Miami Dolphins,NE,20,10,10,9.5,30,36.5,FALSE,0,0,"",0.5,6.5
2006,5,reg,New Orleans Saints,Tampa Bay Buccaneers,NO,24,21,3,7,45,35,FALSE,1,0,DOME,4,10
2006,5,reg,New York Giants,Washington Redskins,NYG,19,3,16,5.5,22,45.5,FALSE,0,0,"",10.5,23.5
2006,5,reg,Philadelphia Eagles,Dallas Cowboys,PHI,38,24,14,2,62,43,FALSE,0,0,"",12,19
2006,5,reg,San Diego Chargers,Pittsburgh Steelers,LAC,23,13,10,3,36,37.5,FALSE,0,0,"",7,1.5
2006,5,reg,San Francisco 49ers,Oakland Raiders,SF,34,20,14,3.5,54,39.5,FALSE,0,0,"",10.5,14.5
2006,5,reg,Denver Broncos,Baltimore Ravens,DEN,13,3,10,5,16,33.5,FALSE,0,0,"",5,17.5
2006,6,reg,Atlanta Falcons,New York Giants,ATL,14,27,13,3,41,41.5,FALSE,1,0,DOME,10,0.5
2006,6,reg,Baltimore Ravens,Carolina Panthers,BAL,21,23,2,3,44,33,FALSE,0,0,"",1,11
2006,6,reg,Dallas Cowboys,Houston Texans,DAL,34,6,28,13,40,44,FALSE,0,0,"",15,4
2006,6,reg,Denver Broncos,Oakland Raiders,DEN,13,3,10,16,16,37,FALSE,0,0,"",6,21
2006,6,reg,Detroit Lions,Buffalo Bills,BUF,20,17,3,1,37,40.5,FALSE,1,0,DOME,2,3.5
2006,6,reg,New Orleans Saints,Philadelphia Eagles,PHI,27,24,3,3,51,47,FALSE,1,0,DOME,0,4
2006,6,reg,New York Jets,Miami Dolphins,NYJ,20,17,3,2.5,37,36.5,FALSE,0,0,"",0.5,0.5
2006,6,reg,Pittsburgh Steelers,Kansas City Chiefs,PIT,45,7,38,6.5,52,36.5,FALSE,0,0,"",31.5,15.5
2006,6,reg,San Francisco 49ers,San Diego Chargers,LAC,19,48,29,10,67,42.5,FALSE,0,0,"",19,24.5
2006,6,reg,St. Louis Rams,Seattle Seahawks,SEA,28,30,2,3,58,45,FALSE,1,0,DOME,1,13
2006,6,reg,Tampa Bay Buccaneers,Cincinnati Bengals,CIN,14,13,1,5,27,44.5,FALSE,0,0,"",4,17.5
2006,6,reg,Washington Redskins,Tennessee Titans,WAS,22,25,3,12,47,39.5,FALSE,0,0,"",9,7.5
2006,6,reg,Arizona Cardinals,Chicago Bears,CHI,23,24,1,13,47,40.5,FALSE,1,0,DOME,12,6.5
2006,7,reg,Atlanta Falcons,Pittsburgh Steelers,PIT,41,38,3,3,79,39,FALSE,1,0,DOME,0,40
2006,7,reg,Buffalo Bills,New England Patriots,NE,6,28,22,5.5,34,37,FALSE,0,0,"",16.5,3
2006,7,reg,Cincinnati Bengals,Carolina Panthers,CIN,17,14,3,3,31,44.5,FALSE,0,0,"",0,13.5
2006,7,reg,Cleveland Browns,Denver Broncos,DEN,7,17,10,4.5,24,31,FALSE,0,0,"",5.5,7
2006,7,reg,Houston Texans,Jacksonville Jaguars,JAX,27,7,20,8,34,39.5,FALSE,1,0,DOME,12,5.5
2006,7,reg,Indianapolis Colts,Washington Redskins,IND,36,22,14,8.5,58,47,FALSE,1,0,DOME,5.5,11
2006,7,reg,Kansas City Chiefs,San Diego Chargers,LAC,30,27,3,5.5,57,39,FALSE,0,0,"",2.5,18
2006,7,reg,Miami Dolphins,Green Bay Packers,MIA,24,34,10,5.5,58,40,FALSE,0,0,"",4.5,18
2006,7,reg,New York Jets,Detroit Lions,NYJ,31,24,7,3.5,55,43.5,FALSE,0,0,"",3.5,11.5
2006,7,reg,Oakland Raiders,Arizona Cardinals,ARI,22,9,13,3,31,40,FALSE,0,0,"",10,9
2006,7,reg,Seattle Seahawks,Minnesota Vikings,SEA,13,31,18,7,44,40.5,FALSE,0,0,"",11,3.5
2006,7,reg,Tampa Bay Buccaneers,Philadelphia Eagles,PHI,23,21,2,6,44,43,FALSE,0,0,"",4,1
2006,7,reg,Dallas Cowboys,New York Giants,DAL,22,36,14,3,58,43.5,FALSE,0,0,"",11,14.5
2006,8,reg,Carolina Panthers,Dallas Cowboys,CAR,14,35,21,5.5,49,40.5,FALSE,0,0,"",15.5,8.5
2006,8,reg,Chicago Bears,San Francisco 49ers,CHI,41,10,31,16.5,51,42,FALSE,0,0,"",14.5,9
2006,8,reg,Cincinnati Bengals,Atlanta Falcons,CIN,27,29,2,4.5,56,46.5,FALSE,0,0,"",2.5,9.5
2006,8,reg,Cleveland Browns,New York Jets,CLE,20,13,7,1.5,33,37.5,FALSE,0,0,"",5.5,4.5
2006,8,reg,Denver Broncos,Indianapolis Colts,DEN,31,34,3,3,65,39.5,FALSE,0,0,"",0,25.5
2006,8,reg,Green Bay Packers,Arizona Cardinals,GB,31,14,17,4,45,45.5,FALSE,0,0,"",13,0.5
2006,8,reg,Kansas City Chiefs,Seattle Seahawks,KC,35,28,7,5,63,37,FALSE,0,0,"",2,26
2006,8,reg,New Orleans Saints,Baltimore Ravens,NO,22,35,13,2,57,37,FALSE,1,0,DOME,11,20
2006,8,reg,New York Giants,Tampa Bay Buccaneers,NYG,17,3,14,9.5,20,36,FALSE,0,0,"",4.5,16
2006,8,reg,Oakland Raiders,Pittsburgh Steelers,PIT,20,13,7,9,33,38.5,FALSE,0,0,"",2,5.5
2006,8,reg,Philadelphia Eagles,Jacksonville Jaguars,PHI,6,13,7,8,19,39,FALSE,0,0,"",1,20
2006,8,reg,San Diego Chargers,St. Louis Rams,LAC,38,24,14,9,62,46,FALSE,0,0,"",5,16
2006,8,reg,Tennessee Titans,Houston Texans,TEN,28,22,6,3,50,42,FALSE,0,0,"",3,8
2006,8,reg,Minnesota Vikings,New England Patriots,NE,7,31,24,2.5,38,39.5,FALSE,1,0,DOME,21.5,1.5
2006,9,reg,Baltimore Ravens,Cincinnati Bengals,BAL,26,20,6,3,46,41,FALSE,0,0,"",3,5
2006,9,reg,Buffalo Bills,Green Bay Packers,BUF,24,10,14,3,34,41,FALSE,0,0,"",11,7
2006,9,reg,Chicago Bears,Miami Dolphins,CHI,13,31,18,13.5,44,37.5,FALSE,0,0,"",4.5,6.5
2006,9,reg,Detroit Lions,Atlanta Falcons,DET,30,14,16,5,44,47,FALSE,1,0,DOME,11,3
2006,9,reg,Jacksonville Jaguars,Tennessee Titans,JAX,37,7,30,9.5,44,37,FALSE,0,0,"",20.5,7
2006,9,reg,New England Patriots,Indianapolis Colts,NE,20,27,7,2.5,47,47.5,FALSE,0,0,"",4.5,0.5
2006,9,reg,New York Giants,Houston Texans,NYG,14,10,4,13,24,43.5,FALSE,0,0,"",9,19.5
2006,9,reg,Pittsburgh Steelers,Denver Broncos,PIT,20,31,11,2.5,51,36.5,FALSE,0,0,"",8.5,14.5
2006,9,reg,San Diego Chargers,Cleveland Browns,LAC,32,25,7,13.5,57,42,FALSE,0,0,"",6.5,15
2006,9,reg,San Francisco 49ers,Minnesota Vikings,MIN,9,3,6,4,12,43,FALSE,0,0,"",2,31
2006,9,reg,St. Louis Rams,Kansas City Chiefs,LAR,17,31,14,3,48,48.5,FALSE,1,0,DOME,11,0.5
2006,9,reg,Tampa Bay Buccaneers,New Orleans Saints,TB,14,31,17,1.5,45,37,FALSE,0,0,"",15.5,8
2006,9,reg,Washington Redskins,Dallas Cowboys,DAL,22,19,3,3,41,40.5,FALSE,0,0,"",0,0.5
2006,9,reg,Seattle Seahawks,Oakland Raiders,SEA,16,0,16,7.5,16,36,FALSE,0,0,"",8.5,20
2006,10,reg,Arizona Cardinals,Dallas Cowboys,DAL,10,27,17,6.5,37,43.5,FALSE,1,0,DOME,10.5,6.5
2006,10,reg,Atlanta Falcons,Cleveland Browns,ATL,13,17,4,7.5,30,41.5,FALSE,1,0,DOME,3.5,11.5
2006,10,reg,Cincinnati Bengals,San Diego Chargers,LAC,41,49,8,1.5,90,48,FALSE,0,0,"",6.5,42
2006,10,reg,Detroit Lions,San Francisco 49ers,DET,13,19,6,6,32,46.5,FALSE,1,0,DOME,0,14.5
2006,10,reg,Indianapolis Colts,Buffalo Bills,IND,17,16,1,12.5,33,45,FALSE,1,0,DOME,11.5,12
2006,10,reg,Jacksonville Jaguars,Houston Texans,JAX,10,13,3,10.5,23,37.5,FALSE,0,0,"",7.5,14.5
2006,10,reg,Miami Dolphins,Kansas City Chiefs,MIA,13,10,3,2,23,40.5,FALSE,0,0,"",1,17.5
2006,10,reg,Minnesota Vikings,Green Bay Packers,MIN,17,23,6,5,40,40.5,FALSE,1,0,DOME,1,0.5
2006,10,reg,New England Patriots,New York Jets,NE,14,17,3,10.5,31,38,FALSE,0,0,"",7.5,7
2006,10,reg,New York Giants,Chicago Bears,NYG,20,38,18,1,58,37.5,FALSE,0,0,"",17,20.5
2006,10,reg,Oakland Raiders,Denver Broncos,DEN,13,17,4,8,30,33.5,FALSE,0,0,"",4,3.5
2006,10,reg,Philadelphia Eagles,Washington Redskins,PHI,27,3,24,8,30,41.5,FALSE,0,0,"",16,11.5
2006,10,reg,Pittsburgh Steelers,New Orleans Saints,PIT,38,31,7,6.5,69,45.5,FALSE,0,0,"",0.5,23.5
2006,10,reg,Seattle Seahawks,St. Louis Rams,SEA,24,22,2,3,46,43.5,FALSE,0,0,"",1,2.5
2006,10,reg,Tennessee Titans,Baltimore Ravens,BAL,26,27,1,7.5,53,38,FALSE,0,0,"",6.5,15
2006,10,reg,Carolina Panthers,Tampa Bay Buccaneers,CAR,24,10,14,10,34,37,FALSE,0,0,"",4,3
2006,11,reg,Arizona Cardinals,Detroit Lions,ARI,17,10,7,2.5,27,45.5,FALSE,1,0,DOME,4.5,18.5
2006,11,reg,Baltimore Ravens,Atlanta Falcons,BAL,24,10,14,3.5,34,41.5,FALSE,0,0,"",10.5,7.5
2006,11,reg,Carolina Panthers,St. Louis Rams,CAR,15,0,15,6.5,15,44.5,FALSE,0,0,"",8.5,29.5
2006,11,reg,Cleveland Browns,Pittsburgh Steelers,PIT,20,24,4,4,44,36,FALSE,0,0,"",0,8
2006,11,reg,Dallas Cowboys,Indianapolis Colts,IND,21,14,7,1,35,49,FALSE,0,0,"",6,14
2006,11,reg,Denver Broncos,San Diego Chargers,DEN,27,35,8,2.5,62,42.5,FALSE,0,0,"",5.5,19.5
2006,11,reg,Green Bay Packers,New England Patriots,NE,0,35,35,6,35,46,FALSE,0,0,"",29,11
2006,11,reg,Houston Texans,Buffalo Bills,HOU,21,24,3,2.5,45,36.5,FALSE,1,0,DOME,0.5,8.5
2006,11,reg,Kansas City Chiefs,Oakland Raiders,KC,17,13,4,9,30,36.5,FALSE,0,0,"",5,6.5
2006,11,reg,Miami Dolphins,Minnesota Vikings,MIA,24,20,4,3,44,33.5,FALSE,0,0,"",1,10.5
2006,11,reg,New Orleans Saints,Cincinnati Bengals,NO,16,31,15,3,47,52.5,FALSE,1,0,DOME,12,5.5
2006,11,reg,New York Jets,Chicago Bears,CHI,0,10,10,5.5,10,40.5,FALSE,0,0,"",4.5,30.5
2006,11,reg,Philadelphia Eagles,Tennessee Titans,PHI,13,31,18,13,44,43.5,FALSE,0,0,"",5,0.5
2006,11,reg,San Francisco 49ers,Seattle Seahawks,SEA,20,14,6,3,34,43.5,FALSE,0,0,"",3,9.5
2006,11,reg,Tampa Bay Buccaneers,Washington Redskins,TB,20,17,3,3,37,34,FALSE,0,0,"",0,3
2006,11,reg,Jacksonville Jaguars,New York Giants,JAX,26,10,16,3.5,36,38.5,FALSE,0,0,"",12.5,2.5
2006,12,reg,Dallas Cowboys,Tampa Bay Buccaneers,DAL,38,10,28,11,48,39,FALSE,0,0,"",17,9
2006,12,reg,Detroit Lions,Miami Dolphins,MIA,10,27,17,2.5,37,40.5,FALSE,1,0,DOME,14.5,3.5
2006,12,reg,Kansas City Chiefs,Denver Broncos,KC,19,10,9,1,29,39,FALSE,0,0,"",8,10
2006,12,reg,Atlanta Falcons,New Orleans Saints,ATL,13,31,18,3,44,48,FALSE,1,0,DOME,15,4
2006,12,reg,Baltimore Ravens,Pittsburgh Steelers,BAL,27,0,27,3,27,40.5,FALSE,0,0,"",24,13.5
2006,12,reg,Buffalo Bills,Jacksonville Jaguars,JAX,27,24,3,3,51,35,FALSE,0,0,"",0,16
2006,12,reg,Cleveland Browns,Cincinnati Bengals,CIN,0,30,30,3,30,44,FALSE,0,0,"",27,14
2006,12,reg,Indianapolis Colts,Philadelphia Eagles,IND,45,21,24,9.5,66,45,FALSE,1,0,DOME,14.5,21
2006,12,reg,Minnesota Vikings,Arizona Cardinals,MIN,31,26,5,6,57,39,FALSE,1,0,DOME,1,18
2006,12,reg,New England Patriots,Chicago Bears,NE,17,13,4,3.5,30,38,FALSE,0,0,"",0.5,8
2006,12,reg,New York Jets,Houston Texans,NYJ,26,11,15,5.5,37,40,FALSE,0,0,"",9.5,3
2006,12,reg,San Diego Chargers,Oakland Raiders,LAC,21,14,7,13,35,43,FALSE,0,0,"",6,8
2006,12,reg,St. Louis Rams,San Francisco 49ers,LAR,20,17,3,4.5,37,45,FALSE,1,0,DOME,1.5,8
2006,12,reg,Tennessee Titans,New York Giants,NYG,24,21,3,3.5,45,45,FALSE,0,0,"",0.5,0
2006,12,reg,Washington Redskins,Carolina Panthers,CAR,17,13,4,6,30,36,FALSE,0,0,"",2,6
2006,12,reg,Seattle Seahawks,Green Bay Packers,SEA,34,24,10,10,58,42.5,FALSE,0,0,"",0,15.5
2006,13,reg,Cincinnati Bengals,Baltimore Ravens,CIN,13,7,6,2.5,20,43.5,FALSE,0,0,"",3.5,23.5
2006,13,reg,Buffalo Bills,San Diego Chargers,LAC,21,24,3,5.5,45,42.5,FALSE,0,0,"",2.5,2.5
2006,13,reg,Chicago Bears,Minnesota Vikings,CHI,23,13,10,9,36,34.5,FALSE,0,0,"",1,1.5
2006,13,reg,Cleveland Browns,Kansas City Chiefs,KC,31,28,3,5,59,35.5,FALSE,0,0,"",2,23.5
2006,13,reg,Denver Broncos,Seattle Seahawks,DEN,20,23,3,4,43,40.5,FALSE,0,0,"",1,2.5
2006,13,reg,Green Bay Packers,New York Jets,PICK,10,38,28,0,48,42.5,FALSE,0,0,"",28,5.5
2006,13,reg,Miami Dolphins,Jacksonville Jaguars,PICK,10,24,14,0,34,35.5,FALSE,0,0,"",14,1.5
2006,13,reg,New England Patriots,Detroit Lions,NE,28,21,7,13.5,49,41.5,FALSE,0,0,"",6.5,7.5
2006,13,reg,New Orleans Saints,San Francisco 49ers,NO,34,10,24,7,44,45.5,FALSE,1,0,DOME,17,1.5
2006,13,reg,New York Giants,Dallas Cowboys,DAL,20,23,3,3.5,43,44,FALSE,0,0,"",0.5,1
2006,13,reg,Oakland Raiders,Houston Texans,OAK,14,23,9,3.5,37,35.5,FALSE,0,0,"",5.5,1.5
2006,13,reg,Pittsburgh Steelers,Tampa Bay Buccaneers,PIT,20,3,17,7,23,41,FALSE,0,0,"",10,18
2006,13,reg,St. Louis Rams,Arizona Cardinals,LAR,20,34,14,6.5,54,47,FALSE,1,0,DOME,7.5,7
2006,13,reg,Tennessee Titans,Indianapolis Colts,IND,20,17,3,7.5,37,46.5,FALSE,0,0,"",4.5,9.5
2006,13,reg,Washington Redskins,Atlanta Falcons,WAS,14,24,10,1.5,38,38.5,FALSE,0,0,"",8.5,0.5
2006,13,reg,Philadelphia Eagles,Carolina Panthers,CAR,27,24,3,3,51,37.5,FALSE,0,0,"",0,13.5
2006,14,reg,Pittsburgh Steelers,Cleveland Browns,PIT,27,7,20,7.5,34,34.5,FALSE,0,0,"",12.5,0.5
2006,14,reg,Arizona Cardinals,Seattle Seahawks,SEA,27,21,6,3.5,48,45,FALSE,1,0,DOME,2.5,3
2006,14,reg,Carolina Panthers,New York Giants,NYG,13,27,14,2.5,40,39,FALSE,0,0,"",11.5,1
2006,14,reg,Cincinnati Bengals,Oakland Raiders,CIN,27,10,17,10.5,37,39.5,FALSE,0,0,"",6.5,2.5
2006,14,reg,Dallas Cowboys,New Orleans Saints,DAL,17,42,25,6.5,59,48,FALSE,0,0,"",18.5,11
2006,14,reg,Detroit Lions,Minnesota Vikings,DET,20,30,10,1,50,40,FALSE,1,0,DOME,9,10
2006,14,reg,Houston Texans,Tennessee Titans,HOU,20,26,6,1.5,46,42,FALSE,1,0,DOME,4.5,4
2006,14,reg,Jacksonville Jaguars,Indianapolis Colts,IND,44,17,27,1,61,44,FALSE,0,0,"",26,17
2006,14,reg,Kansas City Chiefs,Baltimore Ravens,KC,10,20,10,3,30,37.5,FALSE,0,0,"",7,7.5
2006,14,reg,Miami Dolphins,New England Patriots,NE,21,0,21,3,21,37,FALSE,0,0,"",18,16
2006,14,reg,New York Jets,Buffalo Bills,NYJ,13,31,18,3.5,44,37.5,FALSE,0,0,"",14.5,6.5
2006,14,reg,San Diego Chargers,Denver Broncos,LAC,48,20,28,7,68,41,FALSE,0,0,"",21,27
2006,14,reg,San Francisco 49ers,Green Bay Packers,SF,19,30,11,4,49,43.5,FALSE,0,0,"",7,5.5
2006,14,reg,Tampa Bay Buccaneers,Atlanta Falcons,ATL,6,17,11,3,23,38,FALSE,0,0,"",8,15
2006,14,reg,Washington Redskins,Philadelphia Eagles,PHI,19,21,2,2,40,40.5,FALSE,0,0,"",0,0.5
2006,14,reg,St. Louis Rams,Chicago Bears,CHI,27,42,15,6.5,69,41.5,FALSE,1,0,DOME,8.5,27.5
2006,15,reg,Seattle Seahawks,San Francisco 49ers,SEA,14,24,10,10,38,38,FALSE,0,0,"",0,0
2006,15,reg,Atlanta Falcons,Dallas Cowboys,DAL,28,38,10,3.5,66,44.5,FALSE,1,0,DOME,6.5,21.5
2006,15,reg,Arizona Cardinals,Denver Broncos,DEN,20,37,17,2.5,57,44,FALSE,1,0,DOME,14.5,13
2006,15,reg,Baltimore Ravens,Cleveland Browns,BAL,27,17,10,12,44,34.5,FALSE,0,0,"",2,9.5
2006,15,reg,Buffalo Bills,Miami Dolphins,BUF,21,0,21,1,21,34.5,FALSE,0,0,"",20,13.5
2006,15,reg,Carolina Panthers,Pittsburgh Steelers,PIT,3,37,34,2.5,40,39,FALSE,0,0,"",31.5,1
2006,15,reg,Chicago Bears,Tampa Bay Buccaneers,CHI,34,31,3,13.5,65,35,FALSE,0,0,"",10.5,30
2006,15,reg,Green Bay Packers,Detroit Lions,GB,17,9,8,6,26,45,FALSE,0,0,"",2,19
2006,15,reg,Minnesota Vikings,New York Jets,MIN,13,26,13,3,39,40.5,FALSE,1,0,DOME,10,1.5
2006,15,reg,New England Patriots,Houston Texans,NE,40,7,33,12.5,47,37.5,FALSE,0,0,"",20.5,9.5
2006,15,reg,New Orleans Saints,Washington Redskins,NO,10,16,6,9.5,26,47,FALSE,1,0,DOME,3.5,21
2006,15,reg,New York Giants,Philadelphia Eagles,NYG,22,36,14,6,58,45,FALSE,0,0,"",8,13
2006,15,reg,Oakland Raiders,St. Louis Rams,OAK,0,20,20,2,20,39.5,FALSE,0,0,"",18,19.5
2006,15,reg,San Diego Chargers,Kansas City Chiefs,LAC,20,9,11,9,29,47,FALSE,0,0,"",2,18
2006,15,reg,Tennessee Titans,Jacksonville Jaguars,JAX,24,17,7,3.5,41,41,FALSE,0,0,"",3.5,0
2006,15,reg,Indianapolis Colts,Cincinnati Bengals,IND,34,16,18,3.5,50,55,FALSE,1,0,DOME,14.5,5
2006,16,reg,Green Bay Packers,Minnesota Vikings,GB,9,7,2,4,16,38.5,FALSE,0,0,"",2,22.5
2006,16,reg,Oakland Raiders,Kansas City Chiefs,KC,9,20,11,7,29,35.5,FALSE,0,0,"",4,6.5
2006,16,reg,Atlanta Falcons,Carolina Panthers,ATL,3,10,7,6,13,41,FALSE,1,0,DOME,1,28
2006,16,reg,Buffalo Bills,Tennessee Titans,BUF,29,30,1,5.5,59,38,FALSE,0,0,"",4.5,21
2006,16,reg,Cleveland Browns,Tampa Bay Buccaneers,CLE,7,22,15,3,29,37.5,FALSE,0,0,"",12,8.5
2006,16,reg,Denver Broncos,Cincinnati Bengals,DEN,24,23,1,3,47,44.5,FALSE,0,0,"",2,2.5
2006,16,reg,Detroit Lions,Chicago Bears,CHI,21,26,5,6,47,41.5,FALSE,1,0,DOME,1,5.5
2006,16,reg,Houston Texans,Indianapolis Colts,IND,27,24,3,9.5,51,47,FALSE,1,0,DOME,6.5,4
2006,16,reg,Jacksonville Jaguars,New England Patriots,JAX,21,24,3,3,45,37,FALSE,0,0,"",0,8
2006,16,reg,New York Giants,New Orleans Saints,NYG,7,30,23,3,37,47.5,FALSE,0,0,"",20,10.5
2006,16,reg,Pittsburgh Steelers,Baltimore Ravens,PIT,7,31,24,4,38,37,FALSE,0,0,"",20,1
2006,16,reg,San Francisco 49ers,Arizona Cardinals,SF,20,26,6,4,46,45,FALSE,0,0,"",2,1
2006,16,reg,Seattle Seahawks,San Diego Chargers,LAC,17,20,3,4.5,37,45,FALSE,0,0,"",1.5,8
2006,16,reg,St. Louis Rams,Washington Redskins,LAR,37,31,6,2,68,43,FALSE,1,0,DOME,4,25
2006,16,reg,Dallas Cowboys,Philadelphia Eagles,DAL,7,23,16,7,30,48.5,FALSE,0,0,"",9,18.5
2006,16,reg,Miami Dolphins,New York Jets,MIA,10,13,3,3,23,36.5,FALSE,0,0,"",0,13.5
2006,17,reg,Washington Redskins,New York Giants,NYG,28,34,6,2,62,43,FALSE,0,0,"",4,19
2006,17,reg,Baltimore Ravens,Buffalo Bills,BAL,19,7,12,9,26,37.5,FALSE,0,0,"",3,11.5
2006,17,reg,Chicago Bears,Green Bay Packers,CHI,7,26,19,2.5,33,37,FALSE,0,0,"",16.5,4
2006,17,reg,Cincinnati Bengals,Pittsburgh Steelers,CIN,17,23,6,6,40,44.5,FALSE,0,0,"",0,4.5
2006,17,reg,Dallas Cowboys,Detroit Lions,DAL,31,39,8,14,70,46,FALSE,0,0,"",6,24
2006,17,reg,Denver Broncos,San Francisco 49ers,DEN,23,26,3,10,49,39,FALSE,0,0,"",7,10
2006,17,reg,Houston Texans,Cleveland Browns,HOU,14,6,8,6,20,37.5,FALSE,1,0,DOME,2,17.5
2006,17,reg,Indianapolis Colts,Miami Dolphins,IND,27,22,5,9,49,43.5,FALSE,1,0,DOME,4,5.5
2006,17,reg,Kansas City Chiefs,Jacksonville Jaguars,KC,35,30,5,2.5,65,37,FALSE,0,0,"",2.5,28
2006,17,reg,Minnesota Vikings,St. Louis Rams,LAR,21,41,20,2.5,62,44,FALSE,1,0,DOME,17.5,18
2006,17,reg,New Orleans Saints,Carolina Panthers,CAR,21,31,10,2,52,38.5,FALSE,1,0,DOME,8,13.5
2006,17,reg,New York Jets,Oakland Raiders,NYJ,23,3,20,10.5,26,34.5,FALSE,0,0,"",9.5,8.5
2006,17,reg,Philadelphia Eagles,Atlanta Falcons,PHI,24,17,7,8.5,41,43,FALSE,0,0,"",1.5,2
2006,17,reg,San Diego Chargers,Arizona Cardinals,LAC,27,20,7,14,47,44,FALSE,0,0,"",7,3
2006,17,reg,Tampa Bay Buccaneers,Seattle Seahawks,TB,7,23,16,3,30,38,FALSE,0,0,"",13,8
2006,17,reg,Tennessee Titans,New England Patriots,TEN,23,40,17,3,63,41.5,FALSE,0,0,"",14,21.5
2006,Wildcard,post,Indianapolis Colts,Kansas City Chiefs,IND,23,8,15,6.5,31,51,FALSE,1,0,DOME,8.5,20
2006,Wildcard,post,Seattle Seahawks,Dallas Cowboys,SEA,21,20,1,2,41,48.5,FALSE,0,0,"",1,7.5
2006,Wildcard,post,New England Patriots,New York Jets,NE,37,16,21,9,53,38.5,FALSE,0,0,"",12,14.5
2006,Wildcard,post,Philadelphia Eagles,New York Giants,PHI,23,20,3,6,43,46.5,FALSE,0,0,"",3,3.5
2006,Division,post,Baltimore Ravens,Indianapolis Colts,BAL,6,15,9,4,21,41,FALSE,0,0,"",5,20
2006,Division,post,New Orleans Saints,Philadelphia Eagles,NO,27,24,3,4.5,51,48.5,FALSE,1,0,DOME,1.5,2.5
2006,Division,post,Chicago Bears,Seattle Seahawks,CHI,27,24,3,8.5,51,37.5,FALSE,0,0,"",5.5,13.5
2006,Division,post,San Diego Chargers,New England Patriots,LAC,21,24,3,5,45,46.5,FALSE,0,0,"",2,1.5
2006,Conference,post,Chicago Bears,New Orleans Saints,CHI,39,14,25,3,53,43,FALSE,0,0,"",22,10
2006,Conference,post,Indianapolis Colts,New England Patriots,IND,38,34,4,3,72,47,FALSE,1,0,DOME,1,25
2006,Superbowl,post,Indianapolis Colts,Chicago Bears,IND,29,17,12,7,46,47,TRUE,0,0,"",5,1
2007,1,reg,Indianapolis Colts,New Orleans Saints,IND,41,10,31,5.5,51,53.5,FALSE,1,0,DOME,25.5,2.5
2007,1,reg,Buffalo Bills,Denver Broncos,DEN,14,15,1,3,29,37,FALSE,0,0,"",2,8
2007,1,reg,Cleveland Browns,Pittsburgh Steelers,PIT,7,34,27,4.5,41,36.5,FALSE,0,0,"",22.5,4.5
2007,1,reg,Dallas Cowboys,New York Giants,DAL,45,35,10,6.5,80,44.5,FALSE,0,0,"",3.5,35.5
2007,1,reg,Green Bay Packers,Philadelphia Eagles,PHI,16,13,3,3,29,42.5,FALSE,0,0,"",0,13.5
2007,1,reg,Houston Texans,Kansas City Chiefs,HOU,20,3,17,3,23,38,FALSE,1,0,DOME,14,15
2007,1,reg,Jacksonville Jaguars,Tennessee Titans,JAX,10,13,3,7,23,38,FALSE,0,0,"",4,15
2007,1,reg,Minnesota Vikings,Atlanta Falcons,MIN,24,3,21,3,27,35.5,FALSE,1,0,DOME,18,8.5
2007,1,reg,New York Jets,New England Patriots,NE,14,38,24,6.5,52,41,FALSE,0,0,"",17.5,11
2007,1,reg,Oakland Raiders,Detroit Lions,OAK,21,36,15,2.5,57,39.5,FALSE,0,0,"",12.5,17.5
2007,1,reg,San Diego Chargers,Chicago Bears,LAC,14,3,11,6,17,42.5,FALSE,0,0,"",5,25.5
2007,1,reg,Seattle Seahawks,Tampa Bay Buccaneers,SEA,20,6,14,6,26,41,FALSE,0,0,"",8,15
2007,1,reg,St. Louis Rams,Carolina Panthers,LAR,13,27,14,1,40,43,FALSE,1,0,DOME,13,3
2007,1,reg,Washington Redskins,Miami Dolphins,WAS,16,13,3,3,29,34.5,FALSE,0,0,"",0,5.5
2007,1,reg,Cincinnati Bengals,Baltimore Ravens,CIN,27,20,7,2.5,47,40,FALSE,0,0,"",4.5,7
2007,1,reg,San Francisco 49ers,Arizona Cardinals,SF,20,17,3,3,37,46.5,FALSE,0,0,"",0,9.5
2007,2,reg,Arizona Cardinals,Seattle Seahawks,SEA,23,20,3,2.5,43,42.5,FALSE,1,0,DOME,0.5,0.5
2007,2,reg,Baltimore Ravens,New York Jets,BAL,20,13,7,10,33,33,FALSE,0,0,"",3,0
2007,2,reg,Carolina Panthers,Houston Texans,CAR,21,34,13,6.5,55,38.5,FALSE,0,0,"",6.5,16.5
2007,2,reg,Chicago Bears,Kansas City Chiefs,CHI,20,10,10,12,30,34.5,FALSE,0,0,"",2,4.5
2007,2,reg,Cleveland Browns,Cincinnati Bengals,CIN,51,45,6,7,96,41.5,FALSE,0,0,"",1,54.5
2007,2,reg,Denver Broncos,Oakland Raiders,DEN,23,20,3,10,43,37,FALSE,0,0,"",7,6
2007,2,reg,Detroit Lions,Minnesota Vikings,DET,20,17,3,3,37,42.5,FALSE,1,0,DOME,0,5.5
2007,2,reg,Jacksonville Jaguars,Atlanta Falcons,JAX,13,7,6,10,20,34.5,FALSE,0,0,"",4,14.5
2007,2,reg,Miami Dolphins,Dallas Cowboys,DAL,20,37,17,3.5,57,40.5,FALSE,0,0,"",13.5,16.5
2007,2,reg,New England Patriots,San Diego Chargers,NE,38,14,24,3.5,52,46,FALSE,0,0,"",20.5,6
2007,2,reg,New York Giants,Green Bay Packers,NYG,13,35,22,2.5,48,39,FALSE,0,0,"",19.5,9
2007,2,reg,Pittsburgh Steelers,Buffalo Bills,PIT,26,3,23,10,29,39,FALSE,0,0,"",13,10
2007,2,reg,St. Louis Rams,San Francisco 49ers,LAR,16,17,1,3,33,44,FALSE,1,0,DOME,2,11
2007,2,reg,Tampa Bay Buccaneers,New Orleans Saints,NO,31,14,17,4,45,41.5,FALSE,0,0,"",13,3.5
2007,2,reg,Tennessee Titans,Indianapolis Colts,IND,20,22,2,7,42,46,FALSE,0,0,"",5,4
2007,2,reg,Philadelphia Eagles,Washington Redskins,PHI,12,20,8,7,32,38.5,FALSE,0,0,"",1,6.5
2007,3,reg,Atlanta Falcons,Carolina Panthers,CAR,20,27,7,4,47,38.5,FALSE,1,0,DOME,3,8.5
2007,3,reg,Baltimore Ravens,Arizona Cardinals,BAL,26,23,3,7,49,35.5,FALSE,0,0,"",4,13.5
2007,3,reg,Chicago Bears,Dallas Cowboys,CHI,10,34,24,3,44,41.5,FALSE,0,0,"",21,2.5
2007,3,reg,Denver Broncos,Jacksonville Jaguars,DEN,14,23,9,3,37,36,FALSE,0,0,"",6,1
2007,3,reg,Green Bay Packers,San Diego Chargers,LAC,31,24,7,5.5,55,42.5,FALSE,0,0,"",1.5,12.5
2007,3,reg,Houston Texans,Indianapolis Colts,IND,24,30,6,6.5,54,46.5,FALSE,1,0,DOME,0.5,7.5
2007,3,reg,Kansas City Chiefs,Minnesota Vikings,KC,13,10,3,3,23,34,FALSE,0,0,"",0,11
2007,3,reg,New England Patriots,Buffalo Bills,NE,38,7,31,16.5,45,41,FALSE,0,0,"",14.5,4
2007,3,reg,New York Jets,Miami Dolphins,NYJ,31,28,3,3,59,36.5,FALSE,0,0,"",0,22.5
2007,3,reg,Oakland Raiders,Cleveland Browns,OAK,26,24,2,3,50,41.5,FALSE,0,0,"",1,8.5
2007,3,reg,Philadelphia Eagles,Detroit Lions,PHI,56,21,35,5,77,44,FALSE,0,0,"",30,33
2007,3,reg,Pittsburgh Steelers,San Francisco 49ers,PIT,37,16,21,9.5,53,38,FALSE,0,0,"",11.5,15
2007,3,reg,Seattle Seahawks,Cincinnati Bengals,SEA,24,21,3,3,45,49.5,FALSE,0,0,"",0,4.5
2007,3,reg,Tampa Bay Buccaneers,St. Louis Rams,TB,24,3,21,3.5,27,38.5,FALSE,0,0,"",17.5,11.5
2007,3,reg,Washington Redskins,New York Giants,WAS,17,24,7,3.5,41,42.5,FALSE,0,0,"",3.5,1.5
2007,3,reg,New Orleans Saints,Tennessee Titans,NO,14,31,17,4.5,45,46.5,FALSE,1,0,DOME,12.5,1.5
2007,4,reg,Arizona Cardinals,Pittsburgh Steelers,PIT,21,14,7,5,35,42.5,FALSE,1,0,DOME,2,7.5
2007,4,reg,Atlanta Falcons,Houston Texans,HOU,26,16,10,2.5,42,39.5,FALSE,1,0,DOME,7.5,2.5
2007,4,reg,Buffalo Bills,New York Jets,NYJ,17,14,3,3,31,37,FALSE,0,0,"",0,6
2007,4,reg,Carolina Panthers,Tampa Bay Buccaneers,CAR,7,20,13,3,27,39.5,FALSE,0,0,"",10,12.5
2007,4,reg,Cleveland Browns,Baltimore Ravens,BAL,27,13,14,4.5,40,40,FALSE,0,0,"",9.5,0
2007,4,reg,Dallas Cowboys,St. Louis Rams,DAL,35,7,28,13,42,47,FALSE,0,0,"",15,5
2007,4,reg,Detroit Lions,Chicago Bears,CHI,37,27,10,2.5,64,46,FALSE,1,0,DOME,7.5,18
2007,4,reg,Indianapolis Colts,Denver Broncos,IND,38,20,18,10,58,46.5,FALSE,1,0,DOME,8,11.5
2007,4,reg,Miami Dolphins,Oakland Raiders,MIA,17,35,18,3.5,52,40,FALSE,0,0,"",14.5,12
2007,4,reg,Minnesota Vikings,Green Bay Packers,GB,16,23,7,1,39,38,FALSE,1,0,DOME,6,1
2007,4,reg,New York Giants,Philadelphia Eagles,PHI,16,3,13,2.5,19,47,FALSE,0,0,"",10.5,28
2007,4,reg,San Diego Chargers,Kansas City Chiefs,LAC,16,30,14,12,46,38.5,FALSE,0,0,"",2,7.5
2007,4,reg,San Francisco 49ers,Seattle Seahawks,SEA,3,23,20,1,26,40.5,FALSE,0,0,"",19,14.5
2007,4,reg,Cincinnati Bengals,New England Patriots,NE,13,34,21,7.5,47,54,FALSE,0,0,"",13.5,7
2007,5,reg,Denver Broncos,San Diego Chargers,LAC,3,41,38,1,44,43.5,FALSE,0,0,"",37,0.5
2007,5,reg,Green Bay Packers,Chicago Bears,GB,20,27,7,3.5,47,40.5,FALSE,0,0,"",3.5,6.5
2007,5,reg,Houston Texans,Miami Dolphins,HOU,22,19,3,5.5,41,43.5,FALSE,1,0,DOME,2.5,2.5
2007,5,reg,Indianapolis Colts,Tampa Bay Buccaneers,IND,33,14,19,9,47,45,FALSE,1,0,DOME,10,2
2007,5,reg,Kansas City Chiefs,Jacksonville Jaguars,JAX,7,17,10,2,24,35,FALSE,0,0,"",8,11
2007,5,reg,New England Patriots,Cleveland Browns,NE,34,17,17,15.5,51,48,FALSE,0,0,"",1.5,3
2007,5,reg,New Orleans Saints,Carolina Panthers,NO,13,16,3,4,29,44,FALSE,1,0,DOME,1,15
2007,5,reg,New York Giants,New York Jets,NYG,35,24,11,4,59,40.5,FALSE,0,0,"",7,18.5
2007,5,reg,Pittsburgh Steelers,Seattle Seahawks,PIT,21,0,21,5,21,41.5,FALSE,0,0,"",16,20.5
2007,5,reg,San Francisco 49ers,Baltimore Ravens,BAL,7,9,2,3,16,34.5,FALSE,0,0,"",1,18.5
2007,5,reg,St. Louis Rams,Arizona Cardinals,ARI,31,34,3,3.5,65,41,FALSE,1,0,DOME,0.5,24
2007,5,reg,Tennessee Titans,Atlanta Falcons,TEN,20,13,7,7.5,33,41,FALSE,0,0,"",0.5,8
2007,5,reg,Washington Redskins,Detroit Lions,WAS,34,3,31,4,37,44.5,FALSE,0,0,"",27,7.5
2007,5,reg,Buffalo Bills,Dallas Cowboys,DAL,24,25,1,11,49,45,FALSE,0,0,"",10,4
2007,6,reg,Arizona Cardinals,Carolina Panthers,ARI,10,25,15,6,35,38.5,FALSE,1,0,DOME,9,3.5
2007,6,reg,Baltimore Ravens,St. Louis Rams,BAL,22,3,19,9,25,36.5,FALSE,0,0,"",10,11.5
2007,6,reg,Chicago Bears,Minnesota Vikings,CHI,31,34,3,4.5,65,35.5,FALSE,0,0,"",1.5,29.5
2007,6,reg,Cleveland Browns,Miami Dolphins,CLE,41,31,10,4,72,45,FALSE,0,0,"",6,27
2007,6,reg,Dallas Cowboys,New England Patriots,NE,27,48,21,5,75,53,FALSE,0,0,"",16,22
2007,6,reg,Green Bay Packers,Washington Redskins,GB,17,14,3,3,31,40.5,FALSE,0,0,"",0,9.5
2007,6,reg,Jacksonville Jaguars,Houston Texans,JAX,37,17,20,7,54,37.5,FALSE,0,0,"",13,16.5
2007,6,reg,Kansas City Chiefs,Cincinnati Bengals,CIN,27,20,7,2.5,47,44,FALSE,0,0,"",4.5,3
2007,6,reg,New York Jets,Philadelphia Eagles,PHI,9,16,7,4.5,25,43.5,FALSE,0,0,"",2.5,18.5
2007,6,reg,San Diego Chargers,Oakland Raiders,LAC,28,14,14,9.5,42,44,FALSE,0,0,"",4.5,2
2007,6,reg,Seattle Seahawks,New Orleans Saints,SEA,17,28,11,6.5,45,43,FALSE,0,0,"",4.5,2
2007,6,reg,Tampa Bay Buccaneers,Tennessee Titans,TB,13,10,3,2.5,23,37,FALSE,0,0,"",0.5,14
2007,6,reg,Atlanta Falcons,New York Giants,NYG,10,31,21,5.5,41,44,FALSE,1,0,DOME,15.5,3
2007,7,reg,Buffalo Bills,Baltimore Ravens,BAL,19,14,5,3,33,33.5,FALSE,0,0,"",2,0.5
2007,7,reg,Cincinnati Bengals,New York Jets,CIN,38,31,7,6,69,48.5,FALSE,0,0,"",1,20.5
2007,7,reg,Dallas Cowboys,Minnesota Vikings,DAL,24,14,10,9.5,38,46.5,FALSE,0,0,"",0.5,8.5
2007,7,reg,Denver Broncos,Pittsburgh Steelers,PIT,31,28,3,4.5,59,38.5,FALSE,0,0,"",1.5,20.5
2007,7,reg,Detroit Lions,Tampa Bay Buccaneers,DET,23,16,7,2.5,39,44,FALSE,1,0,DOME,4.5,5
2007,7,reg,Houston Texans,Tennessee Titans,HOU,36,38,2,2,74,38,FALSE,1,0,DOME,0,36
2007,7,reg,Miami Dolphins,New England Patriots,NE,28,49,21,15.5,77,49.5,FALSE,0,0,"",5.5,27.5
2007,7,reg,New Orleans Saints,Atlanta Falcons,NO,22,16,6,7.5,38,42,FALSE,1,0,DOME,1.5,4
2007,7,reg,New York Giants,San Francisco 49ers,NYG,33,15,18,9.5,48,39,FALSE,0,0,"",8.5,9
2007,7,reg,Oakland Raiders,Kansas City Chiefs,OAK,10,12,2,1.5,22,38,FALSE,0,0,"",0.5,16
2007,7,reg,Philadelphia Eagles,Chicago Bears,PHI,16,19,3,5.5,35,43,FALSE,0,0,"",2.5,8
2007,7,reg,Seattle Seahawks,St. Louis Rams,SEA,33,6,27,7.5,39,39.5,FALSE,0,0,"",19.5,0.5
2007,7,reg,Washington Redskins,Arizona Cardinals,WAS,21,19,2,8,40,36,FALSE,0,0,"",6,4
2007,7,reg,Jacksonville Jaguars,Indianapolis Colts,IND,7,29,22,3,36,45.5,FALSE,0,0,"",19,9.5
2007,8,reg,Carolina Panthers,Indianapolis Colts,IND,7,31,24,6.5,38,44,FALSE,0,0,"",17.5,6
2007,8,reg,Chicago Bears,Detroit Lions,CHI,7,16,9,6,23,45.5,FALSE,0,0,"",3,22.5
2007,8,reg,Cincinnati Bengals,Pittsburgh Steelers,PIT,13,24,11,4,37,48.5,FALSE,0,0,"",7,11.5
2007,8,reg,Miami Dolphins,New York Giants,NYG,10,13,3,10,23,48,TRUE,0,0,"",7,25
2007,8,reg,Minnesota Vikings,Philadelphia Eagles,PHI,16,23,7,1,39,37.5,FALSE,1,0,DOME,6,1.5
2007,8,reg,New England Patriots,Washington Redskins,NE,52,7,45,14.5,59,46.5,FALSE,0,0,"",30.5,12.5
2007,8,reg,New York Jets,Buffalo Bills,NYJ,3,13,10,3,16,38.5,FALSE,0,0,"",7,22.5
2007,8,reg,San Diego Chargers,Houston Texans,LAC,35,10,25,10,45,45.5,FALSE,0,0,"",15,0.5
2007,8,reg,San Francisco 49ers,New Orleans Saints,NO,10,31,21,1.5,41,40,FALSE,0,0,"",19.5,1
2007,8,reg,St. Louis Rams,Cleveland Browns,CLE,20,27,7,3,47,46.5,FALSE,1,0,DOME,4,0.5
2007,8,reg,Tampa Bay Buccaneers,Jacksonville Jaguars,TB,23,24,1,3.5,47,32,FALSE,0,0,"",2.5,15
2007,8,reg,Tennessee Titans,Oakland Raiders,TEN,13,9,4,7,22,39,FALSE,0,0,"",3,17
2007,8,reg,Denver Broncos,Green Bay Packers,DEN,13,19,6,3,32,43.5,FALSE,0,0,"",3,11.5
2007,9,reg,Atlanta Falcons,San Francisco 49ers,ATL,20,16,4,3.5,36,37,FALSE,1,0,DOME,0.5,1
2007,9,reg,Buffalo Bills,Cincinnati Bengals,CIN,33,21,12,1,54,44,FALSE,0,0,"",11,10
2007,9,reg,Cleveland Browns,Seattle Seahawks,CLE,33,30,3,1.5,63,47,FALSE,0,0,"",1.5,16
2007,9,reg,Detroit Lions,Denver Broncos,DET,44,7,37,3,51,46.5,FALSE,1,0,DOME,34,4.5
2007,9,reg,Indianapolis Colts,New England Patriots,NE,20,24,4,5,44,56.5,FALSE,1,0,DOME,1,12.5
2007,9,reg,Kansas City Chiefs,Green Bay Packers,KC,22,33,11,2.5,55,37.5,FALSE,0,0,"",8.5,17.5
2007,9,reg,Minnesota Vikings,San Diego Chargers,LAC,35,17,18,7,52,42,FALSE,1,0,DOME,11,10
2007,9,reg,New Orleans Saints,Jacksonville Jaguars,NO,41,24,17,3,65,40,FALSE,1,0,DOME,14,25
2007,9,reg,New York Jets,Washington Redskins,WAS,20,23,3,3.5,43,36,FALSE,0,0,"",0.5,7
2007,9,reg,Oakland Raiders,Houston Texans,OAK,17,24,7,3,41,41,FALSE,0,0,"",4,0
2007,9,reg,Philadelphia Eagles,Dallas Cowboys,DAL,17,38,21,3,55,46.5,FALSE,0,0,"",18,8.5
2007,9,reg,Tampa Bay Buccaneers,Arizona Cardinals,TB,17,10,7,3.5,27,39,FALSE,0,0,"",3.5,12
2007,9,reg,Tennessee Titans,Carolina Panthers,TEN,20,7,13,5.5,27,35.5,FALSE,0,0,"",7.5,8.5
2007,9,reg,Pittsburgh Steelers,Baltimore Ravens,PIT,38,7,31,9.5,45,36,FALSE,0,0,"",21.5,9
2007,10,reg,Arizona Cardinals,Detroit Lions,ARI,31,21,10,2,52,45,FALSE,1,0,DOME,8,7
2007,10,reg,Baltimore Ravens,Cincinnati Bengals,BAL,7,21,14,3,28,44.5,FALSE,0,0,"",11,16.5
2007,10,reg,Carolina Panthers,Atlanta Falcons,CAR,13,20,7,4,33,35.5,FALSE,0,0,"",3,2.5
2007,10,reg,Green Bay Packers,Minnesota Vikings,GB,34,0,34,6,34,40.5,FALSE,0,0,"",28,6.5
2007,10,reg,Kansas City Chiefs,Denver Broncos,KC,11,27,16,2.5,38,37,FALSE,0,0,"",13.5,1
2007,10,reg,Miami Dolphins,Buffalo Bills,BUF,10,13,3,2.5,23,40.5,FALSE,0,0,"",0.5,17.5
2007,10,reg,New Orleans Saints,St. Louis Rams,NO,29,37,8,10.5,66,47,FALSE,1,0,DOME,2.5,19
2007,10,reg,New York Giants,Dallas Cowboys,DAL,20,31,11,1.5,51,48,FALSE,0,0,"",9.5,3
2007,10,reg,Oakland Raiders,Chicago Bears,CHI,6,17,11,3.5,23,38,FALSE,0,0,"",7.5,15
2007,10,reg,Pittsburgh Steelers,Cleveland Browns,PIT,31,28,3,9.5,59,47.5,FALSE,0,0,"",6.5,11.5
2007,10,reg,San Diego Chargers,Indianapolis Colts,IND,23,21,2,3.5,44,47.5,FALSE,0,0,"",1.5,3.5
2007,10,reg,Tennessee Titans,Jacksonville Jaguars,TEN,13,28,15,3.5,41,36,FALSE,0,0,"",11.5,5
2007,10,reg,Washington Redskins,Philadelphia Eagles,WAS,25,33,8,2.5,58,37.5,FALSE,0,0,"",5.5,20.5
2007,10,reg,Seattle Seahawks,San Francisco 49ers,SEA,24,0,24,9,24,37.5,FALSE,0,0,"",15,13.5
2007,11,reg,Atlanta Falcons,Tampa Bay Buccaneers,TB,7,31,24,3,38,35.5,FALSE,1,0,DOME,21,2.5
2007,11,reg,Baltimore Ravens,Cleveland Browns,CLE,30,33,3,2,63,44,FALSE,0,0,"",1,19
2007,11,reg,Buffalo Bills,New England Patriots,NE,10,56,46,16,66,46.5,FALSE,0,0,"",30,19.5
2007,11,reg,Cincinnati Bengals,Arizona Cardinals,CIN,27,35,8,3.5,62,49.5,FALSE,0,0,"",4.5,12.5
2007,11,reg,Dallas Cowboys,Washington Redskins,DAL,28,23,5,11,51,47,FALSE,0,0,"",6,4
2007,11,reg,Detroit Lions,New York Giants,NYG,10,16,6,2.5,26,48,FALSE,1,0,DOME,3.5,22
2007,11,reg,Green Bay Packers,Carolina Panthers,GB,31,17,14,10,48,37.5,FALSE,0,0,"",4,10.5
2007,11,reg,Houston Texans,New Orleans Saints,HOU,23,10,13,1,33,50.5,FALSE,1,0,DOME,12,17.5
2007,11,reg,Indianapolis Colts,Kansas City Chiefs,IND,13,10,3,14.5,23,41.5,FALSE,1,0,DOME,11.5,18.5
2007,11,reg,Jacksonville Jaguars,San Diego Chargers,JAX,24,17,7,3,41,40.5,FALSE,0,0,"",4,0.5
2007,11,reg,Minnesota Vikings,Oakland Raiders,MIN,29,22,7,4.5,51,35.5,FALSE,1,0,DOME,2.5,15.5
2007,11,reg,New York Jets,Pittsburgh Steelers,PIT,19,16,3,9.5,35,40.5,FALSE,0,0,"",6.5,5.5
2007,11,reg,Philadelphia Eagles,Miami Dolphins,PHI,17,7,10,9.5,24,40,FALSE,0,0,"",0.5,16
2007,11,reg,San Francisco 49ers,St. Louis Rams,LAR,9,13,4,3,22,39.5,FALSE,0,0,"",1,17.5
2007,11,reg,Seattle Seahawks,Chicago Bears,SEA,30,23,7,5.5,53,37.5,FALSE,0,0,"",1.5,15.5
2007,11,reg,Denver Broncos,Tennessee Titans,PICK,34,20,14,0,54,38.5,FALSE,0,0,"",14,15.5
2007,12,reg,Atlanta Falcons,Indianapolis Colts,IND,13,31,18,14,44,42.5,FALSE,1,0,DOME,4,1.5
2007,12,reg,Dallas Cowboys,New York Jets,DAL,34,3,31,14.5,37,47.5,FALSE,0,0,"",16.5,10.5
2007,12,reg,Detroit Lions,Green Bay Packers,GB,26,37,11,3,63,47,FALSE,1,0,DOME,8,16
2007,12,reg,Arizona Cardinals,San Francisco 49ers,ARI,31,37,6,10.5,68,38,FALSE,1,0,DOME,4.5,30
2007,12,reg,Carolina Panthers,New Orleans Saints,NO,6,31,25,3,37,42,FALSE,0,0,"",22,5
2007,12,reg,Chicago Bears,Denver Broncos,CHI,37,34,3,1,71,41.5,FALSE,0,0,"",2,29.5
2007,12,reg,Cincinnati Bengals,Tennessee Titans,TEN,35,6,29,1,41,47,FALSE,0,0,"",28,6
2007,12,reg,Cleveland Browns,Houston Texans,CLE,27,17,10,3,44,52,FALSE,0,0,"",7,8
2007,12,reg,Jacksonville Jaguars,Buffalo Bills,JAX,36,14,22,9,50,37,FALSE,0,0,"",13,13
2007,12,reg,Kansas City Chiefs,Oakland Raiders,KC,17,20,3,4,37,34.5,FALSE,0,0,"",1,2.5
2007,12,reg,New England Patriots,Philadelphia Eagles,NE,31,28,3,24.5,59,51.5,FALSE,0,0,"",21.5,7.5
2007,12,reg,New York Giants,Minnesota Vikings,NYG,17,41,24,7.5,58,40,FALSE,0,0,"",16.5,18
2007,12,reg,San Diego Chargers,Baltimore Ravens,LAC,32,14,18,9,46,38.5,FALSE,0,0,"",9,7.5
2007,12,reg,St. Louis Rams,Seattle Seahawks,SEA,19,24,5,3,43,46,FALSE,1,0,DOME,2,3
2007,12,reg,Tampa Bay Buccaneers,Washington Redskins,TB,19,13,6,3,32,38.5,FALSE,0,0,"",3,6.5
2007,12,reg,Pittsburgh Steelers,Miami Dolphins,PIT,3,0,3,16,3,38.5,FALSE,0,0,"",13,35.5
2007,13,reg,Dallas Cowboys,Green Bay Packers,DAL,37,27,10,6.5,64,52.5,FALSE,0,0,"",3.5,11.5
2007,13,reg,Arizona Cardinals,Cleveland Browns,PICK,27,21,6,0,48,52,FALSE,1,0,DOME,6,4
2007,13,reg,Carolina Panthers,San Francisco 49ers,CAR,31,14,17,3,45,35,FALSE,0,0,"",14,10
2007,13,reg,Chicago Bears,New York Giants,NYG,16,21,5,1,37,39,FALSE,0,0,"",4,2
2007,13,reg,Indianapolis Colts,Jacksonville Jaguars,IND,28,25,3,7,53,45,FALSE,1,0,DOME,4,8
2007,13,reg,Kansas City Chiefs,San Diego Chargers,LAC,10,24,14,6,34,37.5,FALSE,0,0,"",8,3.5
2007,13,reg,Miami Dolphins,New York Jets,MIA,13,40,27,1,53,37.5,FALSE,0,0,"",26,15.5
2007,13,reg,Minnesota Vikings,Detroit Lions,MIN,42,10,32,4.5,52,44.5,FALSE,1,0,DOME,27.5,7.5
2007,13,reg,New Orleans Saints,Tampa Bay Buccaneers,NO,23,27,4,3,50,42,FALSE,1,0,DOME,1,8
2007,13,reg,Oakland Raiders,Denver Broncos,DEN,34,20,14,3,54,41.5,FALSE,0,0,"",11,12.5
2007,13,reg,Philadelphia Eagles,Seattle Seahawks,PHI,24,28,4,3,52,39,FALSE,0,0,"",1,13
2007,13,reg,Pittsburgh Steelers,Cincinnati Bengals,PIT,24,10,14,7,34,38,FALSE,0,0,"",7,4
2007,13,reg,St. Louis Rams,Atlanta Falcons,LAR,28,16,12,3,44,40,FALSE,1,0,DOME,9,4
2007,13,reg,Tennessee Titans,Houston Texans,TEN,28,20,8,3.5,48,40,FALSE,0,0,"",4.5,8
2007,13,reg,Washington Redskins,Buffalo Bills,WAS,16,17,1,6.5,33,37.5,FALSE,0,0,"",5.5,4.5
2007,13,reg,Baltimore Ravens,New England Patriots,NE,24,27,3,18.5,51,46.5,FALSE,0,0,"",15.5,4.5
2007,14,reg,Washington Redskins,Chicago Bears,WAS,24,16,8,3,40,40,FALSE,0,0,"",5,0
2007,14,reg,Baltimore Ravens,Indianapolis Colts,IND,20,44,24,9,64,42,FALSE,0,0,"",15,22
2007,14,reg,Buffalo Bills,Miami Dolphins,BUF,38,17,21,7,55,34,FALSE,0,0,"",14,21
2007,14,reg,Cincinnati Bengals,St. Louis Rams,CIN,19,10,9,10,29,45.5,FALSE,0,0,"",1,16.5
2007,14,reg,Denver Broncos,Kansas City Chiefs,DEN,41,7,34,7.5,48,37.5,FALSE,0,0,"",26.5,10.5
2007,14,reg,Detroit Lions,Dallas Cowboys,DAL,27,28,1,10.5,55,50.5,FALSE,1,0,DOME,9.5,4.5
2007,14,reg,Green Bay Packers,Oakland Raiders,GB,38,7,31,10,45,40.5,FALSE,0,0,"",21,4.5
2007,14,reg,Houston Texans,Tampa Bay Buccaneers,TB,28,14,14,2.5,42,40,FALSE,1,0,DOME,11.5,2
2007,14,reg,Jacksonville Jaguars,Carolina Panthers,JAX,37,6,31,10.5,43,39,FALSE,0,0,"",20.5,4
2007,14,reg,New England Patriots,Pittsburgh Steelers,NE,34,13,21,10.5,47,49.5,FALSE,0,0,"",10.5,2.5
2007,14,reg,New York Jets,Cleveland Browns,CLE,18,24,6,3.5,42,47.5,FALSE,0,0,"",2.5,5.5
2007,14,reg,Philadelphia Eagles,New York Giants,PHI,13,16,3,3,29,42,FALSE,0,0,"",0,13
2007,14,reg,San Francisco 49ers,Minnesota Vikings,MIN,7,27,20,8.5,34,39.5,FALSE,0,0,"",11.5,5.5
2007,14,reg,Seattle Seahawks,Arizona Cardinals,SEA,42,21,21,7.5,63,44.5,FALSE,0,0,"",13.5,18.5
2007,14,reg,Tennessee Titans,San Diego Chargers,LAC,17,23,6,1,40,40,FALSE,0,0,"",5,0
2007,14,reg,Atlanta Falcons,New Orleans Saints,NO,14,34,20,4.5,48,44,FALSE,1,0,DOME,15.5,4
2007,15,reg,Houston Texans,Denver Broncos,DEN,31,13,18,2.5,44,47.5,FALSE,1,0,DOME,15.5,3.5
2007,15,reg,San Francisco 49ers,Cincinnati Bengals,CIN,20,13,7,8.5,33,43,FALSE,0,0,"",1.5,10
2007,15,reg,Carolina Panthers,Seattle Seahawks,SEA,13,10,3,8,23,37,FALSE,0,0,"",5,14
2007,15,reg,Cleveland Browns,Buffalo Bills,CLE,8,0,8,5,8,37,FALSE,0,0,"",3,29
2007,15,reg,Dallas Cowboys,Philadelphia Eagles,DAL,6,10,4,10,16,49,FALSE,0,0,"",6,33
2007,15,reg,Kansas City Chiefs,Tennessee Titans,TEN,17,26,9,3.5,43,34.5,FALSE,0,0,"",5.5,8.5
2007,15,reg,Miami Dolphins,Baltimore Ravens,BAL,22,16,6,3,38,37.5,FALSE,0,0,"",3,0.5
2007,15,reg,New England Patriots,New York Jets,NE,20,10,10,20.5,30,41,FALSE,0,0,"",10.5,11
2007,15,reg,New Orleans Saints,Arizona Cardinals,NO,31,24,7,3.5,55,49.5,FALSE,1,0,DOME,3.5,5.5
2007,15,reg,New York Giants,Washington Redskins,NYG,10,22,12,6.5,32,36.5,FALSE,0,0,"",5.5,4.5
2007,15,reg,Oakland Raiders,Indianapolis Colts,IND,14,21,7,10,35,45,FALSE,0,0,"",3,10
2007,15,reg,Pittsburgh Steelers,Jacksonville Jaguars,PIT,22,29,7,3,51,34.5,FALSE,0,0,"",4,16.5
2007,15,reg,San Diego Chargers,Detroit Lions,LAC,51,14,37,9.5,65,46,FALSE,0,0,"",27.5,19
2007,15,reg,St. Louis Rams,Green Bay Packers,GB,14,33,19,7,47,47,FALSE,1,0,DOME,12,0
2007,15,reg,Tampa Bay Buccaneers,Atlanta Falcons,TB,37,3,34,12.5,40,37.5,FALSE,0,0,"",21.5,2.5
2007,15,reg,Minnesota Vikings,Chicago Bears,MIN,20,13,7,10.5,33,43.5,FALSE,1,0,DOME,3.5,10.5
2007,16,reg,St. Louis Rams,Pittsburgh Steelers,PIT,24,41,17,8,65,43,FALSE,1,0,DOME,9,22
2007,16,reg,Carolina Panthers,Dallas Cowboys,DAL,13,20,7,10.5,33,42.5,FALSE,0,0,"",3.5,9.5
2007,16,reg,Arizona Cardinals,Atlanta Falcons,ARI,30,27,3,10.5,57,43.5,FALSE,1,0,DOME,7.5,13.5
2007,16,reg,Buffalo Bills,New York Giants,NYG,21,38,17,3,59,32,FALSE,0,0,"",14,27
2007,16,reg,Chicago Bears,Green Bay Packers,GB,35,7,28,7.5,42,32,FALSE,0,0,"",20.5,10
2007,16,reg,Cincinnati Bengals,Cleveland Browns,CLE,19,14,5,3,33,47.5,FALSE,0,0,"",2,14.5
2007,16,reg,Detroit Lions,Kansas City Chiefs,DET,25,20,5,5,45,43.5,FALSE,1,0,DOME,0,1.5
2007,16,reg,Indianapolis Colts,Houston Texans,IND,38,15,23,6.5,53,45,FALSE,1,0,DOME,16.5,8
2007,16,reg,Jacksonville Jaguars,Oakland Raiders,JAX,49,11,38,13.5,60,39.5,FALSE,0,0,"",24.5,20.5
2007,16,reg,Minnesota Vikings,Washington Redskins,MIN,21,32,11,6.5,53,40.5,FALSE,1,0,DOME,4.5,12.5
2007,16,reg,New England Patriots,Miami Dolphins,NE,28,7,21,22.5,35,45.5,FALSE,0,0,"",1.5,10.5
2007,16,reg,New Orleans Saints,Philadelphia Eagles,NO,23,38,15,3,61,48,FALSE,1,0,DOME,12,13
2007,16,reg,San Francisco 49ers,Tampa Bay Buccaneers,TB,21,19,2,7,40,37,FALSE,0,0,"",5,3
2007,16,reg,Seattle Seahawks,Baltimore Ravens,SEA,27,6,21,13.5,33,39,FALSE,0,0,"",7.5,6
2007,16,reg,Tennessee Titans,New York Jets,TEN,10,6,4,9,16,37.5,FALSE,0,0,"",5,21.5
2007,16,reg,San Diego Chargers,Denver Broncos,LAC,23,3,20,8.5,26,47,FALSE,0,0,"",11.5,21
2007,17,reg,New York Giants,New England Patriots,NE,35,38,3,13.5,73,46.5,FALSE,0,0,"",10.5,26.5
2007,17,reg,Arizona Cardinals,St. Louis Rams,ARI,48,19,29,6,67,49,FALSE,1,0,DOME,23,18
2007,17,reg,Atlanta Falcons,Seattle Seahawks,SEA,44,41,3,2,85,38.5,FALSE,1,0,DOME,1,46.5
2007,17,reg,Baltimore Ravens,Pittsburgh Steelers,PIT,27,21,6,3,48,35.5,FALSE,0,0,"",3,12.5
2007,17,reg,Chicago Bears,New Orleans Saints,CHI,33,25,8,1,58,42,FALSE,0,0,"",7,16
2007,17,reg,Cleveland Browns,San Francisco 49ers,CLE,20,7,13,11.5,27,41,FALSE,0,0,"",1.5,14
2007,17,reg,Denver Broncos,Minnesota Vikings,MIN,22,19,3,3,41,40.5,FALSE,0,0,"",0,0.5
2007,17,reg,Green Bay Packers,Detroit Lions,GB,34,13,21,3,47,38.5,FALSE,0,0,"",18,8.5
2007,17,reg,Houston Texans,Jacksonville Jaguars,HOU,42,28,14,7,70,42,FALSE,1,0,DOME,7,28
2007,17,reg,Indianapolis Colts,Tennessee Titans,TEN,10,16,6,4.5,26,41,FALSE,1,0,DOME,1.5,15
2007,17,reg,Miami Dolphins,Cincinnati Bengals,CIN,25,38,13,3,63,45,FALSE,0,0,"",10,18
2007,17,reg,New York Jets,Kansas City Chiefs,NYJ,13,10,3,4.5,23,35,FALSE,0,0,"",1.5,12
2007,17,reg,Oakland Raiders,San Diego Chargers,LAC,17,30,13,9,47,42.5,FALSE,0,0,"",4,4.5
2007,17,reg,Philadelphia Eagles,Buffalo Bills,PHI,17,9,8,9,26,39,FALSE,0,0,"",1,13
2007,17,reg,Tampa Bay Buccaneers,Carolina Panthers,CAR,23,31,8,2.5,54,36,FALSE,0,0,"",5.5,18
2007,17,reg,Washington Redskins,Dallas Cowboys,WAS,27,6,21,9,33,39.5,FALSE,0,0,"",12,6.5
2007,Wildcard,post,Pittsburgh Steelers,Jacksonville Jaguars,JAX,29,31,2,2.5,60,40,FALSE,0,0,"",0.5,20
2007,Wildcard,post,Seattle Seahawks,Washington Redskins,SEA,35,14,21,3.5,49,38.5,FALSE,0,0,"",17.5,10.5
2007,Wildcard,post,San Diego Chargers,Tennessee Titans,LAC,17,6,11,10,23,39,FALSE,0,0,"",1,16
2007,Wildcard,post,Tampa Bay Buccaneers,New York Giants,TB,14,24,10,3,38,39.5,FALSE,0,0,"",7,1.5
2007,Division,post,Green Bay Packers,Seattle Seahawks,GB,42,20,22,7.5,62,44,FALSE,0,0,"",14.5,18
2007,Division,post,New England Patriots,Jacksonville Jaguars,NE,31,20,11,13.5,51,51.5,FALSE,0,0,"",2.5,0.5
2007,Division,post,Dallas Cowboys,New York Giants,DAL,17,21,4,7,38,47.5,FALSE,0,0,"",3,9.5
2007,Division,post,Indianapolis Colts,San Diego Chargers,IND,24,28,4,11,52,47,FALSE,1,0,DOME,7,5
2007,Conference,post,Green Bay Packers,New York Giants,GB,20,23,3,7.5,43,41.5,FALSE,0,0,"",4.5,1.5
2007,Conference,post,New England Patriots,San Diego Chargers,NE,21,12,9,14,33,48,FALSE,0,0,"",5,15
2007,Superbowl,post,New England Patriots,New York Giants,NE,14,17,3,12,31,55,TRUE,1,0,DOME,9,24
2008,1,reg,New York Giants,Washington Redskins,NYG,16,7,9,4.5,23,41.5,FALSE,0,0,"",4.5,18.5
2008,1,reg,Atlanta Falcons,Detroit Lions,DET,34,21,13,3,55,41,FALSE,1,0,DOME,10,14
2008,1,reg,Baltimore Ravens,Cincinnati Bengals,CIN,17,10,7,2,27,37.5,FALSE,0,0,"",5,10.5
2008,1,reg,Buffalo Bills,Seattle Seahawks,BUF,34,10,24,1,44,38.5,FALSE,0,0,"",23,5.5
2008,1,reg,Cleveland Browns,Dallas Cowboys,DAL,10,28,18,6,38,48.5,FALSE,0,0,"",12,10.5
2008,1,reg,Indianapolis Colts,Chicago Bears,IND,13,29,16,10,42,44,FALSE,1,0,DOME,6,2
2008,1,reg,Miami Dolphins,New York Jets,NYJ,14,20,6,3,34,36,FALSE,0,0,"",3,2
2008,1,reg,New England Patriots,Kansas City Chiefs,NE,17,10,7,16,27,43.5,FALSE,0,0,"",9,16.5
2008,1,reg,New Orleans Saints,Tampa Bay Buccaneers,NO,24,20,4,3,44,42.5,FALSE,1,0,DOME,1,1.5
2008,1,reg,Philadelphia Eagles,St. Louis Rams,PHI,38,3,35,8,41,44,FALSE,0,0,"",27,3
2008,1,reg,Pittsburgh Steelers,Houston Texans,PIT,38,17,21,6.5,55,43,FALSE,0,0,"",14.5,12
2008,1,reg,San Diego Chargers,Carolina Panthers,LAC,24,26,2,9.5,50,41,FALSE,0,0,"",7.5,9
2008,1,reg,San Francisco 49ers,Arizona Cardinals,ARI,13,23,10,2.5,36,42,FALSE,0,0,"",7.5,6
2008,1,reg,Tennessee Titans,Jacksonville Jaguars,JAX,17,10,7,3,27,36.5,FALSE,0,0,"",4,9.5
2008,1,reg,Green Bay Packers,Minnesota Vikings,GB,24,19,5,2.5,43,37.5,FALSE,0,0,"",2.5,5.5
2008,1,reg,Oakland Raiders,Denver Broncos,DEN,14,41,27,3,55,40.5,FALSE,0,0,"",24,14.5
2008,2,reg,Arizona Cardinals,Miami Dolphins,ARI,31,10,21,6.5,41,40.5,FALSE,1,0,DOME,14.5,0.5
2008,2,reg,Carolina Panthers,Chicago Bears,CAR,20,17,3,3,37,37.5,FALSE,0,0,"",0,0.5
2008,2,reg,Cincinnati Bengals,Tennessee Titans,CIN,7,24,17,1,31,37,FALSE,0,0,"",16,6
2008,2,reg,Cleveland Browns,Pittsburgh Steelers,PIT,6,10,4,6.5,16,43.5,FALSE,0,0,"",2.5,27.5
2008,2,reg,Denver Broncos,San Diego Chargers,DEN,39,38,1,1,77,46.5,FALSE,0,0,"",0,30.5
2008,2,reg,Detroit Lions,Green Bay Packers,GB,25,48,23,3,73,47,FALSE,1,0,DOME,20,26
2008,2,reg,Jacksonville Jaguars,Buffalo Bills,JAX,16,20,4,4,36,37,FALSE,0,0,"",0,1
2008,2,reg,Kansas City Chiefs,Oakland Raiders,KC,8,23,15,3.5,31,36,FALSE,0,0,"",11.5,5
2008,2,reg,Minnesota Vikings,Indianapolis Colts,IND,15,18,3,1,33,43.5,FALSE,1,0,DOME,2,10.5
2008,2,reg,New York Jets,New England Patriots,NYJ,10,19,9,1,29,37,FALSE,0,0,"",8,8
2008,2,reg,Seattle Seahawks,San Francisco 49ers,SEA,30,33,3,6.5,63,38,FALSE,0,0,"",3.5,25
2008,2,reg,St. Louis Rams,New York Giants,NYG,13,41,28,8,54,43.5,FALSE,1,0,DOME,20,10.5
2008,2,reg,Tampa Bay Buccaneers,Atlanta Falcons,TB,24,9,15,7,33,37.5,FALSE,0,0,"",8,4.5
2008,2,reg,Washington Redskins,New Orleans Saints,WAS,29,24,5,1,53,43.5,FALSE,0,0,"",4,9.5
2008,2,reg,Dallas Cowboys,Philadelphia Eagles,DAL,41,37,4,6.5,78,46.5,FALSE,0,0,"",2.5,31.5
2008,3,reg,Atlanta Falcons,Kansas City Chiefs,ATL,38,14,24,6.5,52,37,FALSE,1,0,DOME,17.5,15
2008,3,reg,Baltimore Ravens,Cleveland Browns,BAL,28,10,18,2.5,38,37,FALSE,0,0,"",15.5,1
2008,3,reg,Buffalo Bills,Oakland Raiders,BUF,24,23,1,10,47,37.5,FALSE,0,0,"",9,9.5
2008,3,reg,Chicago Bears,Tampa Bay Buccaneers,CHI,24,27,3,3,51,35,FALSE,0,0,"",0,16
2008,3,reg,Denver Broncos,New Orleans Saints,DEN,34,32,2,5.5,66,52,FALSE,0,0,"",3.5,14
2008,3,reg,Green Bay Packers,Dallas Cowboys,DAL,16,27,11,3,43,51,FALSE,0,0,"",8,8
2008,3,reg,Indianapolis Colts,Jacksonville Jaguars,IND,21,23,2,4,44,42,FALSE,1,0,DOME,2,2
2008,3,reg,Minnesota Vikings,Carolina Panthers,MIN,20,10,10,3,30,37.5,FALSE,1,0,DOME,7,7.5
2008,3,reg,New England Patriots,Miami Dolphins,NE,13,38,25,12.5,51,37,FALSE,0,0,"",12.5,14
2008,3,reg,New York Giants,Cincinnati Bengals,NYG,26,23,3,13,49,42.5,FALSE,0,0,"",10,6.5
2008,3,reg,Philadelphia Eagles,Pittsburgh Steelers,PHI,15,6,9,3.5,21,45,FALSE,0,0,"",5.5,24
2008,3,reg,San Francisco 49ers,Detroit Lions,SF,31,13,18,5,44,47,FALSE,0,0,"",13,3
2008,3,reg,Seattle Seahawks,St. Louis Rams,SEA,37,13,24,8,50,44.5,FALSE,0,0,"",16,5.5
2008,3,reg,Tennessee Titans,Houston Texans,TEN,31,12,19,5,43,40,FALSE,0,0,"",14,3
2008,3,reg,Washington Redskins,Arizona Cardinals,WAS,24,17,7,3,41,43.5,FALSE,0,0,"",4,2.5
2008,3,reg,San Diego Chargers,New York Jets,LAC,48,29,19,8,77,46.5,FALSE,0,0,"",11,30.5
2008,4,reg,Carolina Panthers,Atlanta Falcons,CAR,24,9,15,7,33,39,FALSE,0,0,"",8,6
2008,4,reg,Chicago Bears,Philadelphia Eagles,PHI,24,20,4,3,44,39,FALSE,0,0,"",1,5
2008,4,reg,Cincinnati Bengals,Cleveland Browns,CIN,12,20,8,1,32,42,FALSE,0,0,"",7,10
2008,4,reg,Dallas Cowboys,Washington Redskins,DAL,24,26,2,10,50,47,FALSE,0,0,"",8,3
2008,4,reg,Jacksonville Jaguars,Houston Texans,JAX,30,27,3,6.5,57,43,FALSE,0,0,"",3.5,14
2008,4,reg,Kansas City Chiefs,Denver Broncos,DEN,33,19,14,9,52,47,FALSE,0,0,"",5,5
2008,4,reg,New Orleans Saints,San Francisco 49ers,NO,31,17,14,4,48,48.5,FALSE,1,0,DOME,10,0.5
2008,4,reg,New York Jets,Arizona Cardinals,NYJ,56,35,21,1.5,91,43.5,FALSE,0,0,"",19.5,47.5
2008,4,reg,Oakland Raiders,San Diego Chargers,LAC,18,28,10,8,46,45.5,FALSE,0,0,"",2,0.5
2008,4,reg,St. Louis Rams,Buffalo Bills,BUF,14,31,17,8.5,45,43.5,FALSE,1,0,DOME,8.5,1.5
2008,4,reg,Tampa Bay Buccaneers,Green Bay Packers,TB,30,21,9,2,51,43,FALSE,0,0,"",7,8
2008,4,reg,Tennessee Titans,Minnesota Vikings,TEN,30,17,13,3,47,35,FALSE,0,0,"",10,12
2008,4,reg,Pittsburgh Steelers,Baltimore Ravens,PIT,23,20,3,6,43,34.5,FALSE,0,0,"",3,8.5
2008,5,reg,Arizona Cardinals,Buffalo Bills,ARI,41,17,24,2.5,58,44.5,FALSE,1,0,DOME,21.5,13.5
2008,5,reg,Baltimore Ravens,Tennessee Titans,TEN,10,13,3,1,23,33.5,FALSE,0,0,"",2,10.5
2008,5,reg,Carolina Panthers,Kansas City Chiefs,CAR,34,0,34,10,34,38,FALSE,0,0,"",24,4
2008,5,reg,Dallas Cowboys,Cincinnati Bengals,DAL,31,22,9,16,53,46,FALSE,0,0,"",7,7
2008,5,reg,Denver Broncos,Tampa Bay Buccaneers,DEN,16,13,3,4,29,47,FALSE,0,0,"",1,18
2008,5,reg,Detroit Lions,Chicago Bears,CHI,7,34,27,3,41,45.5,FALSE,1,0,DOME,24,4.5
2008,5,reg,Green Bay Packers,Atlanta Falcons,GB,24,27,3,5,51,42.5,FALSE,0,0,"",2,8.5
2008,5,reg,Houston Texans,Indianapolis Colts,IND,27,31,4,4.5,58,48.5,FALSE,1,0,DOME,0.5,9.5
2008,5,reg,Jacksonville Jaguars,Pittsburgh Steelers,JAX,21,26,5,5,47,37,FALSE,0,0,"",0,10
2008,5,reg,Miami Dolphins,San Diego Chargers,LAC,17,10,7,6,27,44.5,FALSE,0,0,"",1,17.5
2008,5,reg,New York Giants,Seattle Seahawks,NYG,44,6,38,6.5,50,43.5,FALSE,0,0,"",31.5,6.5
2008,5,reg,Philadelphia Eagles,Washington Redskins,PHI,17,23,6,6.5,40,42,FALSE,0,0,"",0.5,2
2008,5,reg,San Francisco 49ers,New England Patriots,NE,21,30,9,3,51,41,FALSE,0,0,"",6,10
2008,5,reg,New Orleans Saints,Minnesota Vikings,NO,27,30,3,3,57,47,FALSE,1,0,DOME,0,10
2008,6,reg,Arizona Cardinals,Dallas Cowboys,DAL,30,24,6,5,54,53,FALSE,1,0,DOME,1,1
2008,6,reg,Atlanta Falcons,Chicago Bears,CHI,22,20,2,3,42,43.5,FALSE,1,0,DOME,1,1.5
2008,6,reg,Denver Broncos,Jacksonville Jaguars,DEN,17,24,7,3,41,48,FALSE,0,0,"",4,7
2008,6,reg,Houston Texans,Miami Dolphins,HOU,29,28,1,3,57,44.5,FALSE,1,0,DOME,2,12.5
2008,6,reg,Indianapolis Colts,Baltimore Ravens,IND,31,3,28,4,34,38.5,FALSE,1,0,DOME,24,4.5
2008,6,reg,Minnesota Vikings,Detroit Lions,MIN,12,10,2,13,22,45.5,FALSE,1,0,DOME,11,23.5
2008,6,reg,New Orleans Saints,Oakland Raiders,NO,34,3,31,7,37,47.5,FALSE,1,0,DOME,24,10.5
2008,6,reg,New York Jets,Cincinnati Bengals,NYJ,26,14,12,8,40,42.5,FALSE,0,0,"",4,2.5
2008,6,reg,San Diego Chargers,New England Patriots,LAC,30,10,20,6,40,44,FALSE,0,0,"",14,4
2008,6,reg,San Francisco 49ers,Philadelphia Eagles,PHI,26,40,14,5,66,41.5,FALSE,0,0,"",9,24.5
2008,6,reg,Seattle Seahawks,Green Bay Packers,SEA,17,27,10,1,44,44.5,FALSE,0,0,"",9,0.5
2008,6,reg,Tampa Bay Buccaneers,Carolina Panthers,TB,27,3,24,1,30,36.5,FALSE,0,0,"",23,6.5
2008,6,reg,Washington Redskins,St. Louis Rams,WAS,17,19,2,13.5,36,44,FALSE,0,0,"",11.5,8
2008,6,reg,Cleveland Browns,New York Giants,NYG,35,14,21,8,49,43.5,FALSE,0,0,"",13,5.5
2008,7,reg,Buffalo Bills,San Diego Chargers,BUF,23,14,9,1,37,45,FALSE,0,0,"",8,8
2008,7,reg,Carolina Panthers,New Orleans Saints,CAR,30,7,23,3,37,44.5,FALSE,0,0,"",20,7.5
2008,7,reg,Chicago Bears,Minnesota Vikings,CHI,48,41,7,3,89,38,FALSE,0,0,"",4,51
2008,7,reg,Cincinnati Bengals,Pittsburgh Steelers,PIT,10,38,28,8.5,48,37,FALSE,0,0,"",19.5,11
2008,7,reg,Green Bay Packers,Indianapolis Colts,IND,34,14,20,2.5,48,47,FALSE,0,0,"",17.5,1
2008,7,reg,Houston Texans,Detroit Lions,HOU,28,21,7,11.5,49,47.5,FALSE,1,0,DOME,4.5,1.5
2008,7,reg,Kansas City Chiefs,Tennessee Titans,TEN,10,34,24,9,44,35,FALSE,0,0,"",15,9
2008,7,reg,Miami Dolphins,Baltimore Ravens,MIA,13,27,14,3,40,35,FALSE,0,0,"",11,5
2008,7,reg,New York Giants,San Francisco 49ers,NYG,29,17,12,10,46,47,FALSE,0,0,"",2,1
2008,7,reg,Oakland Raiders,New York Jets,NYJ,16,13,3,3,29,41,FALSE,0,0,"",0,12
2008,7,reg,St. Louis Rams,Dallas Cowboys,DAL,34,14,20,8,48,45,FALSE,1,0,DOME,12,3
2008,7,reg,Tampa Bay Buccaneers,Seattle Seahawks,TB,20,10,10,11.5,30,40.5,FALSE,0,0,"",1.5,10.5
2008,7,reg,Washington Redskins,Cleveland Browns,WAS,14,11,3,7,25,42,FALSE,0,0,"",4,17
2008,7,reg,New England Patriots,Denver Broncos,NE,41,7,34,3,48,48,FALSE,0,0,"",31,0
2008,8,reg,Baltimore Ravens,Oakland Raiders,BAL,29,10,19,8,39,34.5,FALSE,0,0,"",11,4.5
2008,8,reg,Carolina Panthers,Arizona Cardinals,CAR,27,23,4,5.5,50,43,FALSE,0,0,"",1.5,7
2008,8,reg,Dallas Cowboys,Tampa Bay Buccaneers,DAL,13,9,4,1.5,22,40.5,FALSE,0,0,"",2.5,18.5
2008,8,reg,Detroit Lions,Washington Redskins,WAS,17,25,8,7,42,42,FALSE,1,0,DOME,1,0
2008,8,reg,Houston Texans,Cincinnati Bengals,HOU,35,6,29,9,41,45.5,FALSE,1,0,DOME,20,4.5
2008,8,reg,Jacksonville Jaguars,Cleveland Browns,JAX,17,23,6,7,40,42,FALSE,0,0,"",1,2
2008,8,reg,Miami Dolphins,Buffalo Bills,MIA,25,16,9,1,41,41.5,FALSE,0,0,"",8,0.5
2008,8,reg,New England Patriots,St. Louis Rams,NE,23,16,7,9,39,41,FALSE,0,0,"",2,2
2008,8,reg,New Orleans Saints,San Diego Chargers,LAC,37,32,5,3,69,45.5,TRUE,0,0,"",2,23.5
2008,8,reg,New York Jets,Kansas City Chiefs,NYJ,28,24,4,14,52,41,FALSE,0,0,"",10,11
2008,8,reg,Philadelphia Eagles,Atlanta Falcons,PHI,27,14,13,9.5,41,45,FALSE,0,0,"",3.5,4
2008,8,reg,Pittsburgh Steelers,New York Giants,PIT,14,21,7,3,35,41,FALSE,0,0,"",4,6
2008,8,reg,San Francisco 49ers,Seattle Seahawks,SF,13,34,21,5.5,47,41.5,FALSE,0,0,"",15.5,5.5
2008,8,reg,Tennessee Titans,Indianapolis Colts,TEN,31,21,10,4,52,41.5,FALSE,0,0,"",6,10.5
2008,9,reg,Buffalo Bills,New York Jets,BUF,17,26,9,5,43,43,FALSE,0,0,"",4,0
2008,9,reg,Chicago Bears,Detroit Lions,CHI,27,23,4,12.5,50,43.5,FALSE,0,0,"",8.5,6.5
2008,9,reg,Cincinnati Bengals,Jacksonville Jaguars,JAX,21,19,2,7.5,40,40,FALSE,0,0,"",5.5,0
2008,9,reg,Cleveland Browns,Baltimore Ravens,CLE,27,37,10,2.5,64,36.5,FALSE,0,0,"",7.5,27.5
2008,9,reg,Denver Broncos,Miami Dolphins,DEN,17,26,9,4,43,50,FALSE,0,0,"",5,7
2008,9,reg,Indianapolis Colts,New England Patriots,IND,18,15,3,6.5,33,44,FALSE,1,0,DOME,3.5,11
2008,9,reg,Kansas City Chiefs,Tampa Bay Buccaneers,TB,27,30,3,9.5,57,36.5,FALSE,0,0,"",6.5,20.5
2008,9,reg,Minnesota Vikings,Houston Texans,MIN,28,21,7,5.5,49,47,FALSE,1,0,DOME,1.5,2
2008,9,reg,New York Giants,Dallas Cowboys,NYG,35,14,21,8.5,49,42,FALSE,0,0,"",12.5,7
2008,9,reg,Oakland Raiders,Atlanta Falcons,ATL,0,24,24,3,24,41.5,FALSE,0,0,"",21,17.5
2008,9,reg,Seattle Seahawks,Philadelphia Eagles,PHI,7,26,19,6.5,33,43,FALSE,0,0,"",12.5,10
2008,9,reg,St. Louis Rams,Arizona Cardinals,ARI,13,34,21,3,47,50,FALSE,1,0,DOME,18,3
2008,9,reg,Tennessee Titans,Green Bay Packers,TEN,19,16,3,3.5,35,41,FALSE,0,0,"",0.5,6
2008,9,reg,Washington Redskins,Pittsburgh Steelers,WAS,6,23,17,2.5,29,37,FALSE,0,0,"",14.5,8
2008,10,reg,Cleveland Browns,Denver Broncos,CLE,30,34,4,3,64,47,FALSE,0,0,"",1,17
2008,10,reg,Atlanta Falcons,New Orleans Saints,ATL,34,20,14,1.5,54,51,FALSE,1,0,DOME,12.5,3
2008,10,reg,Chicago Bears,Tennessee Titans,TEN,14,21,7,3,35,37,FALSE,0,0,"",4,2
2008,10,reg,Detroit Lions,Jacksonville Jaguars,JAX,14,38,24,5,52,43,FALSE,1,0,DOME,19,9
2008,10,reg,Houston Texans,Baltimore Ravens,HOU,13,41,28,2.5,54,44,FALSE,1,0,DOME,25.5,10
2008,10,reg,Miami Dolphins,Seattle Seahawks,MIA,21,19,2,7.5,40,42,FALSE,0,0,"",5.5,2
2008,10,reg,Minnesota Vikings,Green Bay Packers,MIN,28,27,1,2.5,55,44.5,FALSE,1,0,DOME,1.5,10.5
2008,10,reg,New England Patriots,Buffalo Bills,NE,20,10,10,3.5,30,41,FALSE,0,0,"",6.5,11
2008,10,reg,New York Jets,St. Louis Rams,NYJ,47,3,44,9.5,50,43.5,FALSE,0,0,"",34.5,6.5
2008,10,reg,Oakland Raiders,Carolina Panthers,CAR,6,17,11,9.5,23,37.5,FALSE,0,0,"",1.5,14.5
2008,10,reg,Philadelphia Eagles,New York Giants,PHI,31,36,5,1.5,67,42.5,FALSE,0,0,"",3.5,24.5
2008,10,reg,Pittsburgh Steelers,Indianapolis Colts,PIT,20,24,4,3.5,44,39,FALSE,0,0,"",0.5,5
2008,10,reg,San Diego Chargers,Kansas City Chiefs,LAC,20,19,1,14.5,39,47.5,FALSE,0,0,"",13.5,8.5
2008,10,reg,Arizona Cardinals,San Francisco 49ers,ARI,29,24,5,9.5,53,47.5,FALSE,1,0,DOME,4.5,5.5
2008,11,reg,New England Patriots,New York Jets,NE,31,34,3,3.5,65,42.5,FALSE,0,0,"",0.5,22.5
2008,11,reg,Atlanta Falcons,Denver Broncos,ATL,20,24,4,6.5,44,52,FALSE,1,0,DOME,2.5,8
2008,11,reg,Carolina Panthers,Detroit Lions,CAR,31,22,9,14,53,40.5,FALSE,0,0,"",5,12.5
2008,11,reg,Cincinnati Bengals,Philadelphia Eagles,PHI,13,13,0,9,26,41,FALSE,0,0,"",9,15
2008,11,reg,Green Bay Packers,Chicago Bears,GB,37,3,34,3.5,40,43,FALSE,0,0,"",30.5,3
2008,11,reg,Indianapolis Colts,Houston Texans,IND,33,27,6,8,60,50.5,FALSE,1,0,DOME,2,9.5
2008,11,reg,Jacksonville Jaguars,Tennessee Titans,TEN,14,24,10,3,38,40,FALSE,0,0,"",7,2
2008,11,reg,Kansas City Chiefs,New Orleans Saints,NO,20,30,10,6,50,51,FALSE,0,0,"",4,1
2008,11,reg,Miami Dolphins,Oakland Raiders,MIA,17,15,2,10,32,37.5,FALSE,0,0,"",8,5.5
2008,11,reg,New York Giants,Baltimore Ravens,NYG,30,10,20,7,40,40,FALSE,0,0,"",13,0
2008,11,reg,Pittsburgh Steelers,San Diego Chargers,PIT,11,10,1,4.5,21,40.5,FALSE,0,0,"",3.5,19.5
2008,11,reg,San Francisco 49ers,St. Louis Rams,SF,35,16,19,7,51,43.5,FALSE,0,0,"",12,7.5
2008,11,reg,Seattle Seahawks,Arizona Cardinals,ARI,20,26,6,3,46,48,FALSE,0,0,"",3,2
2008,11,reg,Tampa Bay Buccaneers,Minnesota Vikings,TB,19,13,6,5.5,32,38.5,FALSE,0,0,"",0.5,6.5
2008,11,reg,Washington Redskins,Dallas Cowboys,DAL,10,14,4,2,24,43,FALSE,0,0,"",2,19
2008,11,reg,Buffalo Bills,Cleveland Browns,BUF,27,29,2,5,56,40,FALSE,0,0,"",3,16
2008,12,reg,Pittsburgh Steelers,Cincinnati Bengals,PIT,27,10,17,11.5,37,34.5,FALSE,0,0,"",5.5,2.5
2008,12,reg,Arizona Cardinals,New York Giants,NYG,29,37,8,3,66,48.5,FALSE,1,0,DOME,5,17.5
2008,12,reg,Atlanta Falcons,Carolina Panthers,ATL,45,28,17,1,73,41.5,FALSE,1,0,DOME,16,31.5
2008,12,reg,Baltimore Ravens,Philadelphia Eagles,BAL,36,7,29,2,43,39.5,FALSE,0,0,"",27,3.5
2008,12,reg,Cleveland Browns,Houston Texans,CLE,6,16,10,3,22,49.5,FALSE,0,0,"",7,27.5
2008,12,reg,Dallas Cowboys,San Francisco 49ers,DAL,35,22,13,9.5,57,45.5,FALSE,0,0,"",3.5,11.5
2008,12,reg,Denver Broncos,Oakland Raiders,DEN,10,31,21,9,41,43.5,FALSE,0,0,"",12,2.5
2008,12,reg,Detroit Lions,Tampa Bay Buccaneers,TB,20,38,18,8,58,42.5,FALSE,1,0,DOME,10,15.5
2008,12,reg,Jacksonville Jaguars,Minnesota Vikings,JAX,12,30,18,2.5,42,41.5,FALSE,0,0,"",15.5,0.5
2008,12,reg,Kansas City Chiefs,Buffalo Bills,BUF,31,54,23,3,85,43.5,FALSE,0,0,"",20,41.5
2008,12,reg,Miami Dolphins,New England Patriots,NE,28,48,20,2,76,42.5,FALSE,0,0,"",18,33.5
2008,12,reg,San Diego Chargers,Indianapolis Colts,LAC,20,23,3,3,43,49,FALSE,0,0,"",0,6
2008,12,reg,Seattle Seahawks,Washington Redskins,WAS,17,20,3,3,37,40,FALSE,0,0,"",0,3
2008,12,reg,St. Louis Rams,Chicago Bears,CHI,3,27,24,7,30,44.5,FALSE,1,0,DOME,17,14.5
2008,12,reg,Tennessee Titans,New York Jets,TEN,13,34,21,5.5,47,41,FALSE,0,0,"",15.5,6
2008,12,reg,New Orleans Saints,Green Bay Packers,NO,51,29,22,1,80,52,FALSE,1,0,DOME,21,28
2008,13,reg,Dallas Cowboys,Seattle Seahawks,DAL,34,9,25,12,43,46.5,FALSE,0,0,"",13,3.5
2008,13,reg,Detroit Lions,Tennessee Titans,TEN,10,47,37,11,57,44,FALSE,1,0,DOME,26,13
2008,13,reg,Philadelphia Eagles,Arizona Cardinals,PHI,48,20,28,3,68,49,FALSE,0,0,"",25,19
2008,13,reg,Buffalo Bills,San Francisco 49ers,BUF,3,10,7,6.5,13,43,FALSE,0,0,"",0.5,30
2008,13,reg,Cincinnati Bengals,Baltimore Ravens,BAL,3,34,31,7,37,36,FALSE,0,0,"",24,1
2008,13,reg,Cleveland Browns,Indianapolis Colts,IND,6,10,4,4,16,44,FALSE,0,0,"",0,28
2008,13,reg,Green Bay Packers,Carolina Panthers,GB,31,35,4,3,66,41.5,FALSE,0,0,"",1,24.5
2008,13,reg,Minnesota Vikings,Chicago Bears,MIN,34,14,20,5,48,42.5,FALSE,1,0,DOME,15,5.5
2008,13,reg,New England Patriots,Pittsburgh Steelers,NE,10,33,23,2.5,43,40,FALSE,0,0,"",20.5,3
2008,13,reg,New York Jets,Denver Broncos,NYJ,17,34,17,8,51,48,FALSE,0,0,"",9,3
2008,13,reg,Oakland Raiders,Kansas City Chiefs,OAK,13,20,7,3.5,33,41.5,FALSE,0,0,"",3.5,8.5
2008,13,reg,San Diego Chargers,Atlanta Falcons,LAC,16,22,6,6.5,38,48,FALSE,0,0,"",0.5,10
2008,13,reg,St. Louis Rams,Miami Dolphins,MIA,12,16,4,7,28,44.5,FALSE,1,0,DOME,3,16.5
2008,13,reg,Tampa Bay Buccaneers,New Orleans Saints,TB,23,20,3,3.5,43,43.5,FALSE,0,0,"",0.5,0.5
2008,13,reg,Washington Redskins,New York Giants,NYG,7,23,16,4,30,41,FALSE,0,0,"",12,11
2008,13,reg,Houston Texans,Jacksonville Jaguars,HOU,30,17,13,3,47,48.5,FALSE,1,0,DOME,10,1.5
2008,14,reg,San Diego Chargers,Oakland Raiders,LAC,34,7,27,9,41,41,FALSE,0,0,"",18,0
2008,14,reg,Arizona Cardinals,St. Louis Rams,ARI,34,10,24,14.5,44,48.5,FALSE,1,0,DOME,9.5,4.5
2008,14,reg,Baltimore Ravens,Washington Redskins,BAL,24,10,14,6.5,34,35,FALSE,0,0,"",7.5,1
2008,14,reg,Buffalo Bills,Miami Dolphins,BUF,3,16,13,2,19,42.5,TRUE,1,0,DOME,11,23.5
2008,14,reg,Chicago Bears,Jacksonville Jaguars,CHI,23,10,13,6.5,33,40,FALSE,0,0,"",6.5,7
2008,14,reg,Denver Broncos,Kansas City Chiefs,DEN,24,17,7,9,41,49,FALSE,0,0,"",2,8
2008,14,reg,Detroit Lions,Minnesota Vikings,MIN,16,20,4,10.5,36,45.5,FALSE,1,0,DOME,6.5,9.5
2008,14,reg,Green Bay Packers,Houston Texans,GB,21,24,3,7,45,47.5,FALSE,0,0,"",4,2.5
2008,14,reg,Indianapolis Colts,Cincinnati Bengals,IND,35,3,32,13.5,38,41.5,FALSE,1,0,DOME,18.5,3.5
2008,14,reg,New Orleans Saints,Atlanta Falcons,NO,29,25,4,3,54,51.5,FALSE,1,0,DOME,1,2.5
2008,14,reg,New York Giants,Philadelphia Eagles,NYG,14,20,6,7,34,40.5,FALSE,0,0,"",1,6.5
2008,14,reg,Pittsburgh Steelers,Dallas Cowboys,PIT,20,13,7,4,33,38.5,FALSE,0,0,"",3,5.5
2008,14,reg,San Francisco 49ers,New York Jets,NYJ,24,14,10,5,38,45.5,FALSE,0,0,"",5,7.5
2008,14,reg,Seattle Seahawks,New England Patriots,NE,21,24,3,7.5,45,43,FALSE,0,0,"",4.5,2
2008,14,reg,Tennessee Titans,Cleveland Browns,TEN,28,9,19,13.5,37,36.5,FALSE,0,0,"",5.5,0.5
2008,14,reg,Carolina Panthers,Tampa Bay Buccaneers,CAR,38,23,15,3,61,38.5,FALSE,0,0,"",12,22.5
2008,15,reg,Chicago Bears,New Orleans Saints,CHI,27,24,3,3,51,46,FALSE,0,0,"",0,5
2008,15,reg,Arizona Cardinals,Minnesota Vikings,ARI,14,35,21,3.5,49,46.5,FALSE,1,0,DOME,17.5,2.5
2008,15,reg,Atlanta Falcons,Tampa Bay Buccaneers,ATL,13,10,3,4.5,23,43.5,FALSE,1,0,DOME,1.5,20.5
2008,15,reg,Baltimore Ravens,Pittsburgh Steelers,BAL,9,13,4,3,22,34,FALSE,0,0,"",1,12
2008,15,reg,Carolina Panthers,Denver Broncos,CAR,30,10,20,7.5,40,48,FALSE,0,0,"",12.5,8
2008,15,reg,Cincinnati Bengals,Washington Redskins,WAS,20,13,7,6.5,33,36.5,FALSE,0,0,"",0.5,3.5
2008,15,reg,Dallas Cowboys,New York Giants,DAL,20,8,12,3,28,46,FALSE,0,0,"",9,18
2008,15,reg,Houston Texans,Tennessee Titans,TEN,13,12,1,3,25,45,FALSE,1,0,DOME,2,20
2008,15,reg,Indianapolis Colts,Detroit Lions,IND,31,21,10,17,52,45,FALSE,1,0,DOME,7,7
2008,15,reg,Jacksonville Jaguars,Green Bay Packers,GB,20,16,4,2.5,36,46,FALSE,0,0,"",1.5,10
2008,15,reg,Kansas City Chiefs,San Diego Chargers,LAC,21,22,1,5.5,43,41,FALSE,0,0,"",4.5,2
2008,15,reg,Miami Dolphins,San Francisco 49ers,MIA,14,9,5,5.5,23,41,FALSE,0,0,"",0.5,18
2008,15,reg,New York Jets,Buffalo Bills,NYJ,31,27,4,8,58,41,FALSE,0,0,"",4,17
2008,15,reg,Oakland Raiders,New England Patriots,NE,26,49,23,7,75,39.5,FALSE,0,0,"",16,35.5
2008,15,reg,St. Louis Rams,Seattle Seahawks,SEA,20,23,3,2.5,43,42,FALSE,1,0,DOME,0.5,1
2008,15,reg,Philadelphia Eagles,Cleveland Browns,PHI,30,10,20,16,40,40,FALSE,0,0,"",4,0
2008,16,reg,Jacksonville Jaguars,Indianapolis Colts,IND,24,31,7,6,55,44,FALSE,0,0,"",1,11
2008,16,reg,Dallas Cowboys,Baltimore Ravens,DAL,24,33,9,5.5,57,39,FALSE,0,0,"",3.5,18
2008,16,reg,Cleveland Browns,Cincinnati Bengals,CLE,0,14,14,2,14,31.5,FALSE,0,0,"",12,17.5
2008,16,reg,Denver Broncos,Buffalo Bills,DEN,23,30,7,6.5,53,46.5,FALSE,0,0,"",0.5,6.5
2008,16,reg,Detroit Lions,New Orleans Saints,NO,7,42,35,7,49,50.5,FALSE,1,0,DOME,28,1.5
2008,16,reg,Kansas City Chiefs,Miami Dolphins,MIA,31,38,7,3.5,69,37.5,FALSE,0,0,"",3.5,31.5
2008,16,reg,Minnesota Vikings,Atlanta Falcons,MIN,17,24,7,3,41,43.5,FALSE,1,0,DOME,4,2.5
2008,16,reg,New England Patriots,Arizona Cardinals,NE,47,7,40,8,54,41,FALSE,0,0,"",32,13
2008,16,reg,New York Giants,Carolina Panthers,NYG,34,28,6,4,62,38,FALSE,0,0,"",2,24
2008,16,reg,Oakland Raiders,Houston Texans,HOU,27,16,11,7,43,43,FALSE,0,0,"",4,0
2008,16,reg,Seattle Seahawks,New York Jets,NYJ,13,3,10,3.5,16,41,FALSE,0,0,"",6.5,25
2008,16,reg,St. Louis Rams,San Francisco 49ers,SF,16,17,1,3.5,33,42,FALSE,1,0,DOME,2.5,9
2008,16,reg,Tampa Bay Buccaneers,San Diego Chargers,TB,24,41,17,4.5,65,42.5,FALSE,0,0,"",12.5,22.5
2008,16,reg,Tennessee Titans,Pittsburgh Steelers,PIT,31,14,17,3,45,34,FALSE,0,0,"",14,11
2008,16,reg,Washington Redskins,Philadelphia Eagles,PHI,10,3,7,6,13,37.5,FALSE,0,0,"",1,24.5
2008,16,reg,Chicago Bears,Green Bay Packers,CHI,20,17,3,4,37,40,FALSE,0,0,"",1,3
2008,17,reg,Arizona Cardinals,Seattle Seahawks,ARI,34,21,13,7,55,47,FALSE,1,0,DOME,6,8
2008,17,reg,Atlanta Falcons,St. Louis Rams,ATL,31,27,4,14,58,44.5,FALSE,1,0,DOME,10,13.5
2008,17,reg,Baltimore Ravens,Jacksonville Jaguars,BAL,27,7,20,10.5,34,37.5,FALSE,0,0,"",9.5,3.5
2008,17,reg,Buffalo Bills,New England Patriots,NE,0,13,13,5.5,13,34.5,FALSE,0,0,"",7.5,21.5
2008,17,reg,Cincinnati Bengals,Kansas City Chiefs,CIN,16,6,10,1.5,22,40,FALSE,0,0,"",8.5,18
2008,17,reg,Green Bay Packers,Detroit Lions,GB,31,21,10,11,52,41.5,FALSE,0,0,"",1,10.5
2008,17,reg,Houston Texans,Chicago Bears,HOU,31,24,7,3,55,46,FALSE,1,0,DOME,4,9
2008,17,reg,Indianapolis Colts,Tennessee Titans,TEN,23,0,23,3,23,39.5,FALSE,1,0,DOME,20,16.5
2008,17,reg,Minnesota Vikings,New York Giants,MIN,20,19,1,7,39,41,FALSE,1,0,DOME,6,2
2008,17,reg,New Orleans Saints,Carolina Panthers,CAR,31,33,2,1.5,64,51.5,FALSE,1,0,DOME,0.5,12.5
2008,17,reg,New York Jets,Miami Dolphins,NYJ,17,24,7,2.5,41,43,FALSE,0,0,"",4.5,2
2008,17,reg,Philadelphia Eagles,Dallas Cowboys,PHI,44,6,38,2,50,40.5,FALSE,0,0,"",36,9.5
2008,17,reg,Pittsburgh Steelers,Cleveland Browns,PIT,31,0,31,11.5,31,33,FALSE,0,0,"",19.5,2
2008,17,reg,San Diego Chargers,Denver Broncos,LAC,52,21,31,7,73,50.5,FALSE,0,0,"",24,22.5
2008,17,reg,San Francisco 49ers,Washington Redskins,SF,27,24,3,3,51,37,FALSE,0,0,"",0,14
2008,17,reg,Tampa Bay Buccaneers,Oakland Raiders,TB,24,31,7,10.5,55,39.5,FALSE,0,0,"",3.5,15.5
2008,Wildcard,post,Arizona Cardinals,Atlanta Falcons,ARI,30,24,6,2,54,52,FALSE,1,0,DOME,4,2
2008,Wildcard,post,San Diego Chargers,Indianapolis Colts,IND,23,17,6,2.5,40,50,FALSE,0,0,"",3.5,10
2008,Wildcard,post,Miami Dolphins,Baltimore Ravens,BAL,9,27,18,3.5,36,38,FALSE,0,0,"",14.5,2
2008,Wildcard,post,Minnesota Vikings,Philadelphia Eagles,PHI,14,26,12,3.5,40,41,FALSE,1,0,DOME,8.5,1
2008,Division,post,Carolina Panthers,Arizona Cardinals,CAR,13,33,20,10,46,49.5,FALSE,0,0,"",10,3.5
2008,Division,post,Tennessee Titans,Baltimore Ravens,TEN,10,13,3,3,23,33.5,FALSE,0,0,"",0,10.5
2008,Division,post,New York Giants,Philadelphia Eagles,NYG,11,23,12,4,34,39,FALSE,0,0,"",8,5
2008,Division,post,Pittsburgh Steelers,San Diego Chargers,PIT,35,24,11,6.5,59,38.5,FALSE,0,0,"",4.5,20.5
2008,Conference,post,Arizona Cardinals,Philadelphia Eagles,PHI,32,25,7,3.5,57,47,FALSE,1,0,DOME,3.5,10
2008,Conference,post,Pittsburgh Steelers,Baltimore Ravens,PIT,23,14,9,6,37,35.5,FALSE,0,0,"",3,1.5
2008,Superbowl,post,Arizona Cardinals,Pittsburgh Steelers,PIT,23,27,4,7,50,46,TRUE,0,0,"",3,4
2009,1,reg,Pittsburgh Steelers,Tennessee Titans,PIT,13,10,3,6.5,23,35,FALSE,0,0,"",3.5,12
2009,1,reg,Arizona Cardinals,San Francisco 49ers,ARI,16,20,4,4.5,36,45,FALSE,1,0,DOME,0.5,9
2009,1,reg,Atlanta Falcons,Miami Dolphins,ATL,19,7,12,4,26,44.5,FALSE,1,0,DOME,8,18.5
2009,1,reg,Baltimore Ravens,Kansas City Chiefs,BAL,38,24,14,13,62,36.5,FALSE,0,0,"",1,25.5
2009,1,reg,Carolina Panthers,Philadelphia Eagles,PHI,10,38,28,2.5,48,43.5,FALSE,0,0,"",25.5,4.5
2009,1,reg,Cincinnati Bengals,Denver Broncos,CIN,7,12,5,5,19,41,FALSE,0,0,"",0,22
2009,1,reg,Cleveland Browns,Minnesota Vikings,MIN,20,34,14,4.5,54,40,FALSE,0,0,"",9.5,14
2009,1,reg,Green Bay Packers,Chicago Bears,GB,21,15,6,5,36,47,FALSE,0,0,"",1,11
2009,1,reg,Houston Texans,New York Jets,HOU,7,24,17,4.5,31,45,FALSE,1,0,DOME,12.5,14
2009,1,reg,Indianapolis Colts,Jacksonville Jaguars,IND,14,12,2,6,26,45,FALSE,1,0,DOME,4,19
2009,1,reg,New Orleans Saints,Detroit Lions,NO,45,27,18,14,72,50,FALSE,1,0,DOME,4,22
2009,1,reg,New York Giants,Washington Redskins,NYG,23,17,6,6,40,37,FALSE,0,0,"",0,3
2009,1,reg,Seattle Seahawks,St. Louis Rams,SEA,28,0,28,7,28,41,FALSE,0,0,"",21,13
2009,1,reg,Tampa Bay Buccaneers,Dallas Cowboys,DAL,21,34,13,5,55,40,FALSE,0,0,"",8,15
2009,1,reg,New England Patriots,Buffalo Bills,NE,25,24,1,13.5,49,47.5,FALSE,0,0,"",12.5,1.5
2009,1,reg,Oakland Raiders,San Diego Chargers,LAC,20,24,4,10,44,43,FALSE,0,0,"",6,1
2009,2,reg,Atlanta Falcons,Carolina Panthers,ATL,28,20,8,5.5,48,43.5,FALSE,1,0,DOME,2.5,4.5
2009,2,reg,Buffalo Bills,Tampa Bay Buccaneers,BUF,33,20,13,4,53,42,FALSE,0,0,"",9,11
2009,2,reg,Chicago Bears,Pittsburgh Steelers,PIT,17,14,3,3,31,38.5,FALSE,0,0,"",0,7.5
2009,2,reg,Dallas Cowboys,New York Giants,DAL,31,33,2,3,64,45.5,FALSE,0,0,"",1,18.5
2009,2,reg,Denver Broncos,Cleveland Browns,DEN,27,6,21,3,33,38.5,FALSE,0,0,"",18,5.5
2009,2,reg,Detroit Lions,Minnesota Vikings,MIN,13,27,14,10,40,45,FALSE,1,0,DOME,4,5
2009,2,reg,Green Bay Packers,Cincinnati Bengals,GB,24,31,7,7.5,55,42,FALSE,0,0,"",0.5,13
2009,2,reg,Jacksonville Jaguars,Arizona Cardinals,JAX,17,31,14,3,48,44,FALSE,0,0,"",11,4
2009,2,reg,Kansas City Chiefs,Oakland Raiders,KC,10,13,3,1.5,23,40,FALSE,0,0,"",1.5,17
2009,2,reg,New York Jets,New England Patriots,NE,16,9,7,3.5,25,45,FALSE,0,0,"",3.5,20
2009,2,reg,Philadelphia Eagles,New Orleans Saints,NO,22,48,26,2.5,70,46,FALSE,0,0,"",23.5,24
2009,2,reg,San Diego Chargers,Baltimore Ravens,LAC,26,31,5,1,57,41,FALSE,0,0,"",4,16
2009,2,reg,San Francisco 49ers,Seattle Seahawks,SF,23,10,13,1,33,38.5,FALSE,0,0,"",12,5.5
2009,2,reg,Tennessee Titans,Houston Texans,TEN,31,34,3,7,65,40.5,FALSE,0,0,"",4,24.5
2009,2,reg,Washington Redskins,St. Louis Rams,WAS,9,7,2,10,16,37,FALSE,0,0,"",8,21
2009,2,reg,Miami Dolphins,Indianapolis Colts,IND,23,27,4,3,50,41,FALSE,0,0,"",1,9
2009,3,reg,Arizona Cardinals,Indianapolis Colts,ARI,10,31,21,3,41,49,FALSE,1,0,DOME,18,8
2009,3,reg,Baltimore Ravens,Cleveland Browns,BAL,34,3,31,13.5,37,38.5,FALSE,0,1,Rain,17.5,1.5
2009,3,reg,Buffalo Bills,New Orleans Saints,NO,7,27,20,5.5,34,51.5,FALSE,0,0,"",14.5,17.5
2009,3,reg,Cincinnati Bengals,Pittsburgh Steelers,PIT,23,20,3,3.5,43,37,FALSE,0,0,"",0.5,6
2009,3,reg,Detroit Lions,Washington Redskins,WAS,19,14,5,6,33,39.5,FALSE,1,0,DOME,1,6.5
2009,3,reg,Houston Texans,Jacksonville Jaguars,HOU,24,31,7,4.5,55,47.5,FALSE,1,0,DOME,2.5,7.5
2009,3,reg,Minnesota Vikings,San Francisco 49ers,MIN,27,24,3,7,51,39.5,FALSE,1,0,DOME,4,11.5
2009,3,reg,New England Patriots,Atlanta Falcons,NE,26,10,16,4.5,36,45.5,FALSE,0,1,Rain,11.5,9.5
2009,3,reg,New York Jets,Tennessee Titans,NYJ,24,17,7,1,41,36,FALSE,0,1,Rain | Fog,6,5
2009,3,reg,Oakland Raiders,Denver Broncos,DEN,3,23,20,2.5,26,38,FALSE,0,0,"",17.5,12
2009,3,reg,Philadelphia Eagles,Kansas City Chiefs,PHI,34,14,20,7.5,48,39,FALSE,0,1,Fog,12.5,9
2009,3,reg,San Diego Chargers,Miami Dolphins,LAC,23,13,10,5.5,36,45.5,FALSE,0,0,"",4.5,9.5
2009,3,reg,Seattle Seahawks,Chicago Bears,CHI,19,25,6,2.5,44,37.5,FALSE,0,0,"",3.5,6.5
2009,3,reg,St. Louis Rams,Green Bay Packers,GB,17,36,19,6.5,53,43,FALSE,1,0,DOME,12.5,10
2009,3,reg,Tampa Bay Buccaneers,New York Giants,NYG,0,24,24,6.5,24,46,FALSE,0,0,"",17.5,22
2009,3,reg,Dallas Cowboys,Carolina Panthers,DAL,21,7,14,8.5,28,48.5,FALSE,0,0,"",5.5,20.5
2009,4,reg,Chicago Bears,Detroit Lions,CHI,48,24,24,9.5,72,43,FALSE,0,0,"",14.5,29
2009,4,reg,Cleveland Browns,Cincinnati Bengals,CIN,20,23,3,6.5,43,37.5,FALSE,0,0,"",3.5,5.5
2009,4,reg,Denver Broncos,Dallas Cowboys,DAL,17,10,7,3,27,44,FALSE,0,0,"",4,17
2009,4,reg,Houston Texans,Oakland Raiders,HOU,29,6,23,8,35,43,FALSE,1,0,DOME,15,8
2009,4,reg,Indianapolis Colts,Seattle Seahawks,IND,34,17,17,10.5,51,43.5,FALSE,1,0,DOME,6.5,7.5
2009,4,reg,Jacksonville Jaguars,Tennessee Titans,TEN,37,17,20,3.5,54,42,FALSE,0,0,"",16.5,12
2009,4,reg,Kansas City Chiefs,New York Giants,NYG,16,27,11,9.5,43,43,FALSE,0,0,"",1.5,0
2009,4,reg,Miami Dolphins,Buffalo Bills,MIA,38,10,28,1.5,48,37.5,FALSE,0,0,"",26.5,10.5
2009,4,reg,New England Patriots,Baltimore Ravens,NE,27,21,6,2,48,45,FALSE,0,1,Fog,4,3
2009,4,reg,New Orleans Saints,New York Jets,NO,24,10,14,7.5,34,47,FALSE,1,0,DOME,6.5,13
2009,4,reg,Pittsburgh Steelers,San Diego Chargers,PIT,38,28,10,5.5,66,43.5,FALSE,0,0,"",4.5,22.5
2009,4,reg,San Francisco 49ers,St. Louis Rams,SF,35,0,35,9.5,35,36.5,FALSE,0,0,"",25.5,1.5
2009,4,reg,Washington Redskins,Tampa Bay Buccaneers,WAS,16,13,3,9,29,35.5,FALSE,0,0,"",6,6.5
2009,4,reg,Minnesota Vikings,Green Bay Packers,MIN,30,23,7,5,53,46.5,FALSE,1,0,DOME,2,6.5
2009,5,reg,Arizona Cardinals,Houston Texans,ARI,28,21,7,6,49,51,FALSE,1,0,DOME,1,2
2009,5,reg,Baltimore Ravens,Cincinnati Bengals,BAL,14,17,3,9,31,42.5,FALSE,0,0,"",6,11.5
2009,5,reg,Buffalo Bills,Cleveland Browns,BUF,3,6,3,5.5,9,42,FALSE,0,0,"",2.5,33
2009,5,reg,Carolina Panthers,Washington Redskins,CAR,20,17,3,5.5,37,38,FALSE,0,0,"",2.5,1
2009,5,reg,Denver Broncos,New England Patriots,NE,20,17,3,3,37,41.5,FALSE,0,0,"",0,4.5
2009,5,reg,Detroit Lions,Pittsburgh Steelers,PIT,20,28,8,11,48,44,FALSE,1,0,DOME,3,4
2009,5,reg,Kansas City Chiefs,Dallas Cowboys,DAL,20,26,6,7,46,43.5,FALSE,0,0,"",1,2.5
2009,5,reg,New York Giants,Oakland Raiders,NYG,44,7,37,15,51,38.5,FALSE,0,0,"",22,12.5
2009,5,reg,Philadelphia Eagles,Tampa Bay Buccaneers,PHI,33,14,19,15.5,47,42,FALSE,0,0,"",3.5,5
2009,5,reg,San Francisco 49ers,Atlanta Falcons,SF,10,45,35,1,55,39.5,FALSE,0,0,"",34,15.5
2009,5,reg,Seattle Seahawks,Jacksonville Jaguars,SEA,41,0,41,2,41,44.5,FALSE,0,0,"",39,3.5
2009,5,reg,St. Louis Rams,Minnesota Vikings,MIN,10,38,28,10.5,48,41,FALSE,1,0,DOME,17.5,7
2009,5,reg,Tennessee Titans,Indianapolis Colts,IND,9,31,22,3.5,40,44,FALSE,0,0,"",18.5,4
2009,5,reg,Miami Dolphins,New York Jets,NYJ,31,27,4,3,58,36.5,FALSE,0,0,"",1,21.5
2009,6,reg,Atlanta Falcons,Chicago Bears,ATL,21,14,7,3.5,35,45.5,FALSE,1,0,DOME,3.5,10.5
2009,6,reg,Cincinnati Bengals,Houston Texans,CIN,17,28,11,3.5,45,46.5,FALSE,0,0,"",7.5,1.5
2009,6,reg,Green Bay Packers,Detroit Lions,GB,26,0,26,14,26,48,FALSE,0,0,"",12,22
2009,6,reg,Jacksonville Jaguars,St. Louis Rams,JAX,23,20,3,9.5,43,42.5,FALSE,0,0,"",6.5,0.5
2009,6,reg,Minnesota Vikings,Baltimore Ravens,MIN,33,31,2,3,64,45.5,FALSE,1,0,DOME,1,18.5
2009,6,reg,New England Patriots,Tennessee Titans,NE,59,0,59,9,59,37.5,FALSE,0,1,Rain | Fog,50,21.5
2009,6,reg,New Orleans Saints,New York Giants,NO,48,27,21,3,75,47.5,FALSE,1,0,DOME,18,27.5
2009,6,reg,New York Jets,Buffalo Bills,NYJ,13,16,3,9.5,29,35.5,FALSE,0,0,"",6.5,6.5
2009,6,reg,Oakland Raiders,Philadelphia Eagles,PHI,13,9,4,14,22,40.5,FALSE,0,0,"",10,18.5
2009,6,reg,Pittsburgh Steelers,Cleveland Browns,PIT,27,14,13,14,41,38,FALSE,0,0,"",1,3
2009,6,reg,Seattle Seahawks,Arizona Cardinals,SEA,3,27,24,3,30,46,FALSE,0,0,"",21,16
2009,6,reg,Tampa Bay Buccaneers,Carolina Panthers,CAR,21,28,7,3,49,40.5,FALSE,0,0,"",4,8.5
2009,6,reg,Washington Redskins,Kansas City Chiefs,WAS,6,14,8,6.5,20,36.5,FALSE,0,0,"",1.5,16.5
2009,6,reg,San Diego Chargers,Denver Broncos,LAC,23,34,11,3.5,57,45,FALSE,0,0,"",7.5,12
2009,7,reg,Carolina Panthers,Buffalo Bills,CAR,9,20,11,7,29,37,FALSE,0,0,"",4,8
2009,7,reg,Cincinnati Bengals,Chicago Bears,CHI,45,10,35,2,55,43,FALSE,0,0,"",33,12
2009,7,reg,Cleveland Browns,Green Bay Packers,GB,3,31,28,9,34,41.5,FALSE,0,0,"",19,7.5
2009,7,reg,Dallas Cowboys,Atlanta Falcons,DAL,37,21,16,5,58,48,FALSE,0,0,"",11,10
2009,7,reg,Houston Texans,San Francisco 49ers,HOU,24,21,3,3,45,44.5,FALSE,1,0,DOME,0,0.5
2009,7,reg,Kansas City Chiefs,San Diego Chargers,LAC,7,37,30,5.5,44,44,FALSE,0,0,"",24.5,0
2009,7,reg,Miami Dolphins,New Orleans Saints,NO,34,46,12,6.5,80,48,FALSE,0,0,"",5.5,32
2009,7,reg,New York Giants,Arizona Cardinals,NYG,17,24,7,8,41,47,FALSE,0,0,"",1,6
2009,7,reg,Oakland Raiders,New York Jets,NYJ,0,38,38,6,38,34,FALSE,0,0,"",32,4
2009,7,reg,Pittsburgh Steelers,Minnesota Vikings,PIT,27,17,10,6,44,46.5,FALSE,0,0,"",4,2.5
2009,7,reg,St. Louis Rams,Indianapolis Colts,IND,6,42,36,14.5,48,45,FALSE,1,0,DOME,21.5,3
2009,7,reg,Tampa Bay Buccaneers,New England Patriots,NE,7,35,28,15.5,42,44.5,TRUE,0,0,"",12.5,2.5
2009,7,reg,Washington Redskins,Philadelphia Eagles,PHI,17,27,10,9,44,38,FALSE,0,0,"",1,6
2009,8,reg,Arizona Cardinals,Carolina Panthers,ARI,21,34,13,10,55,41,FALSE,1,0,DOME,3,14
2009,8,reg,Baltimore Ravens,Denver Broncos,BAL,30,7,23,3.5,37,42,FALSE,0,1,Rain,19.5,5
2009,8,reg,Buffalo Bills,Houston Texans,HOU,10,31,21,3.5,41,41.5,FALSE,0,0,"",17.5,0.5
2009,8,reg,Chicago Bears,Cleveland Browns,CHI,30,6,24,13.5,36,40,FALSE,0,0,"",10.5,4
2009,8,reg,Dallas Cowboys,Seattle Seahawks,DAL,38,17,21,9.5,55,46,FALSE,0,0,"",11.5,9
2009,8,reg,Detroit Lions,St. Louis Rams,DET,10,17,7,4,27,43.5,FALSE,1,0,DOME,3,16.5
2009,8,reg,Green Bay Packers,Minnesota Vikings,GB,26,38,12,3,64,47,FALSE,0,0,"",9,17
2009,8,reg,Indianapolis Colts,San Francisco 49ers,IND,18,14,4,13.5,32,44.5,FALSE,1,0,DOME,9.5,12.5
2009,8,reg,New York Jets,Miami Dolphins,NYJ,25,30,5,3.5,55,40.5,FALSE,0,0,"",1.5,14.5
2009,8,reg,Philadelphia Eagles,New York Giants,NYG,40,17,23,1,57,44.5,FALSE,0,0,"",22,12.5
2009,8,reg,San Diego Chargers,Oakland Raiders,LAC,24,16,8,16.5,40,41.5,FALSE,0,0,"",8.5,1.5
2009,8,reg,Tennessee Titans,Jacksonville Jaguars,TEN,30,13,17,3,43,44.5,FALSE,0,0,"",14,1.5
2009,8,reg,New Orleans Saints,Atlanta Falcons,NO,35,27,8,12,62,56,FALSE,1,0,DOME,4,6
2009,9,reg,Atlanta Falcons,Washington Redskins,ATL,31,17,14,9,48,41,FALSE,1,0,DOME,5,7
2009,9,reg,Chicago Bears,Arizona Cardinals,CHI,21,41,20,3,62,44.5,FALSE,0,0,"",17,17.5
2009,9,reg,Cincinnati Bengals,Baltimore Ravens,BAL,17,7,10,3,24,44.5,FALSE,0,0,"",7,20.5
2009,9,reg,Indianapolis Colts,Houston Texans,IND,20,17,3,8.5,37,49.5,FALSE,1,0,DOME,5.5,12.5
2009,9,reg,Jacksonville Jaguars,Kansas City Chiefs,JAX,24,21,3,7,45,41.5,FALSE,0,0,"",4,3.5
2009,9,reg,New England Patriots,Miami Dolphins,NE,27,17,10,10.5,44,46.5,FALSE,0,0,"",0.5,2.5
2009,9,reg,New Orleans Saints,Carolina Panthers,NO,30,20,10,13,50,51.5,FALSE,1,0,DOME,3,1.5
2009,9,reg,New York Giants,San Diego Chargers,NYG,20,21,1,4.5,41,48,FALSE,0,0,"",3.5,7
2009,9,reg,Philadelphia Eagles,Dallas Cowboys,PHI,16,20,4,3,36,50,FALSE,0,0,"",1,14
2009,9,reg,San Francisco 49ers,Tennessee Titans,SF,27,34,7,4,61,40.5,FALSE,0,0,"",3,20.5
2009,9,reg,Seattle Seahawks,Detroit Lions,SEA,32,20,12,10,52,42,FALSE,0,0,"",2,10
2009,9,reg,Tampa Bay Buccaneers,Green Bay Packers,GB,38,28,10,9.5,66,43.5,FALSE,0,0,"",0.5,22.5
2009,9,reg,Denver Broncos,Pittsburgh Steelers,PIT,10,28,18,3,38,41.5,FALSE,0,0,"",15,3.5
2009,10,reg,San Francisco 49ers,Chicago Bears,SF,10,6,4,3,16,43.5,FALSE,0,0,"",1,27.5
2009,10,reg,Arizona Cardinals,Seattle Seahawks,ARI,31,20,11,8.5,51,46.5,FALSE,1,0,DOME,2.5,4.5
2009,10,reg,Carolina Panthers,Atlanta Falcons,ATL,28,19,9,1,47,43.5,FALSE,0,0,"",8,3.5
2009,10,reg,Green Bay Packers,Dallas Cowboys,DAL,17,7,10,3,24,48,FALSE,0,0,"",7,24
2009,10,reg,Indianapolis Colts,New England Patriots,IND,35,34,1,1.5,69,48.5,FALSE,1,0,DOME,0.5,20.5
2009,10,reg,Miami Dolphins,Tampa Bay Buccaneers,MIA,25,23,2,10,48,43.5,FALSE,0,0,"",8,4.5
2009,10,reg,Minnesota Vikings,Detroit Lions,MIN,27,10,17,17,37,47.5,FALSE,1,0,DOME,0,10.5
2009,10,reg,New York Jets,Jacksonville Jaguars,NYJ,22,24,2,6.5,46,41,FALSE,0,0,"",4.5,5
2009,10,reg,Oakland Raiders,Kansas City Chiefs,OAK,10,16,6,2.5,26,36,FALSE,0,0,"",3.5,10
2009,10,reg,Pittsburgh Steelers,Cincinnati Bengals,PIT,12,18,6,6.5,30,41.5,FALSE,0,0,"",0.5,11.5
2009,10,reg,San Diego Chargers,Philadelphia Eagles,LAC,31,23,8,1.5,54,47,FALSE,0,0,"",6.5,7
2009,10,reg,St. Louis Rams,New Orleans Saints,NO,23,28,5,14.5,51,51,FALSE,1,0,DOME,9.5,0
2009,10,reg,Tennessee Titans,Buffalo Bills,TEN,41,17,24,7.5,58,41,FALSE,0,0,"",16.5,17
2009,10,reg,Washington Redskins,Denver Broncos,DEN,27,17,10,3.5,44,36.5,FALSE,0,0,"",6.5,7.5
2009,10,reg,Cleveland Browns,Baltimore Ravens,BAL,0,16,16,11,16,39,FALSE,0,0,"",5,23
2009,11,reg,Carolina Panthers,Miami Dolphins,CAR,17,24,7,3.5,41,42,FALSE,0,0,"",3.5,1
2009,11,reg,Baltimore Ravens,Indianapolis Colts,IND,15,17,2,1.5,32,44.5,FALSE,0,0,"",0.5,12.5
2009,11,reg,Chicago Bears,Philadelphia Eagles,PHI,20,24,4,3.5,44,47,FALSE,0,0,"",0.5,3
2009,11,reg,Dallas Cowboys,Washington Redskins,DAL,7,6,1,10.5,13,41.5,FALSE,0,0,"",9.5,28.5
2009,11,reg,Denver Broncos,San Diego Chargers,LAC,3,32,29,6,35,42,FALSE,0,0,"",23,7
2009,11,reg,Detroit Lions,Cleveland Browns,DET,38,37,1,3,75,37.5,FALSE,1,0,DOME,2,37.5
2009,11,reg,Green Bay Packers,San Francisco 49ers,GB,30,24,6,6,54,42,FALSE,0,0,"",0,12
2009,11,reg,Jacksonville Jaguars,Buffalo Bills,JAX,18,15,3,8.5,33,41,FALSE,0,0,"",5.5,8
2009,11,reg,Kansas City Chiefs,Pittsburgh Steelers,PIT,27,24,3,11.5,51,39.5,FALSE,0,0,"",8.5,11.5
2009,11,reg,Minnesota Vikings,Seattle Seahawks,MIN,35,9,26,11,44,47,FALSE,1,0,DOME,15,3
2009,11,reg,New England Patriots,New York Jets,NE,31,14,17,11,45,45,FALSE,0,0,"",6,0
2009,11,reg,New York Giants,Atlanta Falcons,NYG,34,31,3,7,65,46.5,FALSE,0,0,"",4,18.5
2009,11,reg,Oakland Raiders,Cincinnati Bengals,CIN,20,17,3,8.5,37,36,FALSE,0,0,"",5.5,1
2009,11,reg,St. Louis Rams,Arizona Cardinals,ARI,13,21,8,9,34,47,FALSE,1,0,DOME,1,13
2009,11,reg,Tampa Bay Buccaneers,New Orleans Saints,NO,7,38,31,10.5,45,51,FALSE,0,0,"",20.5,6
2009,11,reg,Houston Texans,Tennessee Titans,HOU,17,20,3,3.5,37,48,FALSE,1,0,DOME,0.5,11
2009,12,reg,Dallas Cowboys,Oakland Raiders,DAL,24,7,17,13.5,31,40.5,FALSE,0,0,"",3.5,9.5
2009,12,reg,Denver Broncos,New York Giants,NYG,26,6,20,4.5,32,43.5,FALSE,0,0,"",15.5,11.5
2009,12,reg,Detroit Lions,Green Bay Packers,GB,12,34,22,11.5,46,48,FALSE,1,0,DOME,10.5,2
2009,12,reg,Atlanta Falcons,Tampa Bay Buccaneers,ATL,20,17,3,12.5,37,46,FALSE,1,0,DOME,9.5,9
2009,12,reg,Baltimore Ravens,Pittsburgh Steelers,BAL,20,17,3,8,37,34,FALSE,0,0,"",5,3
2009,12,reg,Buffalo Bills,Miami Dolphins,MIA,31,14,17,3.5,45,38.5,FALSE,0,0,"",13.5,6.5
2009,12,reg,Cincinnati Bengals,Cleveland Browns,CIN,16,7,9,12,23,39.5,FALSE,0,0,"",3,16.5
2009,12,reg,Houston Texans,Indianapolis Colts,IND,27,35,8,3,62,48,FALSE,1,0,DOME,5,14
2009,12,reg,Minnesota Vikings,Chicago Bears,MIN,36,10,26,10,46,47,FALSE,1,0,DOME,16,1
2009,12,reg,New York Jets,Carolina Panthers,NYJ,17,6,11,3.5,23,41.5,FALSE,0,0,"",7.5,18.5
2009,12,reg,Philadelphia Eagles,Washington Redskins,PHI,27,24,3,10,51,40.5,FALSE,0,0,"",7,10.5
2009,12,reg,San Diego Chargers,Kansas City Chiefs,LAC,43,14,29,13.5,57,45,FALSE,0,0,"",15.5,12
2009,12,reg,San Francisco 49ers,Jacksonville Jaguars,SF,20,3,17,3,23,42.5,FALSE,0,0,"",14,19.5
2009,12,reg,St. Louis Rams,Seattle Seahawks,SEA,17,27,10,3.5,44,42.5,FALSE,1,0,DOME,6.5,1.5
2009,12,reg,Tennessee Titans,Arizona Cardinals,TEN,20,17,3,2,37,45.5,FALSE,0,0,"",1,8.5
2009,12,reg,New Orleans Saints,New England Patriots,NO,38,17,21,1.5,55,56.5,FALSE,1,0,DOME,19.5,1.5
2009,13,reg,Buffalo Bills,New York Jets,NYJ,13,19,6,3.5,32,37,TRUE,1,0,DOME,2.5,5
2009,13,reg,Arizona Cardinals,Minnesota Vikings,MIN,30,17,13,3,47,49,FALSE,1,0,DOME,10,2
2009,13,reg,Atlanta Falcons,Philadelphia Eagles,PHI,7,34,27,4,41,43.5,FALSE,1,0,DOME,23,2.5
2009,13,reg,Carolina Panthers,Tampa Bay Buccaneers,CAR,16,6,10,3.5,22,40,FALSE,0,0,"",6.5,18
2009,13,reg,Chicago Bears,St. Louis Rams,CHI,17,9,8,9,26,41,FALSE,0,0,"",1,15
2009,13,reg,Cincinnati Bengals,Detroit Lions,CIN,23,13,10,13.5,36,42,FALSE,0,0,"",3.5,6
2009,13,reg,Cleveland Browns,San Diego Chargers,LAC,23,30,7,13.5,53,42.5,FALSE,0,0,"",6.5,10.5
2009,13,reg,Indianapolis Colts,Tennessee Titans,IND,27,17,10,6,44,47,FALSE,1,0,DOME,4,3
2009,13,reg,Jacksonville Jaguars,Houston Texans,HOU,23,18,5,1.5,41,47.5,FALSE,0,0,"",3.5,6.5
2009,13,reg,Kansas City Chiefs,Denver Broncos,DEN,13,44,31,6,57,39,FALSE,0,0,"",25,18
2009,13,reg,Miami Dolphins,New England Patriots,NE,22,21,1,5,43,46.5,FALSE,0,1,Rain,4,3.5
2009,13,reg,New York Giants,Dallas Cowboys,DAL,31,24,7,1.5,55,45.5,FALSE,0,0,"",5.5,9.5
2009,13,reg,Pittsburgh Steelers,Oakland Raiders,PIT,24,27,3,15,51,37,FALSE,0,0,"",12,14
2009,13,reg,Seattle Seahawks,San Francisco 49ers,SF,20,17,3,1,37,41.5,FALSE,0,0,"",2,4.5
2009,13,reg,Washington Redskins,New Orleans Saints,NO,30,33,3,8,63,47,FALSE,0,0,"",5,16
2009,13,reg,Green Bay Packers,Baltimore Ravens,GB,27,14,13,4,41,43,FALSE,0,0,"",9,2
2009,14,reg,Cleveland Browns,Pittsburgh Steelers,PIT,13,6,7,10,19,34.5,FALSE,0,0,"",3,15.5
2009,14,reg,Atlanta Falcons,New Orleans Saints,NO,23,26,3,10,49,50,FALSE,1,0,DOME,7,1
2009,14,reg,Baltimore Ravens,Detroit Lions,BAL,48,3,45,14,51,40.5,FALSE,0,1,Rain,31,10.5
2009,14,reg,Chicago Bears,Green Bay Packers,GB,14,21,7,4,35,42,FALSE,0,0,"",3,7
2009,14,reg,Dallas Cowboys,San Diego Chargers,DAL,17,20,3,3.5,37,48.5,FALSE,0,0,"",0.5,11.5
2009,14,reg,Houston Texans,Seattle Seahawks,HOU,34,7,27,7,41,45,FALSE,1,0,DOME,20,4
2009,14,reg,Indianapolis Colts,Denver Broncos,IND,28,16,12,6.5,44,43.5,FALSE,1,0,DOME,5.5,0.5
2009,14,reg,Jacksonville Jaguars,Miami Dolphins,JAX,10,14,4,2,24,43,FALSE,0,0,"",2,19
2009,14,reg,Kansas City Chiefs,Buffalo Bills,BUF,10,16,6,2.5,26,38,FALSE,0,0,"",3.5,12
2009,14,reg,Minnesota Vikings,Cincinnati Bengals,MIN,30,10,20,6,40,42.5,FALSE,1,0,DOME,14,2.5
2009,14,reg,New England Patriots,Carolina Panthers,NE,20,10,10,12.5,30,43.5,FALSE,0,0,"",2.5,13.5
2009,14,reg,New York Giants,Philadelphia Eagles,PHI,38,45,7,1,83,42.5,FALSE,0,1,Rain | Fog,6,40.5
2009,14,reg,Oakland Raiders,Washington Redskins,WAS,13,34,21,2.5,47,37.5,FALSE,0,1,Rain | Fog,18.5,9.5
2009,14,reg,Tampa Bay Buccaneers,New York Jets,NYJ,3,26,23,3.5,29,36.5,FALSE,0,0,"",19.5,7.5
2009,14,reg,Tennessee Titans,St. Louis Rams,TEN,47,7,40,14,54,40,FALSE,0,0,"",26,14
2009,14,reg,San Francisco 49ers,Arizona Cardinals,ARI,24,9,15,4,33,45,FALSE,0,0,"",11,12
2009,15,reg,Jacksonville Jaguars,Indianapolis Colts,IND,31,35,4,3,66,43.5,FALSE,0,0,"",1,22.5
2009,15,reg,New Orleans Saints,Dallas Cowboys,NO,17,24,7,7.5,41,53.5,FALSE,1,0,DOME,0.5,12.5
2009,15,reg,Baltimore Ravens,Chicago Bears,BAL,31,7,24,11,38,39,FALSE,0,0,"",13,1
2009,15,reg,Buffalo Bills,New England Patriots,NE,10,17,7,7,27,41,FALSE,0,0,"",0,14
2009,15,reg,Carolina Panthers,Minnesota Vikings,MIN,26,7,19,9,33,43,FALSE,0,0,"",10,10
2009,15,reg,Denver Broncos,Oakland Raiders,DEN,19,20,1,14,39,37,FALSE,0,0,"",13,2
2009,15,reg,Detroit Lions,Arizona Cardinals,ARI,24,31,7,14,55,47,FALSE,1,0,DOME,7,8
2009,15,reg,Kansas City Chiefs,Cleveland Browns,KC,34,41,7,3,75,37,FALSE,0,0,"",4,38
2009,15,reg,New York Jets,Atlanta Falcons,NYJ,7,10,3,7,17,35.5,FALSE,0,0,"",4,18.5
2009,15,reg,Philadelphia Eagles,San Francisco 49ers,PHI,27,13,14,7.5,40,41,FALSE,0,0,"",6.5,1
2009,15,reg,Pittsburgh Steelers,Green Bay Packers,PIT,37,36,1,2.5,73,41,FALSE,0,0,"",1.5,32
2009,15,reg,San Diego Chargers,Cincinnati Bengals,LAC,27,24,3,7,51,43.5,FALSE,0,0,"",4,7.5
2009,15,reg,Seattle Seahawks,Tampa Bay Buccaneers,SEA,7,24,17,6.5,31,39,FALSE,0,0,"",10.5,8
2009,15,reg,St. Louis Rams,Houston Texans,HOU,13,16,3,14,29,43.5,FALSE,1,0,DOME,11,14.5
2009,15,reg,Tennessee Titans,Miami Dolphins,TEN,27,24,3,4.5,51,43,FALSE,0,0,"",1.5,8
2009,15,reg,Washington Redskins,New York Giants,NYG,12,45,33,3,57,43.5,FALSE,0,0,"",30,13.5
2009,16,reg,Tennessee Titans,San Diego Chargers,TEN,17,42,25,2,59,48,FALSE,0,0,"",23,11
2009,16,reg,Arizona Cardinals,St. Louis Rams,ARI,31,10,21,16,41,43.5,FALSE,1,0,DOME,5,2.5
2009,16,reg,Atlanta Falcons,Buffalo Bills,ATL,31,3,28,8,34,40,FALSE,1,0,DOME,20,6
2009,16,reg,Cincinnati Bengals,Kansas City Chiefs,CIN,17,10,7,13,27,39.5,FALSE,0,0,"",6,12.5
2009,16,reg,Cleveland Browns,Oakland Raiders,CLE,23,9,14,3,32,37,FALSE,0,0,"",11,5
2009,16,reg,Green Bay Packers,Seattle Seahawks,GB,48,10,38,13.5,58,43.5,FALSE,0,1,Fog,24.5,14.5
2009,16,reg,Indianapolis Colts,New York Jets,IND,15,29,14,3,44,40.5,FALSE,1,0,DOME,11,3.5
2009,16,reg,Miami Dolphins,Houston Texans,MIA,20,27,7,2,47,47,FALSE,0,0,"",5,0
2009,16,reg,New England Patriots,Jacksonville Jaguars,NE,35,7,28,9,42,44.5,FALSE,0,0,"",19,2.5
2009,16,reg,New Orleans Saints,Tampa Bay Buccaneers,NO,17,20,3,14,37,48.5,FALSE,1,0,DOME,11,11.5
2009,16,reg,New York Giants,Carolina Panthers,NYG,9,41,32,8.5,50,43,FALSE,0,0,"",23.5,7
2009,16,reg,Philadelphia Eagles,Denver Broncos,PHI,30,27,3,7,57,43,FALSE,0,0,"",4,14
2009,16,reg,Pittsburgh Steelers,Baltimore Ravens,PIT,23,20,3,3,43,43,FALSE,0,0,"",0,0
2009,16,reg,San Francisco 49ers,Detroit Lions,SF,20,6,14,14,26,41,FALSE,0,0,"",0,15
2009,16,reg,Washington Redskins,Dallas Cowboys,DAL,0,17,17,7,17,42,FALSE,0,0,"",10,25
2009,16,reg,Chicago Bears,Minnesota Vikings,MIN,36,30,6,8.5,66,42,FALSE,0,0,"",2.5,24
2009,17,reg,Arizona Cardinals,Green Bay Packers,ARI,7,33,26,3,40,44,FALSE,1,0,DOME,23,4
2009,17,reg,Buffalo Bills,Indianapolis Colts,BUF,30,7,23,8,37,32,FALSE,0,1,Snow,15,5
2009,17,reg,Carolina Panthers,New Orleans Saints,CAR,23,10,13,10,33,41,FALSE,0,0,"",3,8
2009,17,reg,Cleveland Browns,Jacksonville Jaguars,CLE,23,17,6,2,40,35,FALSE,0,0,"",4,5
2009,17,reg,Dallas Cowboys,Philadelphia Eagles,DAL,24,0,24,3,24,47,FALSE,0,0,"",21,23
2009,17,reg,Denver Broncos,Kansas City Chiefs,DEN,24,44,20,10,68,38,FALSE,0,0,"",10,30
2009,17,reg,Detroit Lions,Chicago Bears,CHI,23,37,14,4.5,60,44.5,FALSE,1,0,DOME,9.5,15.5
2009,17,reg,Houston Texans,New England Patriots,HOU,34,27,7,7.5,61,47,FALSE,1,0,DOME,0.5,14
2009,17,reg,Miami Dolphins,Pittsburgh Steelers,PIT,24,30,6,3,54,46,FALSE,0,0,"",3,8
2009,17,reg,Minnesota Vikings,New York Giants,MIN,44,7,37,8,51,48,FALSE,1,0,DOME,29,3
2009,17,reg,New York Jets,Cincinnati Bengals,NYJ,37,0,37,10,37,33.5,FALSE,0,0,"",27,3.5
2009,17,reg,Oakland Raiders,Baltimore Ravens,BAL,13,21,8,10,34,39,FALSE,0,0,"",2,5
2009,17,reg,San Diego Chargers,Washington Redskins,LAC,23,20,3,3,43,39,FALSE,0,0,"",0,4
2009,17,reg,Seattle Seahawks,Tennessee Titans,TEN,13,17,4,6,30,45,FALSE,0,0,"",2,15
2009,17,reg,St. Louis Rams,San Francisco 49ers,SF,6,28,22,7,34,39.5,FALSE,1,0,DOME,15,5.5
2009,17,reg,Tampa Bay Buccaneers,Atlanta Falcons,ATL,10,20,10,3,30,41.5,FALSE,0,0,"",7,11.5
2009,Wildcard,post,Cincinnati Bengals,New York Jets,CIN,14,24,10,2.5,38,34.5,FALSE,0,0,"",7.5,3.5
2009,Wildcard,post,Dallas Cowboys,Philadelphia Eagles,DAL,34,14,20,3.5,48,46,FALSE,0,0,"",16.5,2
2009,Wildcard,post,Arizona Cardinals,Green Bay Packers,GB,51,45,6,2.5,96,48,FALSE,1,0,DOME,3.5,48
2009,Wildcard,post,New England Patriots,Baltimore Ravens,NE,14,33,19,4,47,44,FALSE,0,0,"",15,3
2009,Division,post,Indianapolis Colts,Baltimore Ravens,IND,20,3,17,6.5,23,44,FALSE,1,0,DOME,10.5,21
2009,Division,post,New Orleans Saints,Arizona Cardinals,NO,45,14,31,7,59,57,FALSE,1,0,DOME,24,2
2009,Division,post,Minnesota Vikings,Dallas Cowboys,MIN,34,3,31,2.5,37,45,FALSE,1,0,DOME,28.5,8
2009,Division,post,San Diego Chargers,New York Jets,LAC,14,17,3,9,31,42.5,FALSE,0,0,"",6,11.5
2009,Conference,post,Indianapolis Colts,New York Jets,IND,30,17,13,8.5,47,40.5,FALSE,1,0,DOME,4.5,6.5
2009,Conference,post,New Orleans Saints,Minnesota Vikings,NO,31,28,3,3.5,59,54,FALSE,1,0,DOME,0.5,5
2009,Superbowl,post,Indianapolis Colts,New Orleans Saints,IND,17,31,14,5,48,57,TRUE,0,0,"",9,9
2010,1,reg,New Orleans Saints,Minnesota Vikings,NO,14,9,5,5,23,49.5,FALSE,1,0,DOME,0,26.5
2010,1,reg,Buffalo Bills,Miami Dolphins,MIA,10,15,5,3,25,39,FALSE,0,0,"",2,14
2010,1,reg,Chicago Bears,Detroit Lions,CHI,19,14,5,6.5,33,45,FALSE,0,0,"",1.5,12
2010,1,reg,Houston Texans,Indianapolis Colts,IND,34,24,10,1,58,48,FALSE,0,0,DOME (Open Roof),9,10
2010,1,reg,Jacksonville Jaguars,Denver Broncos,JAX,24,17,7,3,41,41.5,FALSE,0,0,"",4,0.5
2010,1,reg,New England Patriots,Cincinnati Bengals,NE,38,24,14,5.5,62,45,FALSE,0,0,"",8.5,17
2010,1,reg,New York Giants,Carolina Panthers,NYG,31,18,13,6,49,41,FALSE,0,1,Rain,7,8
2010,1,reg,Philadelphia Eagles,Green Bay Packers,GB,20,27,7,3,47,48,FALSE,0,0,"",4,1
2010,1,reg,Pittsburgh Steelers,Atlanta Falcons,ATL,15,9,6,1.5,24,39.5,FALSE,0,0,"",4.5,15.5
2010,1,reg,Seattle Seahawks,San Francisco 49ers,SF,31,6,25,3,37,37,FALSE,0,0,"",22,0
2010,1,reg,St. Louis Rams,Arizona Cardinals,ARI,13,17,4,3,30,39.5,FALSE,1,0,DOME,1,9.5
2010,1,reg,Tampa Bay Buccaneers,Cleveland Browns,TB,17,14,3,2.5,31,37,FALSE,0,0,"",0.5,6
2010,1,reg,Tennessee Titans,Oakland Raiders,TEN,38,13,25,6.5,51,40,FALSE,0,0,"",18.5,11
2010,1,reg,Washington Redskins,Dallas Cowboys,DAL,13,7,6,3,20,40,FALSE,0,0,"",3,20
2010,1,reg,Kansas City Chiefs,San Diego Chargers,LAC,21,14,7,4,35,45.5,FALSE,0,0,"",3,10.5
2010,1,reg,New York Jets,Baltimore Ravens,NYJ,9,10,1,1,19,36.5,FALSE,0,1,Rain,0,17.5
2010,2,reg,Atlanta Falcons,Arizona Cardinals,ATL,41,7,34,7,48,43.5,FALSE,1,0,DOME,27,4.5
2010,2,reg,Carolina Panthers,Tampa Bay Buccaneers,CAR,7,20,13,4,27,37.5,FALSE,0,0,"",9,10.5
2010,2,reg,Cincinnati Bengals,Baltimore Ravens,BAL,15,10,5,3,25,39.5,FALSE,0,0,"",2,14.5
2010,2,reg,Cleveland Browns,Kansas City Chiefs,CLE,14,16,2,3,30,38,FALSE,0,0,"",1,8
2010,2,reg,Dallas Cowboys,Chicago Bears,DAL,20,27,7,7,47,41.5,FALSE,1,0,DOME,0,5.5
2010,2,reg,Denver Broncos,Seattle Seahawks,DEN,31,14,17,3.5,45,41,FALSE,0,0,"",13.5,4
2010,2,reg,Detroit Lions,Philadelphia Eagles,PHI,32,35,3,6.5,67,41,FALSE,1,0,DOME,3.5,26
2010,2,reg,Green Bay Packers,Buffalo Bills,GB,34,7,27,13,41,43,FALSE,0,0,"",14,2
2010,2,reg,Indianapolis Colts,New York Giants,IND,38,14,24,4,52,48.5,FALSE,1,0,DOME,20,3.5
2010,2,reg,Minnesota Vikings,Miami Dolphins,MIN,10,14,4,6,24,41,FALSE,1,0,DOME,2,17
2010,2,reg,New York Jets,New England Patriots,NE,28,14,14,3,42,39.5,FALSE,0,0,"",11,2.5
2010,2,reg,Oakland Raiders,St. Louis Rams,OAK,16,14,2,3,30,37.5,FALSE,0,0,"",1,7.5
2010,2,reg,San Diego Chargers,Jacksonville Jaguars,LAC,38,13,25,7,51,45,FALSE,0,0,"",18,6
2010,2,reg,Tennessee Titans,Pittsburgh Steelers,TEN,11,19,8,6,30,37,FALSE,0,0,"",2,7
2010,2,reg,Washington Redskins,Houston Texans,HOU,27,30,3,3,57,42.5,FALSE,0,0,"",0,14.5
2010,2,reg,San Francisco 49ers,New Orleans Saints,NO,22,25,3,5,47,43.5,FALSE,0,0,"",2,3.5
2010,3,reg,Arizona Cardinals,Oakland Raiders,ARI,24,23,1,5.5,47,39,FALSE,1,0,DOME,4.5,8
2010,3,reg,Baltimore Ravens,Cleveland Browns,BAL,24,17,7,12.5,41,36.5,FALSE,0,1,Rain,5.5,4.5
2010,3,reg,Carolina Panthers,Cincinnati Bengals,CIN,7,20,13,3.5,27,37,FALSE,0,1,Rain | Fog,9.5,10
2010,3,reg,Denver Broncos,Indianapolis Colts,IND,13,27,14,6,40,47,FALSE,0,0,"",8,7
2010,3,reg,Houston Texans,Dallas Cowboys,HOU,13,27,14,2.5,40,47.5,FALSE,0,0,DOME (Open Roof),11.5,7.5
2010,3,reg,Jacksonville Jaguars,Philadelphia Eagles,PHI,3,28,25,3,31,45,FALSE,0,0,"",22,14
2010,3,reg,Kansas City Chiefs,San Francisco 49ers,SF,31,10,21,3,41,38,FALSE,0,0,"",18,3
2010,3,reg,Miami Dolphins,New York Jets,MIA,23,31,8,2.5,54,36,FALSE,0,0,"",5.5,18
2010,3,reg,Minnesota Vikings,Detroit Lions,MIN,24,10,14,13,34,43,FALSE,1,0,DOME,1,9
2010,3,reg,New England Patriots,Buffalo Bills,NE,38,30,8,14.5,68,43,FALSE,0,0,"",6.5,25
2010,3,reg,New Orleans Saints,Atlanta Falcons,NO,24,27,3,3,51,49.5,FALSE,1,0,DOME,0,1.5
2010,3,reg,New York Giants,Tennessee Titans,NYG,10,29,19,3,39,43.5,FALSE,0,0,"",16,4.5
2010,3,reg,Seattle Seahawks,San Diego Chargers,LAC,27,20,7,4,47,44,FALSE,0,1,Fog,3,3
2010,3,reg,St. Louis Rams,Washington Redskins,WAS,30,16,14,5,46,39,FALSE,1,0,DOME,9,7
2010,3,reg,Tampa Bay Buccaneers,Pittsburgh Steelers,PIT,13,38,25,3,51,33,FALSE,0,0,"",22,18
2010,3,reg,Chicago Bears,Green Bay Packers,GB,20,17,3,3,37,46.5,FALSE,0,0,"",0,9.5
2010,4,reg,Atlanta Falcons,San Francisco 49ers,ATL,16,14,2,7,30,42.5,FALSE,1,0,DOME,5,12.5
2010,4,reg,Buffalo Bills,New York Jets,NYJ,14,38,24,6,52,37,FALSE,0,1,Rain,18,15
2010,4,reg,Cleveland Browns,Cincinnati Bengals,CIN,23,20,3,2.5,43,37,FALSE,0,0,"",0.5,6
2010,4,reg,Green Bay Packers,Detroit Lions,GB,28,26,2,14.5,54,46,FALSE,0,0,"",12.5,8
2010,4,reg,Jacksonville Jaguars,Indianapolis Colts,IND,31,28,3,7,59,46,FALSE,0,0,"",4,13
2010,4,reg,New Orleans Saints,Carolina Panthers,NO,16,14,2,12.5,30,44,FALSE,1,0,DOME,10.5,14
2010,4,reg,New York Giants,Chicago Bears,NYG,17,3,14,3.5,20,44,FALSE,0,0,"",10.5,24
2010,4,reg,Oakland Raiders,Houston Texans,HOU,24,31,7,3.5,55,44,FALSE,0,0,"",3.5,11
2010,4,reg,Philadelphia Eagles,Washington Redskins,PHI,12,17,5,5,29,43.5,FALSE,0,0,"",0,14.5
2010,4,reg,Pittsburgh Steelers,Baltimore Ravens,PIT,14,17,3,2.5,31,34.5,FALSE,0,0,"",0.5,3.5
2010,4,reg,San Diego Chargers,Arizona Cardinals,LAC,41,10,31,9.5,51,46.5,FALSE,0,0,"",21.5,4.5
2010,4,reg,St. Louis Rams,Seattle Seahawks,SEA,20,3,17,2,23,40,FALSE,1,0,DOME,15,17
2010,4,reg,Tennessee Titans,Denver Broncos,TEN,20,26,6,6.5,46,43.5,FALSE,0,0,"",0.5,2.5
2010,4,reg,Miami Dolphins,New England Patriots,NE,14,41,27,1,55,48,FALSE,0,0,"",26,7
2010,5,reg,Arizona Cardinals,New Orleans Saints,NO,30,20,10,7,50,45.5,FALSE,1,0,DOME,3,4.5
2010,5,reg,Baltimore Ravens,Denver Broncos,BAL,31,17,14,8,48,39.5,FALSE,0,0,"",6,8.5
2010,5,reg,Buffalo Bills,Jacksonville Jaguars,BUF,26,36,10,2.5,62,41.5,FALSE,0,0,"",7.5,20.5
2010,5,reg,Carolina Panthers,Chicago Bears,CAR,6,23,17,3,29,33,FALSE,0,0,"",14,4
2010,5,reg,Cincinnati Bengals,Tampa Bay Buccaneers,CIN,21,24,3,7,45,38.5,FALSE,0,0,"",4,6.5
2010,5,reg,Cleveland Browns,Atlanta Falcons,ATL,10,20,10,3,30,41.5,FALSE,0,0,"",7,11.5
2010,5,reg,Dallas Cowboys,Tennessee Titans,DAL,27,34,7,7,61,43,FALSE,1,0,DOME,0,18
2010,5,reg,Detroit Lions,St. Louis Rams,DET,44,6,38,3,50,42.5,FALSE,1,0,DOME,35,7.5
2010,5,reg,Houston Texans,New York Giants,HOU,10,34,24,3,44,48.5,FALSE,0,0,DOME (Open Roof),21,4.5
2010,5,reg,Indianapolis Colts,Kansas City Chiefs,IND,19,9,10,7.5,28,46.5,FALSE,1,0,DOME,2.5,18.5
2010,5,reg,Oakland Raiders,San Diego Chargers,LAC,35,27,8,7,62,44,FALSE,0,0,"",1,18
2010,5,reg,San Francisco 49ers,Philadelphia Eagles,SF,24,27,3,3,51,38.5,FALSE,0,0,"",0,12.5
2010,5,reg,Washington Redskins,Green Bay Packers,GB,16,13,3,3,29,45.5,FALSE,0,0,"",0,16.5
2010,5,reg,New York Jets,Minnesota Vikings,NYJ,29,20,9,4.5,49,40,FALSE,0,0,"",4.5,9
2010,6,reg,Chicago Bears,Seattle Seahawks,CHI,20,23,3,6,43,38,FALSE,0,0,"",3,5
2010,6,reg,Denver Broncos,New York Jets,NYJ,20,24,4,3.5,44,43,FALSE,0,0,"",0.5,1
2010,6,reg,Green Bay Packers,Miami Dolphins,GB,20,23,3,3,43,44,FALSE,0,0,"",0,1
2010,6,reg,Houston Texans,Kansas City Chiefs,HOU,35,31,4,4.5,66,46,FALSE,0,0,DOME (Open Roof),0.5,20
2010,6,reg,Minnesota Vikings,Dallas Cowboys,MIN,24,21,3,1.5,45,44,FALSE,1,0,DOME,1.5,1
2010,6,reg,New England Patriots,Baltimore Ravens,NE,23,20,3,3,43,44.5,FALSE,0,0,"",0,1.5
2010,6,reg,New York Giants,Detroit Lions,NYG,28,20,8,10,48,45.5,FALSE,0,0,"",2,2.5
2010,6,reg,Philadelphia Eagles,Atlanta Falcons,PHI,31,17,14,1.5,48,43,FALSE,0,0,"",12.5,5
2010,6,reg,Pittsburgh Steelers,Cleveland Browns,PIT,28,10,18,14,38,37.5,FALSE,0,0,"",4,0.5
2010,6,reg,San Francisco 49ers,Oakland Raiders,SF,17,9,8,7,26,41,FALSE,0,0,"",1,15
2010,6,reg,St. Louis Rams,San Diego Chargers,LAC,20,17,3,8.5,37,45,FALSE,1,0,DOME,5.5,8
2010,6,reg,Tampa Bay Buccaneers,New Orleans Saints,NO,6,31,25,5.5,37,44,FALSE,0,0,"",19.5,7
2010,6,reg,Washington Redskins,Indianapolis Colts,IND,24,27,3,3,51,45,FALSE,0,0,"",0,6
2010,6,reg,Jacksonville Jaguars,Tennessee Titans,TEN,3,30,27,3,33,43.5,FALSE,0,0,"",24,10.5
2010,7,reg,Atlanta Falcons,Cincinnati Bengals,ATL,39,32,7,3.5,71,43,FALSE,1,0,DOME,3.5,28
2010,7,reg,Baltimore Ravens,Buffalo Bills,BAL,37,34,3,12.5,71,40,FALSE,0,0,"",9.5,31
2010,7,reg,Carolina Panthers,San Francisco 49ers,SF,23,20,3,2.5,43,35.5,FALSE,0,0,"",0.5,7.5
2010,7,reg,Chicago Bears,Washington Redskins,CHI,14,17,3,3,31,40,FALSE,0,0,"",0,9
2010,7,reg,Denver Broncos,Oakland Raiders,DEN,14,59,45,7,73,43,FALSE,0,0,"",38,30
2010,7,reg,Green Bay Packers,Minnesota Vikings,GB,28,24,4,2.5,52,44.5,FALSE,0,1,Fog,1.5,7.5
2010,7,reg,Kansas City Chiefs,Jacksonville Jaguars,KC,42,20,22,9,62,39,FALSE,0,0,"",13,23
2010,7,reg,Miami Dolphins,Pittsburgh Steelers,PIT,22,23,1,3,45,40.5,FALSE,0,1,Rain | Fog,2,4.5
2010,7,reg,New Orleans Saints,Cleveland Browns,NO,17,30,13,12.5,47,44,FALSE,1,0,DOME,0.5,3
2010,7,reg,San Diego Chargers,New England Patriots,LAC,20,23,3,1.5,43,49.5,FALSE,0,0,"",1.5,6.5
2010,7,reg,Seattle Seahawks,Arizona Cardinals,SEA,22,10,12,6.5,32,40.5,FALSE,0,1,Rain,5.5,8.5
2010,7,reg,Tampa Bay Buccaneers,St. Louis Rams,TB,18,17,1,3,35,39,FALSE,0,0,"",2,4
2010,7,reg,Tennessee Titans,Philadelphia Eagles,TEN,37,19,18,3,56,42,FALSE,0,0,"",15,14
2010,7,reg,Dallas Cowboys,New York Giants,DAL,35,41,6,3.5,76,45.5,FALSE,0,0,"",2.5,30.5
2010,8,reg,Arizona Cardinals,Tampa Bay Buccaneers,ARI,35,38,3,3,73,38,FALSE,1,0,DOME,0,35
2010,8,reg,Cincinnati Bengals,Miami Dolphins,CIN,14,22,8,1,36,44,FALSE,0,0,"",7,8
2010,8,reg,Dallas Cowboys,Jacksonville Jaguars,DAL,17,35,18,6.5,52,44,FALSE,1,0,DOME,11.5,8
2010,8,reg,Detroit Lions,Washington Redskins,DET,37,25,12,3,62,45,FALSE,1,0,DOME,9,17
2010,8,reg,Kansas City Chiefs,Buffalo Bills,KC,13,10,3,7,23,46,FALSE,0,0,"",4,23
2010,8,reg,New England Patriots,Minnesota Vikings,NE,28,18,10,5.5,46,45,FALSE,0,0,"",4.5,1
2010,8,reg,New Orleans Saints,Pittsburgh Steelers,NO,20,10,10,1,30,45.5,FALSE,1,0,DOME,9,15.5
2010,8,reg,New York Jets,Green Bay Packers,NYJ,0,9,9,6,9,42,FALSE,0,0,"",3,33
2010,8,reg,Oakland Raiders,Seattle Seahawks,OAK,33,3,30,2,36,40.5,FALSE,0,0,"",28,4.5
2010,8,reg,San Diego Chargers,Tennessee Titans,LAC,33,25,8,6,58,45,FALSE,0,0,"",2,13
2010,8,reg,San Francisco 49ers,Denver Broncos,SF,24,16,8,2.5,40,41.5,TRUE,0,0,"",5.5,1.5
2010,8,reg,St. Louis Rams,Carolina Panthers,LAR,20,10,10,2.5,30,37,FALSE,1,0,DOME,7.5,7
2010,8,reg,Indianapolis Colts,Houston Texans,IND,30,17,13,5.5,47,51,FALSE,1,0,DOME,7.5,4
2010,9,reg,Atlanta Falcons,Tampa Bay Buccaneers,ATL,27,21,6,9,48,45.5,FALSE,1,0,DOME,3,2.5
2010,9,reg,Baltimore Ravens,Miami Dolphins,BAL,26,10,16,5,36,41,FALSE,0,0,"",11,5
2010,9,reg,Buffalo Bills,Chicago Bears,CHI,19,22,3,3,41,41.5,TRUE,1,0,DOME,0,0.5
2010,9,reg,Carolina Panthers,New Orleans Saints,NO,3,34,31,6.5,37,40.5,FALSE,0,0,"",24.5,3.5
2010,9,reg,Cleveland Browns,New England Patriots,NE,34,14,20,4,48,43.5,FALSE,0,0,"",16,4.5
2010,9,reg,Detroit Lions,New York Jets,NYJ,20,23,3,5.5,43,42,FALSE,1,0,DOME,2.5,1
2010,9,reg,Green Bay Packers,Dallas Cowboys,GB,45,7,38,7,52,45.5,FALSE,0,0,"",31,6.5
2010,9,reg,Houston Texans,San Diego Chargers,LAC,23,29,6,3,52,49.5,FALSE,0,0,DOME (Open Roof),3,2.5
2010,9,reg,Minnesota Vikings,Arizona Cardinals,MIN,27,24,3,7.5,51,42.5,FALSE,1,0,DOME,4.5,8.5
2010,9,reg,Oakland Raiders,Kansas City Chiefs,PICK,23,20,3,0,43,41,FALSE,0,1,Rain | Fog,3,2
2010,9,reg,Philadelphia Eagles,Indianapolis Colts,PHI,26,24,2,3,50,47,FALSE,0,0,"",1,3
2010,9,reg,Seattle Seahawks,New York Giants,NYG,7,41,34,7.5,48,40.5,FALSE,0,0,"",26.5,7.5
2010,9,reg,Cincinnati Bengals,Pittsburgh Steelers,PIT,21,27,6,5.5,48,41.5,FALSE,0,0,"",0.5,6.5
2010,10,reg,Atlanta Falcons,Baltimore Ravens,ATL,26,21,5,1,47,44,FALSE,1,0,DOME,4,3
2010,10,reg,Arizona Cardinals,Seattle Seahawks,ARI,18,36,18,4,54,41.5,FALSE,1,0,DOME,14,12.5
2010,10,reg,Buffalo Bills,Detroit Lions,BUF,14,12,2,1.5,26,45,FALSE,0,0,"",0.5,19
2010,10,reg,Chicago Bears,Minnesota Vikings,MIN,27,13,14,1,40,41.5,FALSE,0,0,"",13,1.5
2010,10,reg,Cleveland Browns,New York Jets,NYJ,20,26,6,3.5,46,37,FALSE,0,0,"",2.5,9
2010,10,reg,Denver Broncos,Kansas City Chiefs,KC,49,29,20,1,78,44.5,FALSE,0,0,"",19,33.5
2010,10,reg,Indianapolis Colts,Cincinnati Bengals,IND,23,17,6,7,40,47,FALSE,1,0,DOME,1,7
2010,10,reg,Jacksonville Jaguars,Houston Texans,PICK,31,24,7,0,55,48.5,FALSE,0,0,"",7,6.5
2010,10,reg,Miami Dolphins,Tennessee Titans,MIA,29,17,12,1,46,43,FALSE,0,0,"",11,3
2010,10,reg,New York Giants,Dallas Cowboys,NYG,20,33,13,12.5,53,46.5,FALSE,0,0,"",0.5,6.5
2010,10,reg,Pittsburgh Steelers,New England Patriots,PIT,26,39,13,4.5,65,45,FALSE,0,1,Rain,8.5,20
2010,10,reg,San Francisco 49ers,St. Louis Rams,SF,23,20,3,4.5,43,39,FALSE,0,0,"",1.5,4
2010,10,reg,Tampa Bay Buccaneers,Carolina Panthers,TB,31,16,15,7,47,37,FALSE,0,0,"",8,10
2010,10,reg,Washington Redskins,Philadelphia Eagles,PHI,28,59,31,3.5,87,43.5,FALSE,0,0,"",27.5,43.5
2010,11,reg,Miami Dolphins,Chicago Bears,MIA,0,16,16,2,16,40,FALSE,0,0,"",14,24
2010,11,reg,Carolina Panthers,Baltimore Ravens,BAL,13,37,24,13.5,50,37,FALSE,0,0,"",10.5,13
2010,11,reg,Cincinnati Bengals,Buffalo Bills,CIN,31,49,18,4,80,41,FALSE,0,0,"",14,39
2010,11,reg,Dallas Cowboys,Detroit Lions,DAL,35,19,16,7,54,44.5,FALSE,1,0,DOME,9,9.5
2010,11,reg,Jacksonville Jaguars,Cleveland Browns,JAX,24,20,4,2.5,44,43,FALSE,0,0,"",1.5,1
2010,11,reg,Kansas City Chiefs,Arizona Cardinals,KC,31,13,18,7,44,45,FALSE,0,0,"",11,1
2010,11,reg,Minnesota Vikings,Green Bay Packers,GB,3,31,28,3,34,45,FALSE,1,0,DOME,25,11
2010,11,reg,New England Patriots,Indianapolis Colts,NE,31,28,3,4.5,59,50,FALSE,0,0,"",1.5,9
2010,11,reg,New Orleans Saints,Seattle Seahawks,NO,34,19,15,11,53,45,FALSE,1,0,DOME,4,8
2010,11,reg,New York Jets,Houston Texans,NYJ,30,27,3,6.5,57,46,FALSE,0,0,"",3.5,11
2010,11,reg,Philadelphia Eagles,New York Giants,PHI,27,17,10,3.5,44,48,FALSE,0,0,"",6.5,4
2010,11,reg,Pittsburgh Steelers,Oakland Raiders,PIT,35,3,32,7,38,41,FALSE,0,0,"",25,3
2010,11,reg,San Francisco 49ers,Tampa Bay Buccaneers,SF,0,21,21,3.5,21,41.5,FALSE,0,0,"",17.5,20.5
2010,11,reg,St. Louis Rams,Atlanta Falcons,ATL,17,34,17,3.5,51,43.5,FALSE,1,0,DOME,13.5,7.5
2010,11,reg,Tennessee Titans,Washington Redskins,TEN,16,19,3,7,35,44.5,FALSE,0,0,"",4,9.5
2010,11,reg,San Diego Chargers,Denver Broncos,LAC,35,14,21,9,49,50,FALSE,0,0,"",12,1
2010,12,reg,Dallas Cowboys,New Orleans Saints,NO,27,30,3,4.5,57,49,FALSE,1,0,DOME,1.5,8
2010,12,reg,Detroit Lions,New England Patriots,NE,24,45,21,7.5,69,50.5,FALSE,1,0,DOME,13.5,18.5
2010,12,reg,New York Jets,Cincinnati Bengals,NYJ,26,10,16,9.5,36,43.5,FALSE,0,0,"",6.5,7.5
2010,12,reg,Atlanta Falcons,Green Bay Packers,ATL,20,17,3,2,37,48,FALSE,1,0,DOME,1,11
2010,12,reg,Baltimore Ravens,Tampa Bay Buccaneers,BAL,17,10,7,7.5,27,41.5,FALSE,0,0,"",0.5,14.5
2010,12,reg,Buffalo Bills,Pittsburgh Steelers,PIT,16,19,3,7,35,44,FALSE,0,0,"",4,9
2010,12,reg,Chicago Bears,Philadelphia Eagles,PHI,31,26,5,3.5,57,43,FALSE,0,0,"",1.5,14
2010,12,reg,Cleveland Browns,Carolina Panthers,CLE,24,23,1,7.5,47,37.5,FALSE,0,0,"",6.5,9.5
2010,12,reg,Denver Broncos,St. Louis Rams,DEN,33,36,3,3,69,45,FALSE,0,0,"",0,24
2010,12,reg,Houston Texans,Tennessee Titans,HOU,20,0,20,5,20,46.5,FALSE,0,0,DOME (Open Roof),15,26.5
2010,12,reg,Indianapolis Colts,San Diego Chargers,IND,14,36,22,2,50,51,FALSE,1,0,DOME,20,1
2010,12,reg,New York Giants,Jacksonville Jaguars,NYG,24,20,4,7.5,44,44,FALSE,0,0,"",3.5,0
2010,12,reg,Oakland Raiders,Miami Dolphins,OAK,17,33,16,3,50,38,FALSE,0,0,"",13,12
2010,12,reg,Seattle Seahawks,Kansas City Chiefs,KC,24,42,18,2,66,45,FALSE,0,0,"",16,21
2010,12,reg,Washington Redskins,Minnesota Vikings,MIN,13,17,4,2.5,30,44,FALSE,0,0,"",1.5,14
2010,12,reg,Arizona Cardinals,San Francisco 49ers,SF,6,27,21,2,33,42,FALSE,1,0,DOME,19,9
2010,13,reg,Philadelphia Eagles,Houston Texans,PHI,34,24,10,8,58,49.5,FALSE,0,0,"",2,8.5
2010,13,reg,Arizona Cardinals,St. Louis Rams,LAR,6,19,13,3.5,25,44,FALSE,1,0,DOME,9.5,19
2010,13,reg,Baltimore Ravens,Pittsburgh Steelers,BAL,10,13,3,3,23,39,FALSE,0,0,"",0,16
2010,13,reg,Cincinnati Bengals,New Orleans Saints,NO,30,34,4,7,64,45.5,FALSE,0,0,"",3,18.5
2010,13,reg,Detroit Lions,Chicago Bears,CHI,20,24,4,5.5,44,43.5,FALSE,1,0,DOME,1.5,0.5
2010,13,reg,Green Bay Packers,San Francisco 49ers,GB,34,16,18,9,50,41,FALSE,0,0,"",9,9
2010,13,reg,Indianapolis Colts,Dallas Cowboys,IND,35,38,3,5.5,73,48,FALSE,1,0,DOME,2.5,25
2010,13,reg,Kansas City Chiefs,Denver Broncos,KC,10,6,4,8,16,48.5,FALSE,0,0,"",4,32.5
2010,13,reg,Miami Dolphins,Cleveland Browns,MIA,10,13,3,6,23,43.5,FALSE,0,0,"",3,20.5
2010,13,reg,Minnesota Vikings,Buffalo Bills,MIN,38,14,24,5,52,44,FALSE,1,0,DOME,19,8
2010,13,reg,New York Giants,Washington Redskins,NYG,31,7,24,7.5,38,43,FALSE,0,0,"",16.5,5
2010,13,reg,San Diego Chargers,Oakland Raiders,LAC,13,28,15,13,41,44.5,FALSE,0,0,"",2,3.5
2010,13,reg,Seattle Seahawks,Carolina Panthers,SEA,31,14,17,5,45,40,FALSE,0,0,"",12,5
2010,13,reg,Tampa Bay Buccaneers,Atlanta Falcons,ATL,24,28,4,3,52,43.5,FALSE,0,0,"",1,8.5
2010,13,reg,Tennessee Titans,Jacksonville Jaguars,TEN,6,17,11,3,23,43.5,FALSE,0,0,"",8,20.5
2010,13,reg,New England Patriots,New York Jets,NE,45,3,42,4,48,44.5,FALSE,0,0,"",38,3.5
2010,14,reg,Tennessee Titans,Indianapolis Colts,IND,28,30,2,4,58,44,FALSE,0,0,"",2,14
2010,14,reg,Arizona Cardinals,Denver Broncos,DEN,43,13,30,4,56,44,FALSE,1,0,DOME,26,12
2010,14,reg,Buffalo Bills,Cleveland Browns,PICK,13,6,7,0,19,39,FALSE,0,1,Rain | Fog,7,20
2010,14,reg,Carolina Panthers,Atlanta Falcons,ATL,10,31,21,7.5,41,41,FALSE,0,0,"",13.5,0
2010,14,reg,Chicago Bears,New England Patriots,NE,7,36,29,3,43,37,FALSE,0,1,Snow,26,6
2010,14,reg,Dallas Cowboys,Philadelphia Eagles,PHI,27,30,3,4,57,51,FALSE,1,0,DOME,1,6
2010,14,reg,Detroit Lions,Green Bay Packers,GB,7,3,4,7,10,46,FALSE,1,0,DOME,3,36
2010,14,reg,Jacksonville Jaguars,Oakland Raiders,JAX,38,31,7,3.5,69,41.5,FALSE,0,1,Rain,3.5,27.5
2010,14,reg,New Orleans Saints,St. Louis Rams,NO,31,13,18,9,44,47,FALSE,1,0,DOME,9,3
2010,14,reg,New York Jets,Miami Dolphins,NYJ,6,10,4,5.5,16,38,FALSE,0,0,"",1.5,22
2010,14,reg,Pittsburgh Steelers,Cincinnati Bengals,PIT,23,7,16,8,30,39.5,FALSE,0,1,Rain,8,9.5
2010,14,reg,San Diego Chargers,Kansas City Chiefs,LAC,31,0,31,10,31,45.5,FALSE,0,0,"",21,14.5
2010,14,reg,San Francisco 49ers,Seattle Seahawks,SF,40,21,19,5,61,43,FALSE,0,1,Fog,14,18
2010,14,reg,Washington Redskins,Tampa Bay Buccaneers,TB,16,17,1,1.5,33,41.5,FALSE,0,0,"",0.5,8.5
2010,14,reg,Houston Texans,Baltimore Ravens,BAL,28,34,6,3,62,47,FALSE,1,0,DOME,3,15
2010,14,reg,Minnesota Vikings,New York Giants,NYG,3,21,18,5.5,24,44,TRUE,1,0,DOME,12.5,20
2010,15,reg,San Diego Chargers,San Francisco 49ers,LAC,34,7,27,10.5,41,45,FALSE,0,0,"",16.5,4
2010,15,reg,Baltimore Ravens,New Orleans Saints,BAL,30,24,6,2.5,54,44.5,FALSE,0,0,"",3.5,9.5
2010,15,reg,Carolina Panthers,Arizona Cardinals,CAR,19,12,7,2.5,31,37.5,FALSE,0,0,"",4.5,6.5
2010,15,reg,Cincinnati Bengals,Cleveland Browns,PICK,19,17,2,0,36,41,FALSE,0,0,"",2,5
2010,15,reg,Dallas Cowboys,Washington Redskins,DAL,33,30,3,9.5,63,44.5,FALSE,0,0,"",6.5,18.5
2010,15,reg,Indianapolis Colts,Jacksonville Jaguars,IND,34,24,10,4.5,58,48,FALSE,1,0,DOME,5.5,10
2010,15,reg,Miami Dolphins,Buffalo Bills,MIA,14,17,3,5.5,31,40,FALSE,0,0,"",2.5,9
2010,15,reg,New England Patriots,Green Bay Packers,NE,31,27,4,14.5,58,43.5,FALSE,0,0,"",10.5,14.5
2010,15,reg,New York Giants,Philadelphia Eagles,NYG,31,38,7,3,69,47,FALSE,0,0,"",4,22
2010,15,reg,Oakland Raiders,Denver Broncos,OAK,39,23,16,8,62,42,FALSE,0,1,Rain,8,20
2010,15,reg,Pittsburgh Steelers,New York Jets,PIT,17,22,5,4,39,35.5,FALSE,0,0,"",1,3.5
2010,15,reg,Seattle Seahawks,Atlanta Falcons,ATL,18,34,16,6,52,46.5,FALSE,0,0,"",10,5.5
2010,15,reg,St. Louis Rams,Kansas City Chiefs,LAR,13,27,14,3,40,42.5,FALSE,1,0,DOME,11,2.5
2010,15,reg,Tampa Bay Buccaneers,Detroit Lions,TB,20,23,3,4,43,43,FALSE,0,0,"",1,0
2010,15,reg,Tennessee Titans,Houston Texans,TEN,31,17,14,1,48,47,FALSE,0,0,"",13,1
2010,15,reg,Minnesota Vikings,Chicago Bears,CHI,14,40,26,7,54,33,FALSE,0,0,Snow | Fog,19,21
2010,16,reg,Pittsburgh Steelers,Carolina Panthers,PIT,27,3,24,14.5,30,38,FALSE,0,0,"",9.5,8
2010,16,reg,Arizona Cardinals,Dallas Cowboys,DAL,27,26,1,7.5,53,45,FALSE,1,0,DOME,6.5,8
2010,16,reg,Buffalo Bills,New England Patriots,NE,3,34,31,9,37,45.5,FALSE,0,1,Snow,22,8.5
2010,16,reg,Chicago Bears,New York Jets,CHI,38,34,4,3,72,36,FALSE,0,0,"",1,36
2010,16,reg,Cincinnati Bengals,San Diego Chargers,LAC,34,20,14,8,54,43.5,FALSE,0,0,"",6,10.5
2010,16,reg,Cleveland Browns,Baltimore Ravens,BAL,10,20,10,4,30,40,FALSE,0,0,"",6,10
2010,16,reg,Denver Broncos,Houston Texans,HOU,24,23,1,2.5,47,49.5,FALSE,0,0,"",1.5,2.5
2010,16,reg,Green Bay Packers,New York Giants,GB,45,17,28,3,62,43,FALSE,0,0,"",25,19
2010,16,reg,Jacksonville Jaguars,Washington Redskins,JAX,17,20,3,6.5,37,45,FALSE,0,0,"",3.5,8
2010,16,reg,Kansas City Chiefs,Tennessee Titans,KC,34,14,20,4,48,42.5,FALSE,0,0,"",16,5.5
2010,16,reg,Miami Dolphins,Detroit Lions,MIA,27,34,7,3.5,61,41,FALSE,0,0,"",3.5,20
2010,16,reg,Oakland Raiders,Indianapolis Colts,IND,26,31,5,2.5,57,47.5,FALSE,0,0,"",2.5,9.5
2010,16,reg,St. Louis Rams,San Francisco 49ers,LAR,25,17,8,2.5,42,40,FALSE,1,0,DOME,5.5,2
2010,16,reg,Tampa Bay Buccaneers,Seattle Seahawks,TB,38,15,23,6,53,43.5,FALSE,0,0,"",17,9.5
2010,16,reg,Atlanta Falcons,New Orleans Saints,ATL,14,17,3,2.5,31,49.5,FALSE,1,0,DOME,0.5,18.5
2010,16,reg,Philadelphia Eagles,Minnesota Vikings,PHI,14,24,10,14.5,38,44.5,FALSE,0,0,"",4.5,6.5
2010,17,reg,Atlanta Falcons,Carolina Panthers,ATL,31,10,21,14.5,41,41.5,FALSE,1,0,DOME,6.5,0.5
2010,17,reg,Baltimore Ravens,Cincinnati Bengals,BAL,13,7,6,9.5,20,43,FALSE,0,0,"",3.5,23
2010,17,reg,Cleveland Browns,Pittsburgh Steelers,PIT,9,41,32,6.5,50,38,FALSE,0,0,"",25.5,12
2010,17,reg,Denver Broncos,San Diego Chargers,LAC,28,33,5,3.5,61,47.5,FALSE,0,0,"",1.5,13.5
2010,17,reg,Detroit Lions,Minnesota Vikings,DET,20,13,7,3.5,33,43.5,FALSE,1,0,DOME,3.5,10.5
2010,17,reg,Green Bay Packers,Chicago Bears,GB,10,3,7,10.5,13,43.5,FALSE,0,0,"",3.5,30.5
2010,17,reg,Houston Texans,Jacksonville Jaguars,HOU,34,17,17,4,51,48,FALSE,0,0,DOME (Open Roof),13,3
2010,17,reg,Indianapolis Colts,Tennessee Titans,IND,23,20,3,9.5,43,48,FALSE,1,0,DOME,6.5,5
2010,17,reg,Kansas City Chiefs,Oakland Raiders,KC,10,31,21,4.5,41,43.5,FALSE,0,0,"",16.5,2.5
2010,17,reg,New England Patriots,Miami Dolphins,NE,38,7,31,6,45,44,FALSE,0,1,Fog,25,1
2010,17,reg,New Orleans Saints,Tampa Bay Buccaneers,NO,13,23,10,7,36,47,FALSE,1,0,DOME,3,11
2010,17,reg,New York Jets,Buffalo Bills,NYJ,38,7,31,1.5,45,38,FALSE,0,1,Fog,29.5,7
2010,17,reg,Philadelphia Eagles,Dallas Cowboys,PICK,13,14,1,0,27,43.5,FALSE,0,1,Rain,1,16.5
2010,17,reg,San Francisco 49ers,Arizona Cardinals,SF,38,7,31,6,45,39,FALSE,0,0,"",25,6
2010,17,reg,Seattle Seahawks,St. Louis Rams,LAR,16,6,10,3,22,41.5,FALSE,0,0,"",7,19.5
2010,17,reg,Washington Redskins,New York Giants,NYG,14,17,3,4,31,44.5,FALSE,0,1,Rain,1,13.5
2010,Wildcard,post,Indianapolis Colts,New York Jets,IND,16,17,1,2,33,44.5,FALSE,1,0,DOME,1,11.5
2010,Wildcard,post,Seattle Seahawks,New Orleans Saints,NO,41,36,5,10,77,46,FALSE,0,0,"",5,31
2010,Wildcard,post,Kansas City Chiefs,Baltimore Ravens,BAL,7,30,23,3,37,41,FALSE,0,0,"",20,4
2010,Wildcard,post,Philadelphia Eagles,Green Bay Packers,PHI,16,21,5,2.5,37,47,FALSE,0,0,"",2.5,10
2010,Division,post,Atlanta Falcons,Green Bay Packers,ATL,21,48,27,1.5,69,43.5,FALSE,1,0,DOME,25.5,25.5
2010,Division,post,Pittsburgh Steelers,Baltimore Ravens,PIT,31,24,7,3,55,37,FALSE,0,0,"",4,18
2010,Division,post,Chicago Bears,Seattle Seahawks,CHI,35,24,11,10,59,43,FALSE,0,0,"",1,16
2010,Division,post,New England Patriots,New York Jets,NE,21,28,7,9.5,49,45,FALSE,0,0,"",2.5,4
2010,Conference,post,Chicago Bears,Green Bay Packers,GB,14,21,7,3.5,35,42.5,FALSE,0,0,"",3.5,7.5
2010,Conference,post,Pittsburgh Steelers,New York Jets,PIT,24,19,5,4,43,38,FALSE,0,0,"",1,5
2010,Superbowl,post,Green Bay Packers,Pittsburgh Steelers,GB,31,25,6,3,56,45,TRUE,0,0,"",3,11
2011,1,reg,Green Bay Packers,New Orleans Saints,GB,42,34,8,5,76,48,FALSE,0,0,"",3,28
2011,1,reg,Arizona Cardinals,Carolina Panthers,ARI,28,21,7,7,49,37.5,FALSE,1,0,DOME,0,11.5
2011,1,reg,Baltimore Ravens,Pittsburgh Steelers,BAL,35,7,28,1.5,42,37,FALSE,0,1,Rain,26.5,5
2011,1,reg,Chicago Bears,Atlanta Falcons,ATL,30,12,18,1.5,42,41,FALSE,0,0,"",16.5,1
2011,1,reg,Cleveland Browns,Cincinnati Bengals,CLE,17,27,10,7,44,36.5,FALSE,0,0,"",3,7.5
2011,1,reg,Houston Texans,Indianapolis Colts,HOU,34,7,27,9,41,44,FALSE,0,0,DOME (Open Roof),18,3
2011,1,reg,Jacksonville Jaguars,Tennessee Titans,TEN,16,14,2,1.5,30,38,FALSE,0,0,"",0.5,8
2011,1,reg,Kansas City Chiefs,Buffalo Bills,KC,7,41,34,3.5,48,40,FALSE,0,0,"",30.5,8
2011,1,reg,New York Jets,Dallas Cowboys,NYJ,27,24,3,6,51,41,FALSE,0,0,"",3,10
2011,1,reg,San Diego Chargers,Minnesota Vikings,LAC,24,17,7,8.5,41,43,FALSE,0,0,"",1.5,2
2011,1,reg,San Francisco 49ers,Seattle Seahawks,SF,33,17,16,6,50,38,FALSE,0,0,"",10,12
2011,1,reg,St. Louis Rams,Philadelphia Eagles,PHI,13,31,18,4,44,44.5,FALSE,1,0,DOME,14,0.5
2011,1,reg,Tampa Bay Buccaneers,Detroit Lions,TB,20,27,7,1.5,47,43.5,FALSE,0,0,"",5.5,3.5
2011,1,reg,Washington Redskins,New York Giants,NYG,28,14,14,2,42,40,FALSE,0,0,"",12,2
2011,1,reg,Denver Broncos,Oakland Raiders,DEN,20,23,3,3,43,42,FALSE,0,0,"",0,1
2011,1,reg,Miami Dolphins,New England Patriots,NE,24,38,14,7.5,62,47,FALSE,0,0,"",6.5,15
2011,2,reg,Atlanta Falcons,Philadelphia Eagles,PHI,35,31,4,2.5,66,49.5,FALSE,1,0,DOME,1.5,16.5
2011,2,reg,Buffalo Bills,Oakland Raiders,BUF,38,35,3,4,73,41,FALSE,0,0,"",1,32
2011,2,reg,Carolina Panthers,Green Bay Packers,GB,23,30,7,11,53,45,FALSE,0,0,"",4,8
2011,2,reg,Denver Broncos,Cincinnati Bengals,DEN,24,22,2,3,46,41,FALSE,0,0,"",1,5
2011,2,reg,Detroit Lions,Kansas City Chiefs,DET,48,3,45,9,51,45,FALSE,1,0,DOME,36,6
2011,2,reg,Indianapolis Colts,Cleveland Browns,CLE,19,27,8,1.5,46,39,FALSE,1,0,DOME,6.5,7
2011,2,reg,Miami Dolphins,Houston Texans,HOU,13,23,10,3,36,47.5,FALSE,0,0,"",7,11.5
2011,2,reg,Minnesota Vikings,Tampa Bay Buccaneers,MIN,20,24,4,1,44,41,FALSE,1,0,DOME,3,3
2011,2,reg,New England Patriots,San Diego Chargers,NE,35,21,14,7,56,53.5,FALSE,0,0,"",7,2.5
2011,2,reg,New Orleans Saints,Chicago Bears,NO,30,13,17,5,43,46.5,FALSE,1,0,DOME,12,3.5
2011,2,reg,New York Jets,Jacksonville Jaguars,NYJ,32,3,29,9,35,38.5,FALSE,0,0,"",20,3.5
2011,2,reg,Pittsburgh Steelers,Seattle Seahawks,PIT,24,0,24,14,24,40,FALSE,0,0,"",10,16
2011,2,reg,San Francisco 49ers,Dallas Cowboys,DAL,24,27,3,3,51,41.5,FALSE,0,0,"",0,9.5
2011,2,reg,Tennessee Titans,Baltimore Ravens,BAL,26,13,13,6,39,39,FALSE,0,0,"",7,0
2011,2,reg,Washington Redskins,Arizona Cardinals,WAS,22,21,1,4.5,43,45,FALSE,0,0,"",3.5,2
2011,2,reg,New York Giants,St. Louis Rams,NYG,28,16,12,7,44,44,FALSE,0,0,"",5,0
2011,3,reg,Buffalo Bills,New England Patriots,NE,34,31,3,7.5,65,54.5,FALSE,0,0,"",4.5,10.5
2011,3,reg,Carolina Panthers,Jacksonville Jaguars,CAR,16,10,6,3.5,26,43.5,FALSE,0,1,Rain,2.5,17.5
2011,3,reg,Chicago Bears,Green Bay Packers,GB,17,27,10,5,44,45.5,FALSE,0,0,"",5,1.5
2011,3,reg,Cincinnati Bengals,San Francisco 49ers,CIN,8,13,5,1,21,38.5,FALSE,0,0,"",4,17.5
2011,3,reg,Cleveland Browns,Miami Dolphins,MIA,17,16,1,2,33,42.5,FALSE,0,0,"",1,9.5
2011,3,reg,Indianapolis Colts,Pittsburgh Steelers,PIT,20,23,3,11,43,39.5,FALSE,1,0,DOME,8,3.5
2011,3,reg,Minnesota Vikings,Detroit Lions,DET,23,26,3,3,49,45,FALSE,1,0,DOME,0,4
2011,3,reg,New Orleans Saints,Houston Texans,NO,40,33,7,4,73,51,FALSE,1,0,DOME,3,22
2011,3,reg,Oakland Raiders,New York Jets,NYJ,34,24,10,3,58,41,FALSE,0,0,"",7,17
2011,3,reg,Philadelphia Eagles,New York Giants,PHI,16,29,13,8,45,46.5,FALSE,0,0,"",5,1.5
2011,3,reg,San Diego Chargers,Kansas City Chiefs,LAC,20,17,3,14.5,37,44.5,FALSE,0,0,"",11.5,7.5
2011,3,reg,Seattle Seahawks,Arizona Cardinals,ARI,13,10,3,3,23,43,FALSE,0,0,"",0,20
2011,3,reg,St. Louis Rams,Baltimore Ravens,BAL,7,37,30,6,44,42,FALSE,1,0,DOME,24,2
2011,3,reg,Tampa Bay Buccaneers,Atlanta Falcons,TB,16,13,3,1,29,45,FALSE,0,0,"",2,16
2011,3,reg,Tennessee Titans,Denver Broncos,TEN,17,14,3,7,31,44,FALSE,0,0,"",4,13
2011,3,reg,Dallas Cowboys,Washington Redskins,DAL,18,16,2,3.5,34,45,FALSE,1,0,DOME,1.5,11
2011,4,reg,Arizona Cardinals,New York Giants,NYG,27,31,4,1.5,58,45,FALSE,1,0,DOME,2.5,13
2011,4,reg,Baltimore Ravens,New York Jets,BAL,34,17,17,5,51,43.5,FALSE,0,0,"",12,7.5
2011,4,reg,Chicago Bears,Carolina Panthers,CHI,34,29,5,7,63,42,FALSE,0,0,"",2,21
2011,4,reg,Cincinnati Bengals,Buffalo Bills,BUF,23,20,3,3,43,43,FALSE,0,0,"",0,0
2011,4,reg,Cleveland Browns,Tennessee Titans,CLE,13,31,18,1.5,44,37.5,FALSE,0,0,"",16.5,6.5
2011,4,reg,Dallas Cowboys,Detroit Lions,DAL,30,34,4,2.5,64,46.5,FALSE,1,0,DOME,1.5,17.5
2011,4,reg,Green Bay Packers,Denver Broncos,GB,49,23,26,12,72,46.5,FALSE,0,0,"",14,25.5
2011,4,reg,Houston Texans,Pittsburgh Steelers,HOU,17,10,7,4,27,46.5,FALSE,0,0,DOME (Open Roof),3,19.5
2011,4,reg,Jacksonville Jaguars,New Orleans Saints,NO,10,23,13,9,33,45,FALSE,0,0,"",4,12
2011,4,reg,Kansas City Chiefs,Minnesota Vikings,MIN,22,17,5,3,39,40,FALSE,0,0,"",2,1
2011,4,reg,Oakland Raiders,New England Patriots,NE,19,31,12,6.5,50,55.5,FALSE,0,0,"",5.5,5.5
2011,4,reg,Philadelphia Eagles,San Francisco 49ers,PHI,23,24,1,10,47,43.5,FALSE,0,1,Rain | Fog,9,3.5
2011,4,reg,San Diego Chargers,Miami Dolphins,LAC,26,16,10,7,42,45,FALSE,0,0,"",3,3
2011,4,reg,Seattle Seahawks,Atlanta Falcons,ATL,28,30,2,6,58,39,FALSE,0,0,"",4,19
2011,4,reg,St. Louis Rams,Washington Redskins,WAS,10,17,7,3,27,44,FALSE,1,0,DOME,4,17
2011,4,reg,Tampa Bay Buccaneers,Indianapolis Colts,TB,24,17,7,10,41,40.5,FALSE,0,0,"",3,0.5
2011,5,reg,Atlanta Falcons,Green Bay Packers,GB,14,25,11,6.5,39,53,FALSE,1,0,DOME,4.5,14
2011,5,reg,Buffalo Bills,Philadelphia Eagles,PHI,31,24,7,3,55,53,FALSE,0,0,"",4,2
2011,5,reg,Carolina Panthers,New Orleans Saints,NO,27,30,3,6.5,57,51.5,FALSE,0,0,"",3.5,5.5
2011,5,reg,Denver Broncos,San Diego Chargers,LAC,24,29,5,3.5,53,46.5,FALSE,0,0,"",1.5,6.5
2011,5,reg,Houston Texans,Oakland Raiders,HOU,20,25,5,4.5,45,48.5,FALSE,0,0,DOME (Open Roof),0.5,3.5
2011,5,reg,Indianapolis Colts,Kansas City Chiefs,IND,24,28,4,1.5,52,38,FALSE,1,0,DOME,2.5,14
2011,5,reg,Jacksonville Jaguars,Cincinnati Bengals,CIN,20,30,10,2.5,50,37,FALSE,0,0,"",7.5,13
2011,5,reg,Minnesota Vikings,Arizona Cardinals,MIN,34,10,24,3.5,44,45,FALSE,1,0,DOME,20.5,1
2011,5,reg,New England Patriots,New York Jets,NE,30,21,9,7.5,51,50,FALSE,0,0,"",1.5,1
2011,5,reg,New York Giants,Seattle Seahawks,NYG,25,36,11,10,61,43.5,FALSE,0,0,"",1,17.5
2011,5,reg,Pittsburgh Steelers,Tennessee Titans,PIT,38,17,21,3,55,40,FALSE,0,0,"",18,15
2011,5,reg,San Francisco 49ers,Tampa Bay Buccaneers,SF,48,3,45,3,51,41.5,FALSE,0,0,"",42,9.5
2011,5,reg,Detroit Lions,Chicago Bears,DET,24,13,11,7,37,47,FALSE,1,0,DOME,4,10
2011,6,reg,Atlanta Falcons,Carolina Panthers,ATL,31,17,14,3.5,48,49.5,FALSE,1,0,DOME,10.5,1.5
2011,6,reg,Baltimore Ravens,Houston Texans,BAL,29,14,15,7,43,43.5,FALSE,0,0,"",8,0.5
2011,6,reg,Chicago Bears,Minnesota Vikings,CHI,39,10,29,2.5,49,42,FALSE,0,0,"",26.5,7
2011,6,reg,Cincinnati Bengals,Indianapolis Colts,CIN,27,17,10,4.5,44,40.5,FALSE,0,0,"",5.5,3.5
2011,6,reg,Detroit Lions,San Francisco 49ers,DET,19,25,6,5,44,45,FALSE,1,0,DOME,1,1
2011,6,reg,Green Bay Packers,St. Louis Rams,GB,24,3,21,14,27,47.5,FALSE,0,0,"",7,20.5
2011,6,reg,New England Patriots,Dallas Cowboys,NE,20,16,4,7,36,54.5,FALSE,0,0,"",3,18.5
2011,6,reg,New York Giants,Buffalo Bills,NYG,27,24,3,3,51,49,FALSE,0,0,"",0,2
2011,6,reg,Oakland Raiders,Cleveland Browns,OAK,24,17,7,6.5,41,45,FALSE,0,0,"",0.5,4
2011,6,reg,Pittsburgh Steelers,Jacksonville Jaguars,PIT,17,13,4,12.5,30,40,FALSE,0,0,"",8.5,10
2011,6,reg,Tampa Bay Buccaneers,New Orleans Saints,NO,26,20,6,6.5,46,49.5,FALSE,0,0,"",0.5,3.5
2011,6,reg,Washington Redskins,Philadelphia Eagles,PHI,13,20,7,3,33,46.5,FALSE,0,0,"",4,13.5
2011,6,reg,New York Jets,Miami Dolphins,NYJ,24,6,18,7.5,30,41.5,FALSE,0,0,"",10.5,11.5
2011,7,reg,Arizona Cardinals,Pittsburgh Steelers,PIT,20,32,12,4.5,52,46.5,FALSE,1,0,DOME,7.5,5.5
2011,7,reg,Carolina Panthers,Washington Redskins,CAR,33,20,13,2.5,53,44.5,FALSE,0,0,"",10.5,8.5
2011,7,reg,Cleveland Browns,Seattle Seahawks,CLE,6,3,3,3,9,41,FALSE,0,0,"",0,32
2011,7,reg,Dallas Cowboys,St. Louis Rams,DAL,34,7,27,14,41,43,FALSE,1,0,DOME,13,2
2011,7,reg,Detroit Lions,Atlanta Falcons,DET,16,23,7,4.5,39,47,FALSE,1,0,DOME,2.5,8
2011,7,reg,Miami Dolphins,Denver Broncos,DEN,15,18,3,1,33,41.5,FALSE,0,0,"",2,8.5
2011,7,reg,Minnesota Vikings,Green Bay Packers,GB,27,33,6,11,60,47,FALSE,1,0,DOME,5,13
2011,7,reg,New Orleans Saints,Indianapolis Colts,NO,62,7,55,14,69,49,FALSE,1,0,DOME,41,20
2011,7,reg,New York Jets,San Diego Chargers,LAC,27,21,6,1,48,43.5,FALSE,0,0,"",5,4.5
2011,7,reg,Oakland Raiders,Kansas City Chiefs,OAK,0,28,28,3.5,28,41.5,FALSE,0,0,"",24.5,13.5
2011,7,reg,Tampa Bay Buccaneers,Chicago Bears,CHI,18,24,6,2,42,44,TRUE,0,0,"",4,2
2011,7,reg,Tennessee Titans,Houston Texans,TEN,7,41,34,2.5,48,44,FALSE,0,0,"",31.5,4
2011,7,reg,Jacksonville Jaguars,Baltimore Ravens,BAL,12,7,5,10.5,19,39,FALSE,0,0,"",5.5,20
2011,8,reg,Baltimore Ravens,Arizona Cardinals,BAL,30,27,3,11.5,57,43,FALSE,0,0,"",8.5,14
2011,8,reg,Buffalo Bills,Washington Redskins,BUF,23,0,23,4,23,46.5,TRUE,1,0,DOME,19,23.5
2011,8,reg,Carolina Panthers,Minnesota Vikings,CAR,21,24,3,3,45,47,FALSE,0,0,"",0,2
2011,8,reg,Denver Broncos,Detroit Lions,DET,10,45,35,3.5,55,43.5,FALSE,0,0,"",31.5,11.5
2011,8,reg,Houston Texans,Jacksonville Jaguars,HOU,24,14,10,10,38,41,FALSE,0,0,DOME (Open Roof),0,3
2011,8,reg,New York Giants,Miami Dolphins,NYG,20,17,3,10,37,43.5,FALSE,0,0,"",7,6.5
2011,8,reg,Philadelphia Eagles,Dallas Cowboys,PHI,34,7,27,3,41,49.5,FALSE,0,0,"",24,8.5
2011,8,reg,Pittsburgh Steelers,New England Patriots,NE,25,17,8,3,42,52,FALSE,0,0,"",5,10
2011,8,reg,San Francisco 49ers,Cleveland Browns,SF,20,10,10,9.5,30,38.5,FALSE,0,0,"",0.5,8.5
2011,8,reg,Seattle Seahawks,Cincinnati Bengals,CIN,12,34,22,1.5,46,37.5,FALSE,0,0,"",20.5,8.5
2011,8,reg,St. Louis Rams,New Orleans Saints,NO,31,21,10,14,52,48.5,FALSE,1,0,DOME,4,3.5
2011,8,reg,Tennessee Titans,Indianapolis Colts,TEN,27,10,17,7.5,37,43.5,FALSE,0,0,"",9.5,6.5
2011,8,reg,Kansas City Chiefs,San Diego Chargers,LAC,23,20,3,3,43,44.5,FALSE,0,0,"",0,1.5
2011,9,reg,Arizona Cardinals,St. Louis Rams,ARI,19,13,6,3,32,41.5,FALSE,1,0,DOME,3,9.5
2011,9,reg,Buffalo Bills,New York Jets,BUF,11,27,16,2.5,38,45,FALSE,0,0,"",13.5,7
2011,9,reg,Dallas Cowboys,Seattle Seahawks,DAL,23,13,10,11,36,45,FALSE,1,0,DOME,1,9
2011,9,reg,Houston Texans,Cleveland Browns,HOU,30,12,18,10.5,42,41,FALSE,0,0,DOME (Open Roof),7.5,1
2011,9,reg,Indianapolis Colts,Atlanta Falcons,ATL,7,31,24,7,38,45.5,FALSE,1,0,DOME,17,7.5
2011,9,reg,Kansas City Chiefs,Miami Dolphins,KC,3,31,28,4,34,40.5,FALSE,0,0,"",24,6.5
2011,9,reg,New England Patriots,New York Giants,NE,20,24,4,9,44,51,FALSE,0,0,"",5,7
2011,9,reg,New Orleans Saints,Tampa Bay Buccaneers,NO,27,16,11,9,43,50.5,FALSE,1,0,DOME,2,7.5
2011,9,reg,Oakland Raiders,Denver Broncos,OAK,24,38,14,7.5,62,42.5,FALSE,0,0,"",6.5,19.5
2011,9,reg,Pittsburgh Steelers,Baltimore Ravens,PIT,20,23,3,3.5,43,42,FALSE,0,0,"",0.5,1
2011,9,reg,San Diego Chargers,Green Bay Packers,GB,38,45,7,6,83,51,FALSE,0,1,Fog,1,32
2011,9,reg,Tennessee Titans,Cincinnati Bengals,TEN,17,24,7,3,41,41.5,FALSE,0,0,"",4,0.5
2011,9,reg,Washington Redskins,San Francisco 49ers,SF,11,19,8,4.5,30,37.5,FALSE,0,0,"",3.5,7.5
2011,9,reg,Philadelphia Eagles,Chicago Bears,PHI,24,30,6,8,54,47.5,FALSE,0,0,"",2,6.5
2011,10,reg,San Diego Chargers,Oakland Raiders,LAC,17,24,7,7,41,48,FALSE,0,0,"",0,7
2011,10,reg,Atlanta Falcons,New Orleans Saints,ATL,23,26,3,1,49,50,FALSE,1,0,DOME,2,1
2011,10,reg,Carolina Panthers,Tennessee Titans,CAR,3,30,27,3.5,33,47.5,FALSE,0,0,"",23.5,14.5
2011,10,reg,Chicago Bears,Detroit Lions,CHI,37,13,24,3,50,42.5,FALSE,0,0,"",21,7.5
2011,10,reg,Cincinnati Bengals,Pittsburgh Steelers,PIT,17,24,7,4,41,40.5,FALSE,0,0,"",3,0.5
2011,10,reg,Cleveland Browns,St. Louis Rams,CLE,12,13,1,3,25,36.5,FALSE,0,0,"",2,11.5
2011,10,reg,Dallas Cowboys,Buffalo Bills,DAL,44,7,37,4.5,51,49,FALSE,1,0,DOME,32.5,2
2011,10,reg,Indianapolis Colts,Jacksonville Jaguars,JAX,3,17,14,3,20,37.5,FALSE,1,0,DOME,11,17.5
2011,10,reg,Kansas City Chiefs,Denver Broncos,KC,10,17,7,3.5,27,42.5,FALSE,0,0,"",3.5,15.5
2011,10,reg,Miami Dolphins,Washington Redskins,MIA,20,9,11,4,29,38,FALSE,0,0,"",7,9
2011,10,reg,New York Jets,New England Patriots,NYJ,16,37,21,2.5,53,47,FALSE,0,0,"",18.5,6
2011,10,reg,Philadelphia Eagles,Arizona Cardinals,PHI,17,21,4,13,38,47.5,FALSE,0,0,"",9,9.5
2011,10,reg,San Francisco 49ers,New York Giants,SF,27,20,7,4,47,42.5,FALSE,0,0,"",3,4.5
2011,10,reg,Seattle Seahawks,Baltimore Ravens,BAL,22,17,5,7,39,39,FALSE,0,0,"",2,0
2011,10,reg,Tampa Bay Buccaneers,Houston Texans,HOU,9,37,28,4,46,45.5,FALSE,0,0,"",24,0.5
2011,10,reg,Green Bay Packers,Minnesota Vikings,GB,45,7,38,13,52,50,FALSE,0,0,"",25,2
2011,11,reg,Denver Broncos,New York Jets,NYJ,17,13,4,6.5,30,38.5,FALSE,0,0,"",2.5,8.5
2011,11,reg,Atlanta Falcons,Tennessee Titans,ATL,23,17,6,6.5,40,44,FALSE,1,0,DOME,0.5,4
2011,11,reg,Baltimore Ravens,Cincinnati Bengals,BAL,31,24,7,7,55,40.5,FALSE,0,0,"",0,14.5
2011,11,reg,Chicago Bears,San Diego Chargers,CHI,31,20,11,4.5,51,45.5,FALSE,0,0,"",6.5,5.5
2011,11,reg,Cleveland Browns,Jacksonville Jaguars,CLE,14,10,4,1.5,24,34.5,FALSE,0,0,"",2.5,10.5
2011,11,reg,Detroit Lions,Carolina Panthers,DET,49,35,14,7,84,47.5,FALSE,1,0,DOME,7,36.5
2011,11,reg,Green Bay Packers,Tampa Bay Buccaneers,GB,35,26,9,13.5,61,49,FALSE,0,0,"",4.5,12
2011,11,reg,Miami Dolphins,Buffalo Bills,MIA,35,8,27,3,43,44,FALSE,0,1,Rain,24,1
2011,11,reg,Minnesota Vikings,Oakland Raiders,MIN,21,27,6,2,48,46.5,FALSE,1,0,DOME,4,1.5
2011,11,reg,New York Giants,Philadelphia Eagles,NYG,10,17,7,6,27,45.5,FALSE,0,0,"",1,18.5
2011,11,reg,San Francisco 49ers,Arizona Cardinals,SF,23,7,16,10,30,40.5,FALSE,0,1,Rain,6,10.5
2011,11,reg,St. Louis Rams,Seattle Seahawks,LAR,7,24,17,3,31,40,FALSE,1,0,DOME,14,9
2011,11,reg,Washington Redskins,Dallas Cowboys,DAL,24,27,3,7,51,43,FALSE,0,0,"",4,8
2011,11,reg,New England Patriots,Kansas City Chiefs,NE,34,3,31,17,37,47,FALSE,0,0,"",14,10
2011,12,reg,Baltimore Ravens,San Francisco 49ers,BAL,16,6,10,3.5,22,40.5,FALSE,0,0,"",6.5,18.5
2011,12,reg,Dallas Cowboys,Miami Dolphins,DAL,20,19,1,7,39,46,FALSE,1,0,DOME,6,7
2011,12,reg,Detroit Lions,Green Bay Packers,GB,15,27,12,4.5,42,55,FALSE,1,0,DOME,7.5,13
2011,12,reg,Atlanta Falcons,Minnesota Vikings,ATL,24,14,10,10,38,44,FALSE,1,0,DOME,0,6
2011,12,reg,Cincinnati Bengals,Cleveland Browns,CIN,23,20,3,7,43,38,FALSE,0,1,Rain,4,5
2011,12,reg,Indianapolis Colts,Carolina Panthers,CAR,19,27,8,3.5,46,46.5,FALSE,1,0,DOME,4.5,0.5
2011,12,reg,Jacksonville Jaguars,Houston Texans,HOU,13,20,7,6.5,33,37,FALSE,0,0,"",0.5,4
2011,12,reg,Kansas City Chiefs,Pittsburgh Steelers,PIT,9,13,4,10.5,22,40.5,FALSE,0,0,"",6.5,18.5
2011,12,reg,New York Jets,Buffalo Bills,NYJ,28,24,4,9.5,52,42.5,FALSE,0,0,"",5.5,9.5
2011,12,reg,Oakland Raiders,Chicago Bears,OAK,25,20,5,3,45,41,FALSE,0,0,"",2,4
2011,12,reg,Philadelphia Eagles,New England Patriots,NE,20,38,18,3.5,58,50.5,FALSE,0,0,"",14.5,7.5
2011,12,reg,San Diego Chargers,Denver Broncos,LAC,13,16,3,5.5,29,42,FALSE,0,0,"",2.5,13
2011,12,reg,Seattle Seahawks,Washington Redskins,SEA,17,23,6,3,40,37.5,FALSE,0,1,Rain,3,2.5
2011,12,reg,St. Louis Rams,Arizona Cardinals,LAR,20,23,3,2.5,43,40,FALSE,1,0,DOME,0.5,3
2011,12,reg,Tennessee Titans,Tampa Bay Buccaneers,TEN,23,17,6,3,40,44,FALSE,0,0,"",3,4
2011,12,reg,New Orleans Saints,New York Giants,NO,49,24,25,7,73,51,FALSE,1,0,DOME,18,22
2011,13,reg,Seattle Seahawks,Philadelphia Eagles,PHI,31,14,17,3,45,43.5,FALSE,0,0,"",14,1.5
2011,13,reg,Arizona Cardinals,Dallas Cowboys,DAL,19,13,6,4.5,32,46.5,FALSE,1,0,DOME,1.5,14.5
2011,13,reg,Buffalo Bills,Tennessee Titans,BUF,17,23,6,1,40,44,FALSE,0,0,"",5,4
2011,13,reg,Chicago Bears,Kansas City Chiefs,CHI,3,10,7,9,13,35,FALSE,0,1,Rain,2,22
2011,13,reg,Cleveland Browns,Baltimore Ravens,BAL,10,24,14,7,34,38.5,FALSE,0,1,Rain,7,4.5
2011,13,reg,Houston Texans,Atlanta Falcons,ATL,17,10,7,2,27,38,FALSE,0,0,DOME (Open Roof),5,11
2011,13,reg,Miami Dolphins,Oakland Raiders,MIA,34,14,20,3,48,43,FALSE,0,0,"",17,5
2011,13,reg,Minnesota Vikings,Denver Broncos,MIN,32,35,3,1.5,67,37.5,FALSE,1,0,DOME,1.5,29.5
2011,13,reg,New England Patriots,Indianapolis Colts,NE,31,24,7,20.5,55,48.5,FALSE,0,0,"",13.5,6.5
2011,13,reg,New Orleans Saints,Detroit Lions,NO,31,17,14,9,48,54.5,FALSE,1,0,DOME,5,6.5
2011,13,reg,New York Giants,Green Bay Packers,GB,35,38,3,7,73,54,FALSE,0,0,"",4,19
2011,13,reg,Pittsburgh Steelers,Cincinnati Bengals,PIT,35,7,28,7,42,43,FALSE,0,0,"",21,1
2011,13,reg,San Francisco 49ers,St. Louis Rams,SF,26,0,26,14.5,26,38.5,FALSE,0,0,"",11.5,12.5
2011,13,reg,Tampa Bay Buccaneers,Carolina Panthers,CAR,19,38,19,2.5,57,46.5,FALSE,0,0,"",16.5,10.5
2011,13,reg,Washington Redskins,New York Jets,NYJ,19,34,15,3,53,38.5,FALSE,0,0,"",12,14.5
2011,13,reg,Jacksonville Jaguars,San Diego Chargers,LAC,14,38,24,3,52,39.5,FALSE,0,0,"",21,12.5
2011,14,reg,Pittsburgh Steelers,Cleveland Browns,PIT,14,3,11,14,17,40,FALSE,0,0,"",3,23
2011,14,reg,Arizona Cardinals,San Francisco 49ers,SF,21,19,2,3.5,40,40,FALSE,1,0,DOME,1.5,0
2011,14,reg,Baltimore Ravens,Indianapolis Colts,BAL,24,10,14,16.5,34,41.5,FALSE,0,0,"",2.5,7.5
2011,14,reg,Carolina Panthers,Atlanta Falcons,ATL,23,31,8,3,54,47.5,FALSE,0,0,"",5,6.5
2011,14,reg,Cincinnati Bengals,Houston Texans,CIN,19,20,1,3,39,37,FALSE,0,0,"",2,2
2011,14,reg,Dallas Cowboys,New York Giants,DAL,34,37,3,4.5,71,50.5,FALSE,1,0,DOME,1.5,20.5
2011,14,reg,Denver Broncos,Chicago Bears,DEN,13,10,3,3.5,23,35.5,FALSE,0,0,"",0.5,12.5
2011,14,reg,Detroit Lions,Minnesota Vikings,DET,34,28,6,10,62,47,FALSE,1,0,DOME,4,15
2011,14,reg,Green Bay Packers,Oakland Raiders,GB,46,16,30,11.5,62,49.5,FALSE,0,0,"",18.5,12.5
2011,14,reg,Jacksonville Jaguars,Tampa Bay Buccaneers,TB,41,14,27,3,55,42,FALSE,0,1,Rain,24,13
2011,14,reg,Miami Dolphins,Philadelphia Eagles,MIA,10,26,16,3,36,44.5,FALSE,0,0,"",13,8.5
2011,14,reg,New York Jets,Kansas City Chiefs,NYJ,37,10,27,10.5,47,35.5,FALSE,0,0,"",16.5,11.5
2011,14,reg,San Diego Chargers,Buffalo Bills,LAC,37,10,27,7,47,49,FALSE,0,0,"",20,2
2011,14,reg,Tennessee Titans,New Orleans Saints,NO,17,22,5,3.5,39,48,FALSE,0,0,"",1.5,9
2011,14,reg,Washington Redskins,New England Patriots,NE,27,34,7,7.5,61,47,FALSE,0,0,"",0.5,14
2011,14,reg,Seattle Seahawks,St. Louis Rams,SEA,30,13,17,9.5,43,37,FALSE,0,0,"",7.5,6
2011,15,reg,Atlanta Falcons,Jacksonville Jaguars,ATL,41,14,27,13.5,55,42,FALSE,1,0,DOME,13.5,13
2011,15,reg,Tampa Bay Buccaneers,Dallas Cowboys,DAL,15,31,16,7,46,47,FALSE,0,0,"",9,1
2011,15,reg,Arizona Cardinals,Cleveland Browns,ARI,20,17,3,6.5,37,37.5,FALSE,1,0,DOME,3.5,0.5
2011,15,reg,Buffalo Bills,Miami Dolphins,BUF,23,30,7,1.5,53,40.5,FALSE,0,1,Snow,5.5,12.5
2011,15,reg,Chicago Bears,Seattle Seahawks,CHI,14,38,24,3.5,52,35,FALSE,0,0,"",20.5,17
2011,15,reg,Denver Broncos,New England Patriots,NE,23,41,18,7.5,64,47.5,FALSE,0,0,"",10.5,16.5
2011,15,reg,Houston Texans,Carolina Panthers,HOU,13,28,15,6,41,45.5,FALSE,0,0,DOME (Open Roof),9,4.5
2011,15,reg,Indianapolis Colts,Tennessee Titans,TEN,27,13,14,6.5,40,41.5,FALSE,1,0,DOME,7.5,1.5
2011,15,reg,Kansas City Chiefs,Green Bay Packers,GB,19,14,5,11.5,33,46,FALSE,0,0,"",6.5,13
2011,15,reg,Minnesota Vikings,New Orleans Saints,NO,20,42,22,7.5,62,53.5,FALSE,1,0,DOME,14.5,8.5
2011,15,reg,New York Giants,Washington Redskins,NYG,10,23,13,6,33,46.5,FALSE,0,0,"",7,13.5
2011,15,reg,Oakland Raiders,Detroit Lions,DET,27,28,1,1.5,55,47.5,FALSE,0,0,"",0.5,7.5
2011,15,reg,Philadelphia Eagles,New York Jets,PHI,45,19,26,3,64,44,FALSE,0,0,"",23,20
2011,15,reg,San Diego Chargers,Baltimore Ravens,BAL,34,14,20,2.5,48,44,FALSE,0,0,"",17.5,4
2011,15,reg,St. Louis Rams,Cincinnati Bengals,CIN,13,20,7,7,33,39,FALSE,1,0,DOME,0,6
2011,15,reg,San Francisco 49ers,Pittsburgh Steelers,SF,20,3,17,3,23,37,FALSE,0,0,"",14,14
2011,16,reg,Indianapolis Colts,Houston Texans,HOU,19,16,3,7,35,40.5,FALSE,1,0,DOME,4,5.5
2011,16,reg,Baltimore Ravens,Cleveland Browns,BAL,20,14,6,11,34,38,FALSE,0,0,"",5,4
2011,16,reg,Buffalo Bills,Denver Broncos,DEN,40,14,26,3,54,43.5,FALSE,0,0,"",23,10.5
2011,16,reg,Carolina Panthers,Tampa Bay Buccaneers,CAR,48,16,32,7.5,64,48,FALSE,0,0,"",24.5,16
2011,16,reg,Cincinnati Bengals,Arizona Cardinals,CIN,23,16,7,4,39,41,FALSE,0,0,"",3,2
2011,16,reg,Dallas Cowboys,Philadelphia Eagles,PHI,7,20,13,2.5,27,50,FALSE,1,0,DOME,10.5,23
2011,16,reg,Detroit Lions,San Diego Chargers,LAC,38,10,28,1,48,53,FALSE,1,0,DOME,27,5
2011,16,reg,Kansas City Chiefs,Oakland Raiders,KC,13,16,3,3,29,43,FALSE,0,0,"",0,14
2011,16,reg,New England Patriots,Miami Dolphins,NE,27,24,3,7.5,51,49.5,FALSE,0,0,"",4.5,1.5
2011,16,reg,New York Jets,New York Giants,NYJ,14,29,15,3,43,46,FALSE,0,0,"",12,3
2011,16,reg,Pittsburgh Steelers,St. Louis Rams,PIT,27,0,27,10,27,34,FALSE,0,0,"",17,7
2011,16,reg,Seattle Seahawks,San Francisco 49ers,SF,17,19,2,2.5,36,37,FALSE,0,0,"",0.5,1
2011,16,reg,Tennessee Titans,Jacksonville Jaguars,TEN,23,17,6,8.5,40,38.5,FALSE,0,0,"",2.5,1.5
2011,16,reg,Washington Redskins,Minnesota Vikings,WAS,26,33,7,6,59,43,FALSE,0,0,"",1,16
2011,16,reg,Green Bay Packers,Chicago Bears,GB,35,21,14,13,56,42,FALSE,0,0,"",1,14
2011,16,reg,New Orleans Saints,Atlanta Falcons,NO,45,16,29,7,61,52.5,FALSE,1,0,DOME,22,8.5
2011,17,reg,Arizona Cardinals,Seattle Seahawks,ARI,23,20,3,2.5,43,40.5,FALSE,1,0,DOME,0.5,2.5
2011,17,reg,Atlanta Falcons,Tampa Bay Buccaneers,ATL,45,24,21,9.5,69,45,FALSE,1,0,DOME,11.5,24
2011,17,reg,Cincinnati Bengals,Baltimore Ravens,BAL,16,24,8,2.5,40,38,FALSE,0,0,"",5.5,2
2011,17,reg,Cleveland Browns,Pittsburgh Steelers,PIT,9,13,4,7,22,33,FALSE,0,0,"",3,11
2011,17,reg,Denver Broncos,Kansas City Chiefs,DEN,3,7,4,2,10,37.5,FALSE,0,0,"",2,27.5
2011,17,reg,Green Bay Packers,Detroit Lions,DET,45,41,4,6.5,86,42,FALSE,0,0,"",2.5,44
2011,17,reg,Houston Texans,Tennessee Titans,TEN,22,23,1,2,45,38.5,FALSE,0,0,DOME (Open Roof),1,6.5
2011,17,reg,Jacksonville Jaguars,Indianapolis Colts,JAX,19,13,6,3,32,37,FALSE,0,0,"",3,5
2011,17,reg,Miami Dolphins,New York Jets,MIA,19,17,2,2,36,39,FALSE,0,0,"",0,3
2011,17,reg,Minnesota Vikings,Chicago Bears,MIN,13,17,4,2.5,30,42,FALSE,1,0,DOME,1.5,12
2011,17,reg,New England Patriots,Buffalo Bills,NE,49,21,28,10,70,50,FALSE,0,0,"",18,20
2011,17,reg,New Orleans Saints,Carolina Panthers,NO,45,17,28,7,62,55,FALSE,1,0,DOME,21,7
2011,17,reg,New York Giants,Dallas Cowboys,NYG,31,14,17,3,45,47.5,FALSE,0,1,Rain,14,2.5
2011,17,reg,Oakland Raiders,San Diego Chargers,OAK,26,38,12,3,64,48.5,FALSE,0,0,"",9,15.5
2011,17,reg,Philadelphia Eagles,Washington Redskins,PHI,34,10,24,7,44,44.5,FALSE,0,0,"",17,0.5
2011,17,reg,St. Louis Rams,San Francisco 49ers,SF,27,34,7,12.5,61,34.5,FALSE,1,0,DOME,5.5,26.5
2011,Wildcard,post,Houston Texans,Cincinnati Bengals,HOU,31,10,21,4,41,38,FALSE,0,0,"",17,3
2011,Wildcard,post,New Orleans Saints,Detroit Lions,NO,45,28,17,10.5,73,60,FALSE,1,0,DOME,6.5,13
2011,Wildcard,post,Denver Broncos,Pittsburgh Steelers,PIT,29,23,6,7.5,52,34,FALSE,0,0,"",1.5,18
2011,Wildcard,post,New York Giants,Atlanta Falcons,NYG,24,2,22,3,26,48,FALSE,0,0,"",19,22
2011,Division,post,New England Patriots,Denver Broncos,NE,45,10,35,13.5,55,50,FALSE,0,0,"",21.5,5
2011,Division,post,San Francisco 49ers,New Orleans Saints,NO,36,32,4,3.5,68,47,FALSE,0,0,"",0.5,21
2011,Division,post,Baltimore Ravens,Houston Texans,BAL,20,13,7,8,33,37.5,FALSE,0,0,"",1,4.5
2011,Division,post,Green Bay Packers,New York Giants,GB,20,37,17,8,57,54.5,FALSE,0,0,"",9,2.5
2011,Conference,post,New England Patriots,Baltimore Ravens,NE,23,20,3,7,43,50,FALSE,0,0,"",4,7
2011,Conference,post,San Francisco 49ers,New York Giants,SF,17,20,3,2,37,41.5,FALSE,0,0,"",1,4.5
2011,Superbowl,post,New England Patriots,New York Giants,NE,17,21,4,2.5,38,53,TRUE,1,0,DOME,1.5,15
2012,1,reg,New York Giants,Dallas Cowboys,NYG,17,24,7,4,41,46,FALSE,0,0,"",3,5
2012,1,reg,Arizona Cardinals,Seattle Seahawks,SEA,20,16,4,3,36,41,FALSE,1,0,DOME,1,5
2012,1,reg,Chicago Bears,Indianapolis Colts,CHI,41,21,20,10,62,42.5,FALSE,0,0,"",10,19.5
2012,1,reg,Cleveland Browns,Philadelphia Eagles,PHI,16,17,1,9.5,33,42,FALSE,0,0,"",8.5,9
2012,1,reg,Denver Broncos,Pittsburgh Steelers,DEN,31,19,12,2,50,45.5,FALSE,0,0,"",10,4.5
2012,1,reg,Detroit Lions,St. Louis Rams,DET,27,23,4,9,50,46.5,FALSE,1,0,DOME,5,3.5
2012,1,reg,Green Bay Packers,San Francisco 49ers,GB,22,30,8,5.5,52,46.5,FALSE,0,0,"",2.5,5.5
2012,1,reg,Houston Texans,Miami Dolphins,HOU,30,10,20,13.5,40,41.5,FALSE,0,0,DOME (Open Roof),6.5,1.5
2012,1,reg,Kansas City Chiefs,Atlanta Falcons,ATL,24,40,16,2.5,64,43,FALSE,0,0,"",13.5,21
2012,1,reg,Minnesota Vikings,Jacksonville Jaguars,MIN,26,23,3,3.5,49,38,FALSE,1,0,DOME,0.5,11
2012,1,reg,New Orleans Saints,Washington Redskins,NO,32,40,8,9,72,50.5,FALSE,1,0,DOME,1,21.5
2012,1,reg,New York Jets,Buffalo Bills,NYJ,48,28,20,3,76,39,FALSE,0,0,"",17,37
2012,1,reg,Tampa Bay Buccaneers,Carolina Panthers,CAR,16,10,6,3,26,45.5,FALSE,0,1,Rain,3,19.5
2012,1,reg,Tennessee Titans,New England Patriots,NE,13,34,21,6.5,47,48,FALSE,0,0,"",14.5,1
2012,1,reg,Baltimore Ravens,Cincinnati Bengals,BAL,44,13,31,7,57,43,FALSE,0,0,"",24,14
2012,1,reg,Oakland Raiders,San Diego Chargers,OAK,14,22,8,1,36,47.5,FALSE,0,1,Fog,7,11.5
2012,2,reg,Green Bay Packers,Chicago Bears,GB,23,10,13,5.5,33,51,FALSE,0,0,"",7.5,18
2012,2,reg,Buffalo Bills,Kansas City Chiefs,BUF,35,17,18,3,52,45,FALSE,0,0,"",15,7
2012,2,reg,Carolina Panthers,New Orleans Saints,NO,35,27,8,3,62,54,FALSE,0,0,"",5,8
2012,2,reg,Cincinnati Bengals,Cleveland Browns,CIN,34,27,7,7,61,39.5,FALSE,0,0,"",0,21.5
2012,2,reg,Indianapolis Colts,Minnesota Vikings,MIN,23,20,3,3,43,45.5,FALSE,1,0,DOME,0,2.5
2012,2,reg,Jacksonville Jaguars,Houston Texans,HOU,7,27,20,7,34,40,FALSE,0,0,"",13,6
2012,2,reg,Miami Dolphins,Oakland Raiders,OAK,35,13,22,2,48,41,FALSE,0,0,"",20,7
2012,2,reg,New England Patriots,Arizona Cardinals,NE,18,20,2,13.5,38,47,FALSE,0,0,"",11.5,9
2012,2,reg,New York Giants,Tampa Bay Buccaneers,NYG,41,34,7,8,75,43.5,FALSE,0,0,"",1,31.5
2012,2,reg,Philadelphia Eagles,Baltimore Ravens,PHI,24,23,1,3,47,47,FALSE,0,0,"",2,0
2012,2,reg,Pittsburgh Steelers,New York Jets,PIT,27,10,17,4.5,37,43,FALSE,0,0,"",12.5,6
2012,2,reg,San Diego Chargers,Tennessee Titans,LAC,38,10,28,6,48,43.5,FALSE,0,0,"",22,4.5
2012,2,reg,San Francisco 49ers,Detroit Lions,SF,27,19,8,7,46,46,FALSE,0,0,"",1,0
2012,2,reg,Seattle Seahawks,Dallas Cowboys,DAL,27,7,20,3,34,43,FALSE,0,0,"",17,9
2012,2,reg,St. Louis Rams,Washington Redskins,WAS,31,28,3,3.5,59,42.5,FALSE,1,0,DOME,0.5,16.5
2012,2,reg,Atlanta Falcons,Denver Broncos,ATL,27,21,6,3,48,50.5,FALSE,1,0,DOME,3,2.5
2012,3,reg,Carolina Panthers,New York Giants,CAR,7,36,29,3,43,49,FALSE,0,0,"",26,6
2012,3,reg,Arizona Cardinals,Philadelphia Eagles,PHI,27,6,21,3,33,42,FALSE,1,0,DOME,18,9
2012,3,reg,Baltimore Ravens,New England Patriots,BAL,31,30,1,3,61,48,FALSE,0,0,"",2,13
2012,3,reg,Chicago Bears,St. Louis Rams,CHI,23,6,17,7,29,42,FALSE,0,0,"",10,13
2012,3,reg,Cleveland Browns,Buffalo Bills,BUF,14,24,10,3,38,45,FALSE,0,0,"",7,7
2012,3,reg,Dallas Cowboys,Tampa Bay Buccaneers,DAL,16,10,6,7,26,45.5,FALSE,0,0,"",1,19.5
2012,3,reg,Denver Broncos,Houston Texans,HOU,25,31,6,1.5,56,43.5,FALSE,0,0,"",4.5,12.5
2012,3,reg,Indianapolis Colts,Jacksonville Jaguars,IND,17,22,5,3,39,42,FALSE,1,0,DOME,2,3
2012,3,reg,Miami Dolphins,New York Jets,NYJ,20,23,3,3,43,40.5,FALSE,0,1,Rain | Fog,0,2.5
2012,3,reg,Minnesota Vikings,San Francisco 49ers,SF,24,13,11,7,37,42.5,FALSE,1,0,DOME,4,5.5
2012,3,reg,New Orleans Saints,Kansas City Chiefs,NO,24,27,3,8.5,51,51.5,FALSE,1,0,DOME,5.5,0.5
2012,3,reg,Oakland Raiders,Pittsburgh Steelers,PIT,34,31,3,4,65,45,FALSE,0,0,"",1,20
2012,3,reg,San Diego Chargers,Atlanta Falcons,LAC,3,27,24,3,30,47.5,FALSE,0,0,"",21,17.5
2012,3,reg,Tennessee Titans,Detroit Lions,DET,44,41,3,4,85,47,FALSE,0,0,"",1,38
2012,3,reg,Washington Redskins,Cincinnati Bengals,WAS,31,38,7,3,69,49.5,FALSE,0,0,"",4,19.5
2012,3,reg,Seattle Seahawks,Green Bay Packers,GB,14,12,2,3.5,26,45.5,FALSE,0,0,"",1.5,19.5
2012,4,reg,Baltimore Ravens,Cleveland Browns,BAL,23,16,7,11.5,39,43.5,FALSE,0,0,"",4.5,4.5
2012,4,reg,Arizona Cardinals,Miami Dolphins,ARI,24,21,3,4,45,39.5,FALSE,1,0,DOME,1,5.5
2012,4,reg,Atlanta Falcons,Carolina Panthers,ATL,30,28,2,7,58,48,FALSE,1,0,DOME,5,10
2012,4,reg,Buffalo Bills,New England Patriots,NE,28,52,24,4.5,80,48.5,FALSE,0,0,"",19.5,31.5
2012,4,reg,Denver Broncos,Oakland Raiders,DEN,37,6,31,6.5,43,47,FALSE,0,0,"",24.5,4
2012,4,reg,Detroit Lions,Minnesota Vikings,DET,13,20,7,4,33,48.5,FALSE,1,0,DOME,3,15.5
2012,4,reg,Green Bay Packers,New Orleans Saints,GB,28,27,1,7.5,55,54,FALSE,0,0,"",6.5,1
2012,4,reg,Houston Texans,Tennessee Titans,HOU,38,14,24,13.5,52,45,FALSE,0,0,DOME (Open Roof),10.5,7
2012,4,reg,Jacksonville Jaguars,Cincinnati Bengals,JAX,10,27,17,1.5,37,45.5,FALSE,0,0,"",15.5,8.5
2012,4,reg,Kansas City Chiefs,San Diego Chargers,LAC,20,37,17,2.5,57,43.5,FALSE,0,0,"",14.5,13.5
2012,4,reg,New York Jets,San Francisco 49ers,SF,0,34,34,4,34,41,FALSE,0,0,"",30,7
2012,4,reg,Philadelphia Eagles,New York Giants,PHI,19,17,2,1.5,36,46.5,FALSE,0,1,Rain,0.5,10.5
2012,4,reg,St. Louis Rams,Seattle Seahawks,SEA,19,13,6,2.5,32,39,FALSE,1,0,DOME,3.5,7
2012,4,reg,Tampa Bay Buccaneers,Washington Redskins,TB,22,24,2,2,46,45,FALSE,0,0,"",0,1
2012,4,reg,Dallas Cowboys,Chicago Bears,DAL,18,34,16,3,52,41.5,FALSE,0,0,"",13,10.5
2012,5,reg,St. Louis Rams,Arizona Cardinals,ARI,17,3,14,1.5,20,38,FALSE,1,0,DOME,12.5,18
2012,5,reg,Carolina Panthers,Seattle Seahawks,CAR,12,16,4,2,28,42,FALSE,0,0,"",2,14
2012,5,reg,Cincinnati Bengals,Miami Dolphins,CIN,13,17,4,3,30,45,FALSE,0,0,"",1,15
2012,5,reg,Indianapolis Colts,Green Bay Packers,GB,30,27,3,6.5,57,49,FALSE,1,0,DOME,3.5,8
2012,5,reg,Jacksonville Jaguars,Chicago Bears,CHI,3,41,38,6.5,44,40,FALSE,0,0,"",31.5,4
2012,5,reg,Kansas City Chiefs,Baltimore Ravens,BAL,6,9,3,6.5,15,47,FALSE,0,0,"",3.5,32
2012,5,reg,Minnesota Vikings,Tennessee Titans,MIN,30,7,23,6,37,44,FALSE,1,0,DOME,17,7
2012,5,reg,New England Patriots,Denver Broncos,NE,31,21,10,6,52,51.5,FALSE,0,0,"",4,0.5
2012,5,reg,New Orleans Saints,San Diego Chargers,NO,31,24,7,3.5,55,52.5,FALSE,1,0,DOME,3.5,2.5
2012,5,reg,New York Giants,Cleveland Browns,NYG,41,27,14,8,68,44,FALSE,0,0,"",6,24
2012,5,reg,Pittsburgh Steelers,Philadelphia Eagles,PIT,16,14,2,4,30,44,FALSE,0,1,Rain,2,14
2012,5,reg,San Francisco 49ers,Buffalo Bills,SF,45,3,42,10,48,45,FALSE,0,0,"",32,3
2012,5,reg,Washington Redskins,Atlanta Falcons,ATL,17,24,7,3,41,51,FALSE,0,0,"",4,10
2012,5,reg,New York Jets,Houston Texans,HOU,17,23,6,10,40,41,FALSE,0,0,"",4,1
2012,6,reg,Tennessee Titans,Pittsburgh Steelers,PIT,26,23,3,6.5,49,43,FALSE,0,0,"",3.5,6
2012,6,reg,Arizona Cardinals,Buffalo Bills,ARI,16,19,3,5,35,44,FALSE,1,0,DOME,2,9
2012,6,reg,Atlanta Falcons,Oakland Raiders,ATL,23,20,3,10,43,49,FALSE,1,0,DOME,7,6
2012,6,reg,Baltimore Ravens,Dallas Cowboys,BAL,31,29,2,3,60,45,FALSE,0,0,"",1,15
2012,6,reg,Cleveland Browns,Cincinnati Bengals,CIN,34,24,10,2,58,42,FALSE,0,0,"",8,16
2012,6,reg,Houston Texans,Green Bay Packers,HOU,24,42,18,4,66,46.5,FALSE,0,0,DOME (Open Roof),14,19.5
2012,6,reg,Miami Dolphins,St. Louis Rams,MIA,17,14,3,5,31,38,FALSE,0,0,"",2,7
2012,6,reg,New York Jets,Indianapolis Colts,NYJ,35,9,26,3,44,44,FALSE,0,0,"",23,0
2012,6,reg,Philadelphia Eagles,Detroit Lions,PHI,23,26,3,3.5,49,47.5,FALSE,0,0,"",0.5,1.5
2012,6,reg,San Francisco 49ers,New York Giants,SF,3,26,23,7,29,46.5,FALSE,0,0,"",16,17.5
2012,6,reg,Seattle Seahawks,New England Patriots,NE,24,23,1,4,47,42.5,FALSE,0,1,Rain,3,4.5
2012,6,reg,Tampa Bay Buccaneers,Kansas City Chiefs,TB,38,10,28,5,48,39.5,FALSE,0,0,"",23,8.5
2012,6,reg,Washington Redskins,Minnesota Vikings,MIN,38,26,12,2,64,44,FALSE,0,0,"",10,20
2012,6,reg,San Diego Chargers,Denver Broncos,PICK,24,35,11,0,59,47.5,FALSE,0,0,"",11,11.5
2012,7,reg,San Francisco 49ers,Seattle Seahawks,SF,13,6,7,7.5,19,37.5,FALSE,0,0,"",0.5,18.5
2012,7,reg,Buffalo Bills,Tennessee Titans,BUF,34,35,1,4.5,69,46.5,FALSE,0,0,"",3.5,22.5
2012,7,reg,Carolina Panthers,Dallas Cowboys,DAL,14,19,5,2.5,33,45,FALSE,0,0,"",2.5,12
2012,7,reg,Cincinnati Bengals,Pittsburgh Steelers,CIN,17,24,7,1,41,45.5,FALSE,0,0,"",6,4.5
2012,7,reg,Houston Texans,Baltimore Ravens,HOU,43,13,30,6.5,56,47.5,FALSE,0,0,DOME (Open Roof),23.5,8.5
2012,7,reg,Indianapolis Colts,Cleveland Browns,IND,17,13,4,1,30,46.5,FALSE,1,0,DOME,3,16.5
2012,7,reg,Minnesota Vikings,Arizona Cardinals,MIN,21,14,7,6.5,35,39.5,FALSE,1,0,DOME,0.5,4.5
2012,7,reg,New England Patriots,New York Jets,NE,29,26,3,10.5,55,47,FALSE,0,0,"",7.5,8
2012,7,reg,New York Giants,Washington Redskins,NYG,27,23,4,6.5,50,51.5,FALSE,0,0,"",2.5,1.5
2012,7,reg,Oakland Raiders,Jacksonville Jaguars,OAK,26,23,3,6,49,44,FALSE,0,0,"",3,5
2012,7,reg,St. Louis Rams,Green Bay Packers,GB,20,30,10,5,50,45,FALSE,1,0,DOME,5,5
2012,7,reg,Tampa Bay Buccaneers,New Orleans Saints,NO,28,35,7,1.5,63,49.5,FALSE,0,0,"",5.5,13.5
2012,7,reg,Chicago Bears,Detroit Lions,CHI,13,7,6,6.5,20,47,FALSE,0,0,"",0.5,27
2012,8,reg,Minnesota Vikings,Tampa Bay Buccaneers,MIN,17,36,19,5.5,53,43,FALSE,1,0,DOME,13.5,10
2012,8,reg,Chicago Bears,Carolina Panthers,CHI,23,22,1,7.5,45,41.5,FALSE,0,0,"",6.5,3.5
2012,8,reg,Cleveland Browns,San Diego Chargers,LAC,7,6,1,3,13,41,FALSE,0,1,Rain | Fog,2,28
2012,8,reg,Dallas Cowboys,New York Giants,NYG,24,29,5,2.5,53,48,FALSE,0,0,"",2.5,5
2012,8,reg,Denver Broncos,New Orleans Saints,DEN,34,14,20,6.5,48,55,FALSE,0,0,"",13.5,7
2012,8,reg,Detroit Lions,Seattle Seahawks,DET,28,24,4,3,52,42.5,FALSE,1,0,DOME,1,9.5
2012,8,reg,Green Bay Packers,Jacksonville Jaguars,GB,24,15,9,16,39,45.5,FALSE,0,0,"",7,6.5
2012,8,reg,Kansas City Chiefs,Oakland Raiders,KC,16,26,10,1,42,42.5,FALSE,0,0,"",9,0.5
2012,8,reg,New York Jets,Miami Dolphins,NYJ,9,30,21,1,39,39,FALSE,0,0,"",20,0
2012,8,reg,Philadelphia Eagles,Atlanta Falcons,PHI,17,30,13,3,47,43,FALSE,0,1,Rain,10,4
2012,8,reg,Pittsburgh Steelers,Washington Redskins,PIT,27,12,15,4.5,39,44,FALSE,0,1,Rain | Fog,10.5,5
2012,8,reg,St. Louis Rams,New England Patriots,NE,7,45,38,7,52,46,TRUE,0,1,Rain,31,6
2012,8,reg,Tennessee Titans,Indianapolis Colts,TEN,13,19,6,3,32,47,FALSE,0,0,"",3,15
2012,8,reg,Arizona Cardinals,San Francisco 49ers,SF,3,24,21,7,27,38.5,FALSE,1,0,DOME,14,11.5
2012,9,reg,San Diego Chargers,Kansas City Chiefs,LAC,31,13,18,7,44,41,FALSE,0,0,"",11,3
2012,9,reg,Atlanta Falcons,Dallas Cowboys,ATL,19,13,6,4.5,32,47.5,FALSE,1,0,DOME,1.5,15.5
2012,9,reg,Cincinnati Bengals,Denver Broncos,DEN,23,31,8,5.5,54,47.5,FALSE,0,0,"",2.5,6.5
2012,9,reg,Cleveland Browns,Baltimore Ravens,BAL,15,25,10,3.5,40,44,FALSE,0,0,"",6.5,4
2012,9,reg,Green Bay Packers,Arizona Cardinals,GB,31,17,14,10.5,48,43.5,FALSE,0,0,"",3.5,4.5
2012,9,reg,Houston Texans,Buffalo Bills,HOU,21,9,12,11.5,30,48,FALSE,0,0,DOME (Open Roof),0.5,18
2012,9,reg,Indianapolis Colts,Miami Dolphins,MIA,23,20,3,2,43,43.5,FALSE,1,0,DOME,1,0.5
2012,9,reg,Jacksonville Jaguars,Detroit Lions,DET,14,31,17,6,45,44,FALSE,0,0,"",11,1
2012,9,reg,New York Giants,Pittsburgh Steelers,NYG,20,24,4,3.5,44,47.5,FALSE,0,0,"",0.5,3.5
2012,9,reg,Oakland Raiders,Tampa Bay Buccaneers,OAK,32,42,10,1,74,47.5,FALSE,0,0,"",9,26.5
2012,9,reg,Seattle Seahawks,Minnesota Vikings,SEA,30,20,10,4,50,38.5,FALSE,0,0,"",6,11.5
2012,9,reg,Tennessee Titans,Chicago Bears,CHI,20,51,31,5,71,43.5,FALSE,0,0,"",26,27.5
2012,9,reg,Washington Redskins,Carolina Panthers,WAS,13,21,8,3,34,48.5,FALSE,0,0,"",5,14.5
2012,9,reg,New Orleans Saints,Philadelphia Eagles,NO,28,13,15,3,41,52,FALSE,1,0,DOME,12,11
2012,10,reg,Jacksonville Jaguars,Indianapolis Colts,IND,10,27,17,3.5,37,43.5,FALSE,0,0,"",13.5,6.5
2012,10,reg,Baltimore Ravens,Oakland Raiders,BAL,55,20,35,7.5,75,47.5,FALSE,0,0,"",27.5,27.5
2012,10,reg,Carolina Panthers,Denver Broncos,DEN,14,36,22,4,50,47,FALSE,0,0,"",18,3
2012,10,reg,Chicago Bears,Houston Texans,CHI,6,13,7,1,19,40,FALSE,0,1,Fog,6,21
2012,10,reg,Cincinnati Bengals,New York Giants,NYG,31,13,18,4.5,44,47.5,FALSE,0,0,"",13.5,3.5
2012,10,reg,Miami Dolphins,Tennessee Titans,MIA,3,37,34,7,40,44,FALSE,0,0,"",27,4
2012,10,reg,Minnesota Vikings,Detroit Lions,DET,34,24,10,3,58,45.5,FALSE,1,0,DOME,7,12.5
2012,10,reg,New England Patriots,Buffalo Bills,NE,37,31,6,13.5,68,54,FALSE,0,0,"",7.5,14
2012,10,reg,New Orleans Saints,Atlanta Falcons,ATL,31,27,4,1.5,58,54,FALSE,1,0,DOME,2.5,4
2012,10,reg,Philadelphia Eagles,Dallas Cowboys,DAL,23,38,15,2.5,61,44.5,FALSE,0,0,"",12.5,16.5
2012,10,reg,San Francisco 49ers,St. Louis Rams,SF,24,24,0,13,48,38,FALSE,0,0,"",13,10
2012,10,reg,Seattle Seahawks,New York Jets,SEA,28,7,21,5.5,35,38.5,FALSE,0,0,"",15.5,3.5
2012,10,reg,Tampa Bay Buccaneers,San Diego Chargers,TB,34,24,10,3,58,47,FALSE,0,0,"",7,11
2012,10,reg,Pittsburgh Steelers,Kansas City Chiefs,PIT,16,13,3,13,29,40,FALSE,0,1,Rain | Fog,10,11
2012,11,reg,Buffalo Bills,Miami Dolphins,BUF,19,14,5,2.5,33,46,FALSE,0,0,"",2.5,13
2012,11,reg,Atlanta Falcons,Arizona Cardinals,ATL,23,19,4,9.5,42,44,FALSE,1,0,DOME,5.5,2
2012,11,reg,Carolina Panthers,Tampa Bay Buccaneers,TB,21,27,6,1.5,48,47,FALSE,0,0,"",4.5,1
2012,11,reg,Dallas Cowboys,Cleveland Browns,DAL,23,20,3,7,43,43.5,FALSE,0,0,"",4,0.5
2012,11,reg,Denver Broncos,San Diego Chargers,DEN,30,23,7,7.5,53,48,FALSE,0,0,"",0.5,5
2012,11,reg,Detroit Lions,Green Bay Packers,GB,20,24,4,3,44,53.5,FALSE,1,0,DOME,1,9.5
2012,11,reg,Houston Texans,Jacksonville Jaguars,HOU,43,37,6,15.5,80,40.5,FALSE,0,0,DOME (Open Roof),9.5,39.5
2012,11,reg,Kansas City Chiefs,Cincinnati Bengals,CIN,6,28,22,3,34,42.5,FALSE,0,0,"",19,8.5
2012,11,reg,New England Patriots,Indianapolis Colts,NE,59,24,35,10,83,55,FALSE,0,0,"",25,28
2012,11,reg,Oakland Raiders,New Orleans Saints,NO,17,38,21,6.5,55,56,FALSE,0,0,"",14.5,1
2012,11,reg,Pittsburgh Steelers,Baltimore Ravens,BAL,10,13,3,3,23,40.5,FALSE,0,0,"",0,17.5
2012,11,reg,St. Louis Rams,New York Jets,LAR,13,27,14,3.5,40,38.5,FALSE,1,0,DOME,10.5,1.5
2012,11,reg,Washington Redskins,Philadelphia Eagles,WAS,31,6,25,3.5,37,46,FALSE,0,0,"",21.5,9
2012,11,reg,San Francisco 49ers,Chicago Bears,SF,32,7,25,5,39,35,FALSE,0,0,"",20,4
2012,12,reg,Dallas Cowboys,Washington Redskins,DAL,31,38,7,3.5,69,47.5,FALSE,0,0,"",3.5,21.5
2012,12,reg,Detroit Lions,Houston Texans,HOU,31,34,3,4,65,49,FALSE,1,0,DOME,1,16
2012,12,reg,New York Jets,New England Patriots,NE,19,49,30,7,68,48.5,FALSE,0,0,"",23,19.5
2012,12,reg,Arizona Cardinals,St. Louis Rams,ARI,17,31,14,1,48,36.5,FALSE,1,0,DOME,13,11.5
2012,12,reg,Chicago Bears,Minnesota Vikings,CHI,28,10,18,6.5,38,39,FALSE,0,0,"",11.5,1
2012,12,reg,Cincinnati Bengals,Oakland Raiders,CIN,34,10,24,8,44,51,FALSE,0,0,"",16,7
2012,12,reg,Cleveland Browns,Pittsburgh Steelers,PIT,20,14,6,2,34,33.5,FALSE,0,0,"",4,0.5
2012,12,reg,Indianapolis Colts,Buffalo Bills,IND,20,13,7,3,33,51.5,FALSE,1,0,DOME,4,18.5
2012,12,reg,Jacksonville Jaguars,Tennessee Titans,TEN,24,19,5,3.5,43,45,FALSE,0,0,"",1.5,2
2012,12,reg,Kansas City Chiefs,Denver Broncos,DEN,9,17,8,10.5,26,42.5,FALSE,0,0,"",2.5,16.5
2012,12,reg,Miami Dolphins,Seattle Seahawks,SEA,24,21,3,3,45,38,FALSE,0,0,"",0,7
2012,12,reg,New Orleans Saints,San Francisco 49ers,SF,21,31,10,1.5,52,50,FALSE,1,0,DOME,8.5,2
2012,12,reg,New York Giants,Green Bay Packers,NYG,38,10,28,2.5,48,51.5,FALSE,0,0,"",25.5,3.5
2012,12,reg,San Diego Chargers,Baltimore Ravens,BAL,13,16,3,1,29,47,FALSE,0,1,Fog,2,18
2012,12,reg,Tampa Bay Buccaneers,Atlanta Falcons,ATL,23,24,1,1.5,47,51.5,FALSE,0,0,"",0.5,4.5
2012,12,reg,Philadelphia Eagles,Carolina Panthers,CAR,22,30,8,3,52,42,FALSE,0,0,"",5,10
2012,13,reg,Atlanta Falcons,New Orleans Saints,ATL,23,13,10,3.5,36,55,FALSE,1,0,DOME,6.5,19
2012,13,reg,Baltimore Ravens,Pittsburgh Steelers,BAL,20,23,3,7.5,43,36.5,FALSE,0,0,"",4.5,6.5
2012,13,reg,Buffalo Bills,Jacksonville Jaguars,BUF,34,18,16,6,52,42,FALSE,0,1,Rain | Fog,10,10
2012,13,reg,Chicago Bears,Seattle Seahawks,CHI,17,23,6,3.5,40,37,FALSE,0,0,"",2.5,3
2012,13,reg,Dallas Cowboys,Philadelphia Eagles,DAL,38,33,5,10.5,71,44,FALSE,0,0,"",5.5,27
2012,13,reg,Denver Broncos,Tampa Bay Buccaneers,DEN,31,23,8,7.5,54,50,FALSE,0,0,"",0.5,4
2012,13,reg,Detroit Lions,Indianapolis Colts,DET,33,35,2,7,68,51,FALSE,1,0,DOME,5,17
2012,13,reg,Green Bay Packers,Minnesota Vikings,GB,23,14,9,7.5,37,47,FALSE,0,0,"",1.5,10
2012,13,reg,Kansas City Chiefs,Carolina Panthers,CAR,27,21,6,6,48,41,FALSE,0,0,"",0,7
2012,13,reg,Miami Dolphins,New England Patriots,NE,16,23,7,9,39,51.5,FALSE,0,0,"",2,12.5
2012,13,reg,New York Jets,Arizona Cardinals,NYJ,7,6,1,6,13,36.5,FALSE,0,1,Fog,5,23.5
2012,13,reg,Oakland Raiders,Cleveland Browns,CLE,17,20,3,2.5,37,39.5,FALSE,0,0,"",0.5,2.5
2012,13,reg,San Diego Chargers,Cincinnati Bengals,CIN,13,20,7,2.5,33,46,FALSE,0,1,Fog,4.5,13
2012,13,reg,St. Louis Rams,San Francisco 49ers,SF,16,13,3,8,29,41,FALSE,1,0,DOME,5,12
2012,13,reg,Tennessee Titans,Houston Texans,HOU,10,24,14,7,34,47,FALSE,0,0,"",7,13
2012,13,reg,Washington Redskins,New York Giants,NYG,17,16,1,3,33,50,FALSE,0,0,"",2,17
2012,14,reg,Oakland Raiders,Denver Broncos,DEN,13,26,13,10.5,39,47,FALSE,0,0,"",2.5,8
2012,14,reg,Buffalo Bills,St. Louis Rams,BUF,12,15,3,3,27,42.5,FALSE,0,0,"",0,15.5
2012,14,reg,Carolina Panthers,Atlanta Falcons,ATL,30,20,10,3.5,50,47,FALSE,0,1,Fog,6.5,3
2012,14,reg,Cincinnati Bengals,Dallas Cowboys,CIN,19,20,1,3.5,39,46,FALSE,0,0,"",2.5,7
2012,14,reg,Cleveland Browns,Kansas City Chiefs,CLE,30,7,23,7,37,38,FALSE,0,0,"",16,1
2012,14,reg,Green Bay Packers,Detroit Lions,GB,27,20,7,6.5,47,49,FALSE,0,0,Snow | Fog,0.5,2
2012,14,reg,Indianapolis Colts,Tennessee Titans,IND,27,23,4,4,50,47,FALSE,1,0,DOME,0,3
2012,14,reg,Jacksonville Jaguars,New York Jets,NYJ,10,17,7,3,27,39,FALSE,0,1,Fog,4,12
2012,14,reg,Minnesota Vikings,Chicago Bears,CHI,21,14,7,1.5,35,40.5,FALSE,1,0,DOME,5.5,5.5
2012,14,reg,New York Giants,New Orleans Saints,NYG,52,27,25,4.5,79,51.5,FALSE,0,1,Rain,20.5,27.5
2012,14,reg,Pittsburgh Steelers,San Diego Chargers,PIT,24,34,10,7.5,58,38,FALSE,0,0,"",2.5,20
2012,14,reg,San Francisco 49ers,Miami Dolphins,SF,27,13,14,10.5,40,38.5,FALSE,0,0,"",3.5,1.5
2012,14,reg,Seattle Seahawks,Arizona Cardinals,SEA,58,0,58,10,58,36,FALSE,0,1,Rain | Fog,48,22
2012,14,reg,Tampa Bay Buccaneers,Philadelphia Eagles,TB,21,23,2,7,44,48,FALSE,0,0,"",5,4
2012,14,reg,Washington Redskins,Baltimore Ravens,WAS,31,28,3,1.5,59,48,FALSE,0,0,"",1.5,11
2012,14,reg,New England Patriots,Houston Texans,NE,42,14,28,5.5,56,51,FALSE,0,0,"",22.5,5
2012,15,reg,Philadelphia Eagles,Cincinnati Bengals,CIN,13,34,21,5,47,45,FALSE,0,0,"",16,2
2012,15,reg,Arizona Cardinals,Detroit Lions,DET,38,10,28,6.5,48,43.5,FALSE,1,0,DOME,21.5,4.5
2012,15,reg,Atlanta Falcons,New York Giants,PICK,34,0,34,0,34,50,FALSE,1,0,DOME,34,16
2012,15,reg,Baltimore Ravens,Denver Broncos,DEN,17,34,17,3,51,48,FALSE,0,1,Rain,14,3
2012,15,reg,Buffalo Bills,Seattle Seahawks,SEA,17,50,33,5,67,44,TRUE,1,0,DOME,28,23
2012,15,reg,Chicago Bears,Green Bay Packers,GB,13,21,8,3,34,43.5,FALSE,0,0,"",5,9.5
2012,15,reg,Cleveland Browns,Washington Redskins,CLE,21,38,17,4,59,40.5,FALSE,0,0,"",13,18.5
2012,15,reg,Dallas Cowboys,Pittsburgh Steelers,PIT,27,24,3,2.5,51,46,FALSE,0,0,"",0.5,5
2012,15,reg,Houston Texans,Indianapolis Colts,HOU,29,17,12,10.5,46,48,FALSE,0,0,DOME (Open Roof),1.5,2
2012,15,reg,Miami Dolphins,Jacksonville Jaguars,MIA,24,3,21,7.5,27,38,FALSE,0,0,"",13.5,11
2012,15,reg,New England Patriots,San Francisco 49ers,NE,34,41,7,5,75,47.5,FALSE,0,1,Fog,2,27.5
2012,15,reg,New Orleans Saints,Tampa Bay Buccaneers,NO,41,0,41,3.5,41,55,FALSE,1,0,DOME,37.5,14
2012,15,reg,Oakland Raiders,Kansas City Chiefs,OAK,15,0,15,4.5,15,44,FALSE,0,0,"",10.5,29
2012,15,reg,San Diego Chargers,Carolina Panthers,LAC,7,31,24,3,38,45.5,FALSE,0,0,"",21,7.5
2012,15,reg,St. Louis Rams,Minnesota Vikings,LAR,22,36,14,2.5,58,39.5,FALSE,1,0,DOME,11.5,18.5
2012,15,reg,Tennessee Titans,New York Jets,TEN,14,10,4,1,24,42,FALSE,0,0,"",3,18
2012,16,reg,Detroit Lions,Atlanta Falcons,ATL,18,31,13,4,49,50.5,FALSE,1,0,DOME,9,1.5
2012,16,reg,Arizona Cardinals,Chicago Bears,CHI,13,28,15,7,41,36.5,FALSE,1,0,DOME,8,4.5
2012,16,reg,Baltimore Ravens,New York Giants,NYG,33,14,19,2.5,47,47,FALSE,0,0,"",16.5,0
2012,16,reg,Carolina Panthers,Oakland Raiders,CAR,17,6,11,9.5,23,47,FALSE,0,0,"",1.5,24
2012,16,reg,Dallas Cowboys,New Orleans Saints,DAL,31,34,3,3,65,54.5,FALSE,0,0,"",0,10.5
2012,16,reg,Denver Broncos,Cleveland Browns,DEN,34,12,22,11,46,44,FALSE,0,0,"",11,2
2012,16,reg,Green Bay Packers,Tennessee Titans,GB,55,7,48,11,62,44.5,FALSE,0,0,"",37,17.5
2012,16,reg,Houston Texans,Minnesota Vikings,HOU,6,23,17,7.5,29,43.5,FALSE,0,0,DOME (Open Roof),9.5,14.5
2012,16,reg,Jacksonville Jaguars,New England Patriots,NE,16,23,7,14.5,39,51,FALSE,0,0,"",7.5,12
2012,16,reg,Kansas City Chiefs,Indianapolis Colts,IND,13,20,7,6,33,41.5,FALSE,0,0,"",1,8.5
2012,16,reg,Miami Dolphins,Buffalo Bills,MIA,24,10,14,5,34,43,FALSE,0,0,"",9,9
2012,16,reg,New York Jets,San Diego Chargers,NYJ,17,27,10,3,44,38,FALSE,0,0,"",7,6
2012,16,reg,Philadelphia Eagles,Washington Redskins,WAS,20,27,7,6,47,46,FALSE,0,0,"",1,1
2012,16,reg,Pittsburgh Steelers,Cincinnati Bengals,PIT,10,13,3,3.5,23,40,FALSE,0,0,"",0.5,17
2012,16,reg,Seattle Seahawks,San Francisco 49ers,SEA,42,13,29,2,55,40.5,FALSE,0,1,Rain,27,14.5
2012,16,reg,Tampa Bay Buccaneers,St. Louis Rams,TB,13,28,15,3,41,44,FALSE,0,0,"",12,3
2012,17,reg,Atlanta Falcons,Tampa Bay Buccaneers,ATL,17,22,5,3,39,46,FALSE,1,0,DOME,2,7
2012,17,reg,Buffalo Bills,New York Jets,BUF,28,9,19,3.5,37,41,FALSE,0,0,"",15.5,4
2012,17,reg,Cincinnati Bengals,Baltimore Ravens,CIN,23,17,6,3,40,42.5,FALSE,0,0,"",3,2.5
2012,17,reg,Denver Broncos,Kansas City Chiefs,DEN,38,3,35,17,41,41.5,FALSE,0,0,"",18,0.5
2012,17,reg,Detroit Lions,Chicago Bears,CHI,24,26,2,3,50,46,FALSE,1,0,DOME,1,4
2012,17,reg,Indianapolis Colts,Houston Texans,HOU,28,16,12,6,44,47,FALSE,1,0,DOME,6,3
2012,17,reg,Minnesota Vikings,Green Bay Packers,GB,37,34,3,3,71,46,FALSE,1,0,DOME,0,25
2012,17,reg,New England Patriots,Miami Dolphins,NE,28,0,28,10,28,46.5,FALSE,0,0,"",18,18.5
2012,17,reg,New Orleans Saints,Carolina Panthers,NO,38,44,6,4,82,54,FALSE,1,0,DOME,2,28
2012,17,reg,New York Giants,Philadelphia Eagles,NYG,42,7,35,6.5,49,44.5,FALSE,0,1,Snow,28.5,4.5
2012,17,reg,Pittsburgh Steelers,Cleveland Browns,PIT,24,10,14,9.5,34,36,FALSE,0,0,"",4.5,2
2012,17,reg,San Diego Chargers,Oakland Raiders,LAC,24,21,3,8,45,41.5,FALSE,0,0,"",5,3.5
2012,17,reg,San Francisco 49ers,Arizona Cardinals,SF,27,13,14,16.5,40,39.5,FALSE,0,0,"",2.5,0.5
2012,17,reg,Seattle Seahawks,St. Louis Rams,SEA,20,13,7,12,33,42.5,FALSE,0,0,"",5,9.5
2012,17,reg,Tennessee Titans,Jacksonville Jaguars,TEN,38,20,18,5.5,58,42,FALSE,0,0,"",12.5,16
2012,17,reg,Washington Redskins,Dallas Cowboys,WAS,28,18,10,3,46,49,FALSE,0,0,"",7,3
2012,Wildcard,post,Green Bay Packers,Minnesota Vikings,GB,24,10,14,11,34,44.5,FALSE,0,0,"",3,10.5
2012,Wildcard,post,Houston Texans,Cincinnati Bengals,HOU,19,13,6,4,32,42.5,FALSE,0,0,"",2,10.5
2012,Wildcard,post,Baltimore Ravens,Indianapolis Colts,BAL,24,9,15,7,33,47,FALSE,0,0,"",8,14
2012,Wildcard,post,Washington Redskins,Seattle Seahawks,SEA,14,24,10,3,38,45,FALSE,0,0,"",7,7
2012,Division,post,Denver Broncos,Baltimore Ravens,DEN,35,38,3,9,73,44.5,FALSE,0,0,"",6,28.5
2012,Division,post,San Francisco 49ers,Green Bay Packers,SF,45,31,14,3,76,45.5,FALSE,0,0,"",11,30.5
2012,Division,post,Atlanta Falcons,Seattle Seahawks,ATL,30,28,2,3,58,47,FALSE,1,0,DOME,1,11
2012,Division,post,New England Patriots,Houston Texans,NE,41,28,13,9.5,69,51,FALSE,0,0,"",3.5,18
2012,Conference,post,Atlanta Falcons,San Francisco 49ers,SF,24,28,4,4.5,52,49,FALSE,1,0,DOME,0.5,3
2012,Conference,post,New England Patriots,Baltimore Ravens,NE,13,28,15,7.5,41,51.5,FALSE,0,0,"",7.5,10.5
2012,Superbowl,post,San Francisco 49ers,Baltimore Ravens,SF,31,34,3,4.5,65,48,TRUE,1,0,DOME,1.5,17
2013,1,reg,Denver Broncos,Baltimore Ravens,DEN,49,27,22,7.5,76,49.5,FALSE,0,0,"",14.5,26.5
2013,1,reg,Buffalo Bills,New England Patriots,NE,21,23,2,10.5,44,51.5,FALSE,0,0,"",8.5,7.5
2013,1,reg,Carolina Panthers,Seattle Seahawks,SEA,7,12,5,3.5,19,45,FALSE,0,0,"",1.5,26
2013,1,reg,Chicago Bears,Cincinnati Bengals,CHI,24,21,3,3,45,42,FALSE,0,0,"",0,3
2013,1,reg,Cleveland Browns,Miami Dolphins,CLE,10,23,13,2.5,33,40.5,FALSE,0,0,"",10.5,7.5
2013,1,reg,Dallas Cowboys,New York Giants,DAL,36,31,5,3.5,67,50,FALSE,1,0,DOME,1.5,17
2013,1,reg,Detroit Lions,Minnesota Vikings,DET,34,24,10,4.5,58,47.5,FALSE,1,0,DOME,5.5,10.5
2013,1,reg,Indianapolis Colts,Oakland Raiders,IND,21,17,4,11.5,38,45.5,FALSE,1,0,DOME,7.5,7.5
2013,1,reg,Jacksonville Jaguars,Kansas City Chiefs,KC,2,28,26,4.5,30,43,FALSE,0,0,"",21.5,13
2013,1,reg,New Orleans Saints,Atlanta Falcons,NO,23,17,6,3.5,40,56,FALSE,1,0,DOME,2.5,16
2013,1,reg,New York Jets,Tampa Bay Buccaneers,TB,18,17,1,6,35,39,FALSE,0,0,"",5,4
2013,1,reg,Pittsburgh Steelers,Tennessee Titans,PIT,9,16,7,6,25,42,FALSE,0,0,"",1,17
2013,1,reg,San Francisco 49ers,Green Bay Packers,SF,34,28,6,5,62,48.5,FALSE,0,0,"",1,13.5
2013,1,reg,St. Louis Rams,Arizona Cardinals,LAR,27,24,3,3.5,51,41.5,FALSE,1,0,DOME,0.5,9.5
2013,1,reg,San Diego Chargers,Houston Texans,HOU,28,31,3,6.5,59,45.5,FALSE,0,0,"",3.5,13.5
2013,1,reg,Washington Redskins,Philadelphia Eagles,WAS,27,33,6,4.5,60,53.5,FALSE,0,0,"",1.5,6.5
2013,2,reg,New England Patriots,New York Jets,NE,13,10,3,11.5,23,43.5,FALSE,0,1,Rain | Fog,8.5,20.5
2013,2,reg,Arizona Cardinals,Detroit Lions,DET,25,21,4,2,46,48.5,FALSE,1,0,DOME,2,2.5
2013,2,reg,Atlanta Falcons,St. Louis Rams,ATL,31,24,7,5.5,55,47.5,FALSE,1,0,DOME,1.5,7.5
2013,2,reg,Baltimore Ravens,Cleveland Browns,BAL,14,6,8,7,20,44,FALSE,0,0,"",1,24
2013,2,reg,Buffalo Bills,Carolina Panthers,CAR,24,23,1,3.5,47,43.5,FALSE,0,0,"",2.5,3.5
2013,2,reg,Chicago Bears,Minnesota Vikings,CHI,31,30,1,6.5,61,42,FALSE,0,1,Rain,5.5,19
2013,2,reg,Green Bay Packers,Washington Redskins,GB,38,20,18,8,58,50,FALSE,0,0,"",10,8
2013,2,reg,Houston Texans,Tennessee Titans,HOU,30,24,6,9,54,43,FALSE,0,0,DOME (Open Roof),3,11
2013,2,reg,Indianapolis Colts,Miami Dolphins,IND,20,24,4,3,44,44,FALSE,1,0,DOME,1,0
2013,2,reg,Kansas City Chiefs,Dallas Cowboys,KC,17,16,1,3,33,46,FALSE,0,0,"",2,13
2013,2,reg,New York Giants,Denver Broncos,DEN,23,41,18,4,64,55.5,FALSE,0,0,"",14,8.5
2013,2,reg,Oakland Raiders,Jacksonville Jaguars,OAK,19,9,10,5,28,40,FALSE,0,0,"",5,12
2013,2,reg,Philadelphia Eagles,San Diego Chargers,PHI,30,33,3,7.5,63,54,FALSE,0,0,"",4.5,9
2013,2,reg,Seattle Seahawks,San Francisco 49ers,SEA,29,3,26,2.5,32,44.5,FALSE,0,1,Rain,23.5,12.5
2013,2,reg,Tampa Bay Buccaneers,New Orleans Saints,NO,14,16,2,4,30,48.5,FALSE,0,0,"",2,18.5
2013,2,reg,Cincinnati Bengals,Pittsburgh Steelers,CIN,20,10,10,6.5,30,41,FALSE,0,0,"",3.5,11
2013,3,reg,Philadelphia Eagles,Kansas City Chiefs,PHI,16,26,10,3.5,42,51,FALSE,0,0,"",6.5,9
2013,3,reg,Baltimore Ravens,Houston Texans,HOU,30,9,21,1,39,44.5,FALSE,0,0,"",20,5.5
2013,3,reg,Carolina Panthers,New York Giants,NYG,38,0,38,3,38,47,FALSE,0,0,"",35,9
2013,3,reg,Cincinnati Bengals,Green Bay Packers,GB,34,30,4,3,64,50.5,FALSE,0,0,"",1,13.5
2013,3,reg,Dallas Cowboys,St. Louis Rams,DAL,31,7,24,3.5,38,47,FALSE,1,0,DOME,20.5,9
2013,3,reg,Miami Dolphins,Atlanta Falcons,MIA,27,23,4,2.5,50,46,FALSE,0,0,"",1.5,4
2013,3,reg,Minnesota Vikings,Cleveland Browns,MIN,27,31,4,7,58,40.5,FALSE,1,0,DOME,3,17.5
2013,3,reg,New England Patriots,Tampa Bay Buccaneers,NE,23,3,20,7.5,26,45,FALSE,0,0,"",12.5,19
2013,3,reg,New Orleans Saints,Arizona Cardinals,NO,31,7,24,7.5,38,49.5,FALSE,1,0,DOME,16.5,11.5
2013,3,reg,New York Jets,Buffalo Bills,NYJ,27,20,7,2.5,47,41,FALSE,0,0,"",4.5,6
2013,3,reg,Pittsburgh Steelers,Chicago Bears,CHI,23,40,17,2.5,63,41,FALSE,0,0,"",14.5,22
2013,3,reg,San Francisco 49ers,Indianapolis Colts,SF,7,27,20,10,34,47,FALSE,0,0,"",10,13
2013,3,reg,Seattle Seahawks,Jacksonville Jaguars,SEA,45,17,28,20,62,39.5,FALSE,0,0,"",8,22.5
2013,3,reg,Tennessee Titans,San Diego Chargers,TEN,20,17,3,3,37,43.5,FALSE,0,0,"",0,6.5
2013,3,reg,Washington Redskins,Detroit Lions,DET,20,27,7,1,47,49.5,FALSE,0,0,"",6,2.5
2013,3,reg,Denver Broncos,Oakland Raiders,DEN,37,21,16,16.5,58,50,FALSE,0,0,"",0.5,8
2013,4,reg,St. Louis Rams,San Francisco 49ers,SF,11,35,24,4,46,43.5,FALSE,1,0,DOME,20,2.5
2013,4,reg,Atlanta Falcons,New England Patriots,ATL,23,30,7,3,53,50,FALSE,1,0,DOME,4,3
2013,4,reg,Buffalo Bills,Baltimore Ravens,BAL,23,20,3,4,43,45,FALSE,0,0,"",1,2
2013,4,reg,Cleveland Browns,Cincinnati Bengals,CIN,17,6,11,4.5,23,42.5,FALSE,0,0,"",6.5,19.5
2013,4,reg,Denver Broncos,Philadelphia Eagles,DEN,52,20,32,11.5,72,59,FALSE,0,0,"",20.5,13
2013,4,reg,Detroit Lions,Chicago Bears,DET,40,32,8,2.5,72,49.5,FALSE,1,0,DOME,5.5,22.5
2013,4,reg,Houston Texans,Seattle Seahawks,SEA,20,23,3,2,43,41,FALSE,0,0,DOME (Open Roof),1,2
2013,4,reg,Jacksonville Jaguars,Indianapolis Colts,IND,3,37,34,9.5,40,42.5,FALSE,0,0,"",24.5,2.5
2013,4,reg,Kansas City Chiefs,New York Giants,KC,31,7,24,4.5,38,44,FALSE,0,0,"",19.5,6
2013,4,reg,Minnesota Vikings,Pittsburgh Steelers,PIT,34,27,7,3,61,41.5,TRUE,0,0,"",4,19.5
2013,4,reg,Oakland Raiders,Washington Redskins,WAS,14,24,10,4,38,46,FALSE,0,0,"",6,8
2013,4,reg,San Diego Chargers,Dallas Cowboys,DAL,30,21,9,1.5,51,48,FALSE,0,0,"",7.5,3
2013,4,reg,Tampa Bay Buccaneers,Arizona Cardinals,TB,10,13,3,2.5,23,40,FALSE,0,0,"",0.5,17
2013,4,reg,Tennessee Titans,New York Jets,TEN,38,13,25,3.5,51,40.5,FALSE,0,1,Rain,21.5,10.5
2013,4,reg,New Orleans Saints,Miami Dolphins,NO,38,17,21,7.5,55,49,FALSE,1,0,DOME,13.5,6
2013,5,reg,Cleveland Browns,Buffalo Bills,CLE,37,24,13,4,61,41,FALSE,0,1,Rain,9,20
2013,5,reg,Arizona Cardinals,Carolina Panthers,CAR,22,6,16,3,28,42.5,FALSE,1,0,DOME,13,14.5
2013,5,reg,Chicago Bears,New Orleans Saints,NO,18,26,8,1.5,44,51.5,FALSE,0,0,"",6.5,7.5
2013,5,reg,Cincinnati Bengals,New England Patriots,NE,13,6,7,1,19,45.5,FALSE,0,0,"",6,26.5
2013,5,reg,Dallas Cowboys,Denver Broncos,DEN,48,51,3,9,99,57.5,FALSE,1,0,DOME,6,41.5
2013,5,reg,Green Bay Packers,Detroit Lions,GB,22,9,13,9.5,31,55,FALSE,0,0,"",3.5,24
2013,5,reg,Indianapolis Colts,Seattle Seahawks,SEA,34,28,6,3,62,44,FALSE,1,0,DOME,3,18
2013,5,reg,Miami Dolphins,Baltimore Ravens,MIA,23,26,3,2.5,49,43,FALSE,0,0,"",0.5,6
2013,5,reg,New York Giants,Philadelphia Eagles,NYG,21,36,15,1.5,57,54,FALSE,0,1,Fog,13.5,3
2013,5,reg,Oakland Raiders,San Diego Chargers,LAC,27,17,10,5,44,47,FALSE,0,0,"",5,3
2013,5,reg,San Francisco 49ers,Houston Texans,SF,34,3,31,4.5,37,44,FALSE,0,0,"",26.5,7
2013,5,reg,St. Louis Rams,Jacksonville Jaguars,LAR,34,20,14,11,54,41,FALSE,1,0,DOME,3,13
2013,5,reg,Tennessee Titans,Kansas City Chiefs,KC,17,26,9,3,43,38.5,FALSE,0,1,Rain,6,4.5
2013,5,reg,Atlanta Falcons,New York Jets,ATL,28,30,2,10.5,58,45,FALSE,1,0,DOME,8.5,13
2013,6,reg,Chicago Bears,New York Giants,CHI,27,21,6,8.5,48,48,FALSE,0,0,"",2.5,0
2013,6,reg,Baltimore Ravens,Green Bay Packers,GB,17,19,2,2,36,48,FALSE,0,1,Rain,0,12
2013,6,reg,Buffalo Bills,Cincinnati Bengals,CIN,24,27,3,6,51,41,FALSE,0,0,"",3,10
2013,6,reg,Cleveland Browns,Detroit Lions,DET,17,31,14,2.5,48,43.5,FALSE,0,0,"",11.5,4.5
2013,6,reg,Dallas Cowboys,Washington Redskins,DAL,31,16,15,5.5,47,51.5,FALSE,1,0,DOME,9.5,4.5
2013,6,reg,Denver Broncos,Jacksonville Jaguars,DEN,35,19,16,26.5,54,52,FALSE,0,0,"",10.5,2
2013,6,reg,Houston Texans,St. Louis Rams,HOU,13,38,25,9,51,42.5,FALSE,0,0,DOME (Open Roof),16,8.5
2013,6,reg,Kansas City Chiefs,Oakland Raiders,KC,24,7,17,7.5,31,41.5,FALSE,0,0,"",9.5,10.5
2013,6,reg,Minnesota Vikings,Carolina Panthers,MIN,10,35,25,2.5,45,44.5,FALSE,1,0,DOME,22.5,0.5
2013,6,reg,New England Patriots,New Orleans Saints,NE,30,27,3,2.5,57,50,FALSE,0,0,"",0.5,7
2013,6,reg,New York Jets,Pittsburgh Steelers,PIT,6,19,13,1.5,25,41,FALSE,0,0,"",11.5,16
2013,6,reg,San Francisco 49ers,Arizona Cardinals,SF,32,20,12,10.5,52,41,FALSE,0,0,"",1.5,11
2013,6,reg,Seattle Seahawks,Tennessee Titans,SEA,20,13,7,11.5,33,41.5,FALSE,0,0,"",4.5,8.5
2013,6,reg,Tampa Bay Buccaneers,Philadelphia Eagles,PHI,20,31,11,3,51,44,FALSE,0,0,"",8,7
2013,6,reg,San Diego Chargers,Indianapolis Colts,PICK,19,9,10,0,28,50.5,FALSE,0,0,"",10,22.5
2013,7,reg,Arizona Cardinals,Seattle Seahawks,SEA,22,34,12,4.5,56,41.5,FALSE,1,0,DOME,7.5,14.5
2013,7,reg,Atlanta Falcons,Tampa Bay Buccaneers,ATL,31,23,8,6.5,54,43,FALSE,1,0,DOME,1.5,11
2013,7,reg,Carolina Panthers,St. Louis Rams,CAR,30,15,15,7,45,42,FALSE,0,0,"",8,3
2013,7,reg,Detroit Lions,Cincinnati Bengals,DET,24,27,3,1.5,51,46,FALSE,1,0,DOME,1.5,5
2013,7,reg,Green Bay Packers,Cleveland Browns,GB,31,13,18,9.5,44,45,FALSE,0,0,"",8.5,1
2013,7,reg,Indianapolis Colts,Denver Broncos,DEN,39,33,6,6,72,55.5,FALSE,1,0,DOME,0,16.5
2013,7,reg,Jacksonville Jaguars,San Diego Chargers,LAC,6,24,18,7,30,44.5,FALSE,0,0,"",11,14.5
2013,7,reg,Kansas City Chiefs,Houston Texans,KC,17,16,1,6,33,39,FALSE,0,0,"",5,6
2013,7,reg,Miami Dolphins,Buffalo Bills,MIA,21,23,2,6.5,44,44.5,FALSE,0,0,"",4.5,0.5
2013,7,reg,New York Jets,New England Patriots,NE,30,27,3,3,57,43,FALSE,0,0,"",0,14
2013,7,reg,Philadelphia Eagles,Dallas Cowboys,PHI,3,17,14,2.5,20,55,FALSE,0,0,"",11.5,35
2013,7,reg,Pittsburgh Steelers,Baltimore Ravens,PIT,19,16,3,2.5,35,41,FALSE,0,0,"",0.5,6
2013,7,reg,Tennessee Titans,San Francisco 49ers,SF,17,31,14,3,48,40.5,FALSE,0,0,"",11,7.5
2013,7,reg,Washington Redskins,Chicago Bears,CHI,45,41,4,1,86,48,FALSE,0,0,"",3,38
2013,7,reg,New York Giants,Minnesota Vikings,NYG,23,7,16,3.5,30,47,FALSE,0,0,"",12.5,17
2013,8,reg,Tampa Bay Buccaneers,Carolina Panthers,CAR,13,31,18,6.5,44,38.5,FALSE,0,0,"",11.5,5.5
2013,8,reg,Arizona Cardinals,Atlanta Falcons,ARI,27,13,14,3,40,46.5,FALSE,1,0,DOME,11,6.5
2013,8,reg,Cincinnati Bengals,New York Jets,CIN,49,9,40,4.5,58,41.5,FALSE,0,0,"",35.5,16.5
2013,8,reg,Denver Broncos,Washington Redskins,DEN,45,21,24,11,66,58,FALSE,0,0,"",13,8
2013,8,reg,Detroit Lions,Dallas Cowboys,DET,31,30,1,3,61,50.5,FALSE,1,0,DOME,2,10.5
2013,8,reg,Jacksonville Jaguars,San Francisco 49ers,SF,10,42,32,14.5,52,40,TRUE,0,0,"",17.5,12
2013,8,reg,Kansas City Chiefs,Cleveland Browns,KC,23,17,6,7,40,39,FALSE,0,0,"",1,1
2013,8,reg,Minnesota Vikings,Green Bay Packers,GB,31,44,13,7.5,75,47,FALSE,1,0,DOME,5.5,28
2013,8,reg,New England Patriots,Miami Dolphins,NE,27,17,10,5.5,44,45,FALSE,0,0,"",4.5,1
2013,8,reg,New Orleans Saints,Buffalo Bills,NO,35,17,18,10.5,52,48,FALSE,1,0,DOME,7.5,4
2013,8,reg,Oakland Raiders,Pittsburgh Steelers,PIT,21,18,3,2.5,39,40.5,FALSE,0,0,"",0.5,1.5
2013,8,reg,Philadelphia Eagles,New York Giants,PHI,7,15,8,5.5,22,49.5,FALSE,0,0,"",2.5,27.5
2013,8,reg,St. Louis Rams,Seattle Seahawks,SEA,9,14,5,13,23,43.5,FALSE,1,0,DOME,8,20.5
2013,9,reg,Miami Dolphins,Cincinnati Bengals,CIN,22,20,2,3,42,42,FALSE,0,0,"",1,0
2013,9,reg,Buffalo Bills,Kansas City Chiefs,KC,13,23,10,4.5,36,41,FALSE,0,0,"",5.5,5
2013,9,reg,Carolina Panthers,Atlanta Falcons,CAR,34,10,24,8,44,47,FALSE,0,0,"",16,3
2013,9,reg,Cleveland Browns,Baltimore Ravens,BAL,24,18,6,1,42,42,FALSE,0,0,"",5,0
2013,9,reg,Dallas Cowboys,Minnesota Vikings,DAL,27,23,4,8.5,50,50.5,FALSE,1,0,DOME,4.5,0.5
2013,9,reg,Houston Texans,Indianapolis Colts,IND,24,27,3,1,51,44,FALSE,0,0,DOME (Open Roof),2,7
2013,9,reg,New England Patriots,Pittsburgh Steelers,NE,55,31,24,5.5,86,43,FALSE,0,0,"",18.5,43
2013,9,reg,New York Jets,New Orleans Saints,NO,26,20,6,5.5,46,46,FALSE,0,0,"",0.5,0
2013,9,reg,Oakland Raiders,Philadelphia Eagles,OAK,20,49,29,1,69,45.5,FALSE,0,0,"",28,23.5
2013,9,reg,Seattle Seahawks,Tampa Bay Buccaneers,SEA,27,24,3,14.5,51,40.5,FALSE,0,0,"",11.5,10.5
2013,9,reg,St. Louis Rams,Tennessee Titans,TEN,21,28,7,3,49,40.5,FALSE,1,0,DOME,4,8.5
2013,9,reg,Washington Redskins,San Diego Chargers,PICK,30,24,6,0,54,48.5,FALSE,0,0,"",6,5.5
2013,9,reg,Green Bay Packers,Chicago Bears,GB,20,27,7,9.5,47,50.5,FALSE,0,0,"",2.5,3.5
2013,10,reg,Minnesota Vikings,Washington Redskins,WAS,34,27,7,1,61,48,FALSE,1,0,DOME,6,13
2013,10,reg,Arizona Cardinals,Houston Texans,ARI,27,24,3,3.5,51,42,FALSE,1,0,DOME,0.5,9
2013,10,reg,Atlanta Falcons,Seattle Seahawks,SEA,10,33,23,3,43,47,FALSE,1,0,DOME,20,4
2013,10,reg,Baltimore Ravens,Cincinnati Bengals,BAL,20,17,3,2,37,43.5,FALSE,0,0,"",1,6.5
2013,10,reg,Chicago Bears,Detroit Lions,DET,19,21,2,1.5,40,52,FALSE,0,0,"",0.5,12
2013,10,reg,Green Bay Packers,Philadelphia Eagles,PHI,13,27,14,1,40,47,FALSE,0,0,"",13,7
2013,10,reg,Indianapolis Colts,St. Louis Rams,IND,8,38,30,7,46,43,FALSE,1,0,DOME,23,3
2013,10,reg,New Orleans Saints,Dallas Cowboys,NO,49,17,32,5.5,66,53.5,FALSE,1,0,DOME,26.5,12.5
2013,10,reg,New York Giants,Oakland Raiders,NYG,24,20,4,7,44,41,FALSE,0,1,Rain,3,3
2013,10,reg,Pittsburgh Steelers,Buffalo Bills,PIT,23,10,13,2.5,33,43,FALSE,0,0,"",10.5,10
2013,10,reg,San Diego Chargers,Denver Broncos,DEN,20,28,8,7,48,57,FALSE,0,0,"",1,9
2013,10,reg,San Francisco 49ers,Carolina Panthers,SF,9,10,1,5.5,19,42.5,FALSE,0,0,"",4.5,23.5
2013,10,reg,Tennessee Titans,Jacksonville Jaguars,TEN,27,29,2,11.5,56,42,FALSE,0,0,"",9.5,14
2013,10,reg,Tampa Bay Buccaneers,Miami Dolphins,MIA,22,19,3,2.5,41,39.5,FALSE,0,0,"",0.5,1.5
2013,11,reg,Tennessee Titans,Indianapolis Colts,IND,27,30,3,3,57,42,FALSE,0,0,"",0,15
2013,11,reg,Buffalo Bills,New York Jets,NYJ,37,14,23,2,51,39.5,FALSE,0,0,"",21,11.5
2013,11,reg,Chicago Bears,Baltimore Ravens,CHI,23,20,3,3.5,43,41,FALSE,0,0,"",0.5,2
2013,11,reg,Cincinnati Bengals,Cleveland Browns,CIN,41,20,21,4.5,61,40,FALSE,0,0,"",16.5,21
2013,11,reg,Denver Broncos,Kansas City Chiefs,DEN,27,17,10,7.5,44,49,FALSE,0,0,"",2.5,5
2013,11,reg,Houston Texans,Oakland Raiders,HOU,23,28,5,10.5,51,40.5,FALSE,0,0,DOME (Open Roof),5.5,10.5
2013,11,reg,Jacksonville Jaguars,Arizona Cardinals,ARI,14,27,13,9,41,40.5,FALSE,0,0,"",4,0.5
2013,11,reg,Miami Dolphins,San Diego Chargers,LAC,20,16,4,3,36,44.5,FALSE,0,0,"",1,8.5
2013,11,reg,New Orleans Saints,San Francisco 49ers,NO,23,20,3,3.5,43,49.5,FALSE,1,0,DOME,0.5,6.5
2013,11,reg,New York Giants,Green Bay Packers,NYG,27,13,14,3,40,40.5,FALSE,0,1,Fog,11,0.5
2013,11,reg,Philadelphia Eagles,Washington Redskins,PHI,24,16,8,4,40,54,FALSE,0,0,"",4,14
2013,11,reg,Pittsburgh Steelers,Detroit Lions,DET,37,27,10,3,64,45,FALSE,0,1,Rain,7,19
2013,11,reg,Seattle Seahawks,Minnesota Vikings,SEA,41,20,21,13,61,45,FALSE,0,0,"",8,16
2013,11,reg,Tampa Bay Buccaneers,Atlanta Falcons,TB,41,28,13,2,69,43.5,FALSE,0,0,"",11,25.5
2013,11,reg,Carolina Panthers,New England Patriots,CAR,24,20,4,3,44,45.5,FALSE,0,0,"",1,1.5
2013,12,reg,Atlanta Falcons,New Orleans Saints,NO,13,17,4,7,30,52.5,FALSE,1,0,DOME,3,22.5
2013,12,reg,Arizona Cardinals,Indianapolis Colts,ARI,40,11,29,3,51,44.5,FALSE,1,0,DOME,26,6.5
2013,12,reg,Baltimore Ravens,New York Jets,BAL,19,3,16,3.5,22,38.5,FALSE,0,0,"",12.5,16.5
2013,12,reg,Cleveland Browns,Pittsburgh Steelers,CLE,11,27,16,2,38,39,FALSE,0,1,Snow,14,1
2013,12,reg,Detroit Lions,Tampa Bay Buccaneers,DET,21,24,3,7,45,48,FALSE,1,0,DOME,4,3
2013,12,reg,Green Bay Packers,Minnesota Vikings,GB,26,26,0,5.5,52,44.5,FALSE,0,0,"",5.5,7.5
2013,12,reg,Houston Texans,Jacksonville Jaguars,HOU,6,13,7,10,19,43.5,FALSE,0,0,DOME (Open Roof),3,24.5
2013,12,reg,Kansas City Chiefs,San Diego Chargers,KC,38,41,3,3,79,42.5,FALSE,0,0,"",0,36.5
2013,12,reg,Miami Dolphins,Carolina Panthers,CAR,16,20,4,4,36,40.5,FALSE,0,1,Rain,0,4.5
2013,12,reg,New England Patriots,Denver Broncos,DEN,34,31,3,2.5,65,53,FALSE,0,0,"",0.5,12
2013,12,reg,New York Giants,Dallas Cowboys,NYG,21,24,3,2.5,45,44,FALSE,0,0,"",0.5,1
2013,12,reg,Oakland Raiders,Tennessee Titans,TEN,19,23,4,2,42,42,FALSE,0,0,"",2,0
2013,12,reg,St. Louis Rams,Chicago Bears,LAR,42,21,21,1.5,63,45,FALSE,1,0,DOME,19.5,18
2013,12,reg,Washington Redskins,San Francisco 49ers,SF,6,27,21,5,33,47,FALSE,0,0,"",16,14
2013,13,reg,Baltimore Ravens,Pittsburgh Steelers,BAL,22,20,2,3,42,40.5,FALSE,0,0,"",1,1.5
2013,13,reg,Dallas Cowboys,Oakland Raiders,DAL,31,24,7,8,55,48,FALSE,1,0,DOME,1,7
2013,13,reg,Detroit Lions,Green Bay Packers,DET,40,10,30,6,50,48.5,FALSE,1,0,DOME,24,1.5
2013,13,reg,Buffalo Bills,Atlanta Falcons,BUF,31,34,3,4.5,65,48.5,TRUE,1,0,DOME,1.5,16.5
2013,13,reg,Carolina Panthers,Tampa Bay Buccaneers,CAR,27,6,21,6.5,33,40.5,FALSE,0,0,"",14.5,7.5
2013,13,reg,Cleveland Browns,Jacksonville Jaguars,CLE,28,32,4,7.5,60,39,FALSE,0,0,"",3.5,21
2013,13,reg,Houston Texans,New England Patriots,NE,31,34,3,6.5,65,47.5,FALSE,0,0,DOME (Open Roof),3.5,17.5
2013,13,reg,Indianapolis Colts,Tennessee Titans,IND,22,14,8,3.5,36,46,FALSE,1,0,DOME,4.5,10
2013,13,reg,Kansas City Chiefs,Denver Broncos,DEN,28,35,7,6,63,50,FALSE,0,0,"",1,13
2013,13,reg,Minnesota Vikings,Chicago Bears,MIN,23,20,3,1,43,50.5,FALSE,1,0,DOME,2,7.5
2013,13,reg,New York Jets,Miami Dolphins,NYJ,3,23,20,2,26,40.5,FALSE,0,0,"",18,14.5
2013,13,reg,Philadelphia Eagles,Arizona Cardinals,PHI,24,21,3,3.5,45,48.5,FALSE,0,0,"",0.5,3.5
2013,13,reg,San Diego Chargers,Cincinnati Bengals,CIN,10,17,7,1.5,27,48.5,FALSE,0,0,"",5.5,21.5
2013,13,reg,San Francisco 49ers,St. Louis Rams,SF,23,13,10,7.5,36,40,FALSE,0,1,Fog,2.5,4
2013,13,reg,Washington Redskins,New York Giants,WAS,17,24,7,1,41,44.5,FALSE,0,0,"",6,3.5
2013,13,reg,Seattle Seahawks,New Orleans Saints,SEA,34,7,27,5,41,47.5,FALSE,0,0,"",22,6.5
2013,14,reg,Jacksonville Jaguars,Houston Texans,HOU,27,20,7,3.5,47,43,FALSE,0,0,"",3.5,4
2013,14,reg,Arizona Cardinals,St. Louis Rams,ARI,30,10,20,4.5,40,41,FALSE,1,0,DOME,15.5,1
2013,14,reg,Baltimore Ravens,Minnesota Vikings,BAL,29,26,3,6,55,41.5,FALSE,0,0,Snow | Freezing Rain,3,13.5
2013,14,reg,Cincinnati Bengals,Indianapolis Colts,CIN,42,28,14,7,70,43.5,FALSE,0,0,"",7,26.5
2013,14,reg,Denver Broncos,Tennessee Titans,DEN,51,28,23,13.5,79,49.5,FALSE,0,0,"",9.5,29.5
2013,14,reg,Green Bay Packers,Atlanta Falcons,GB,22,21,1,3.5,43,45,FALSE,0,1,Snow,2.5,2
2013,14,reg,New England Patriots,Cleveland Browns,NE,27,26,1,9.5,53,47.5,FALSE,0,0,"",8.5,5.5
2013,14,reg,New Orleans Saints,Carolina Panthers,NO,31,13,18,3,44,46.5,FALSE,1,0,DOME,15,2.5
2013,14,reg,New York Jets,Oakland Raiders,NYJ,37,27,10,3,64,39.5,FALSE,0,0,"",7,24.5
2013,14,reg,Philadelphia Eagles,Detroit Lions,PHI,34,20,14,2,54,53.5,FALSE,0,0,Snow | Fog,12,0.5
2013,14,reg,Pittsburgh Steelers,Miami Dolphins,PIT,28,34,6,3,62,41,FALSE,0,0,Snow | Fog,3,21
2013,14,reg,San Diego Chargers,New York Giants,LAC,37,14,23,4,51,46.5,FALSE,0,0,"",19,4.5
2013,14,reg,San Francisco 49ers,Seattle Seahawks,SF,19,17,2,2,36,41,FALSE,0,0,"",0,5
2013,14,reg,Tampa Bay Buccaneers,Buffalo Bills,TB,27,6,21,2.5,33,42.5,FALSE,0,0,"",18.5,9.5
2013,14,reg,Washington Redskins,Kansas City Chiefs,KC,10,45,35,3,55,44.5,FALSE,0,1,Rain,32,10.5
2013,14,reg,Chicago Bears,Dallas Cowboys,CHI,45,28,17,1.5,73,49.5,FALSE,0,0,"",15.5,23.5
2013,15,reg,Denver Broncos,San Diego Chargers,DEN,20,27,7,9.5,47,57,FALSE,0,0,"",2.5,10
2013,15,reg,Atlanta Falcons,Washington Redskins,ATL,27,26,1,5.5,53,49,FALSE,1,0,DOME,4.5,4
2013,15,reg,Carolina Panthers,New York Jets,CAR,30,20,10,10,50,40.5,FALSE,0,0,"",0,9.5
2013,15,reg,Cleveland Browns,Chicago Bears,CLE,31,38,7,1,69,44,FALSE,0,1,Snow,6,25
2013,15,reg,Dallas Cowboys,Green Bay Packers,DAL,36,37,1,4,73,49.5,FALSE,1,0,DOME,3,23.5
2013,15,reg,Indianapolis Colts,Houston Texans,IND,25,3,22,6,28,47,FALSE,1,0,DOME,16,19
2013,15,reg,Jacksonville Jaguars,Buffalo Bills,BUF,20,27,7,4,47,43.5,FALSE,0,0,"",3,3.5
2013,15,reg,Miami Dolphins,New England Patriots,MIA,24,20,4,2.5,44,46.5,FALSE,0,0,"",1.5,2.5
2013,15,reg,Minnesota Vikings,Philadelphia Eagles,PHI,48,30,18,7,78,53,FALSE,1,0,DOME,11,25
2013,15,reg,New York Giants,Seattle Seahawks,SEA,0,23,23,9.5,23,43,FALSE,0,0,"",13.5,20
2013,15,reg,Oakland Raiders,Kansas City Chiefs,KC,31,56,25,6,87,44.5,FALSE,0,0,"",19,42.5
2013,15,reg,Pittsburgh Steelers,Cincinnati Bengals,CIN,30,20,10,1.5,50,43,FALSE,0,0,"",8.5,7
2013,15,reg,St. Louis Rams,New Orleans Saints,NO,27,16,11,7,43,48,FALSE,1,0,DOME,4,5
2013,15,reg,Tampa Bay Buccaneers,San Francisco 49ers,SF,14,33,19,4.5,47,41,FALSE,0,0,"",14.5,6
2013,15,reg,Tennessee Titans,Arizona Cardinals,ARI,34,37,3,3,71,42.5,FALSE,0,0,"",0,28.5
2013,15,reg,Detroit Lions,Baltimore Ravens,DET,16,18,2,5.5,34,49,FALSE,1,0,DOME,3.5,15
2013,16,reg,Baltimore Ravens,New England Patriots,BAL,7,41,34,1.5,48,44.5,FALSE,0,1,Rain,32.5,3.5
2013,16,reg,Buffalo Bills,Miami Dolphins,MIA,19,0,19,1.5,19,42.5,FALSE,0,1,Rain | Fog,17.5,23.5
2013,16,reg,Carolina Panthers,New Orleans Saints,CAR,17,13,4,3,30,44.5,FALSE,0,1,Rain | Fog,1,14.5
2013,16,reg,Cincinnati Bengals,Minnesota Vikings,CIN,42,14,28,7.5,56,47.5,FALSE,0,0,"",20.5,8.5
2013,16,reg,Detroit Lions,New York Giants,DET,20,23,3,9,43,48.5,FALSE,1,0,DOME,6,5.5
2013,16,reg,Green Bay Packers,Pittsburgh Steelers,GB,31,38,7,2,69,44.5,FALSE,0,0,Snow | Fog,5,24.5
2013,16,reg,Houston Texans,Denver Broncos,DEN,13,37,24,9.5,50,53.5,FALSE,0,0,DOME (Open Roof),14.5,3.5
2013,16,reg,Jacksonville Jaguars,Tennessee Titans,TEN,16,20,4,4,36,44,FALSE,0,0,"",0,8
2013,16,reg,Kansas City Chiefs,Indianapolis Colts,KC,7,23,16,7,30,46.5,FALSE,0,0,"",9,16.5
2013,16,reg,New York Jets,Cleveland Browns,NYJ,24,13,11,1.5,37,42,FALSE,0,0,"",9.5,5
2013,16,reg,Philadelphia Eagles,Chicago Bears,PHI,54,11,43,3,65,55,FALSE,0,0,"",40,10
2013,16,reg,San Diego Chargers,Oakland Raiders,LAC,26,13,13,9,39,51,FALSE,0,0,"",4,12
2013,16,reg,Seattle Seahawks,Arizona Cardinals,SEA,10,17,7,9,27,43,FALSE,0,1,Fog,2,16
2013,16,reg,St. Louis Rams,Tampa Bay Buccaneers,LAR,23,13,10,3.5,36,43,FALSE,1,0,DOME,6.5,7
2013,16,reg,Washington Redskins,Dallas Cowboys,DAL,23,24,1,2.5,47,52,FALSE,0,0,"",1.5,5
2013,16,reg,San Francisco 49ers,Atlanta Falcons,SF,34,24,10,14.5,58,46,FALSE,0,0,"",4.5,12
2013,17,reg,Arizona Cardinals,San Francisco 49ers,ARI,20,23,3,3,43,41,FALSE,1,0,DOME,0,2
2013,17,reg,Atlanta Falcons,Carolina Panthers,CAR,20,21,1,5.5,41,46.5,FALSE,1,0,DOME,4.5,5.5
2013,17,reg,Chicago Bears,Green Bay Packers,GB,28,33,5,3,61,51.5,FALSE,0,0,"",2,9.5
2013,17,reg,Cincinnati Bengals,Baltimore Ravens,CIN,34,17,17,7,51,42.5,FALSE,0,0,"",10,8.5
2013,17,reg,Dallas Cowboys,Philadelphia Eagles,PHI,22,24,2,7,46,52.5,FALSE,1,0,DOME,5,6.5
2013,17,reg,Indianapolis Colts,Jacksonville Jaguars,IND,30,10,20,11.5,40,45,FALSE,1,0,DOME,8.5,5
2013,17,reg,Miami Dolphins,New York Jets,MIA,7,20,13,7,27,41,FALSE,0,0,"",6,14
2013,17,reg,Minnesota Vikings,Detroit Lions,DET,14,13,1,2.5,27,49.5,FALSE,1,0,DOME,1.5,22.5
2013,17,reg,New England Patriots,Buffalo Bills,NE,34,20,14,7,54,46,FALSE,0,1,Rain | Fog,7,8
2013,17,reg,New Orleans Saints,Tampa Bay Buccaneers,NO,42,17,25,10.5,59,46.5,FALSE,1,0,DOME,14.5,12.5
2013,17,reg,New York Giants,Washington Redskins,NYG,20,6,14,3.5,26,44.5,FALSE,0,1,Rain | Fog,10.5,18.5
2013,17,reg,Oakland Raiders,Denver Broncos,DEN,14,34,20,10,48,53.5,FALSE,0,0,"",10,5.5
2013,17,reg,Pittsburgh Steelers,Cleveland Browns,PIT,20,7,13,9.5,27,44.5,FALSE,0,1,Rain | Fog,3.5,17.5
2013,17,reg,San Diego Chargers,Kansas City Chiefs,LAC,27,24,3,14.5,51,45,FALSE,0,0,"",11.5,6
2013,17,reg,Seattle Seahawks,St. Louis Rams,SEA,27,9,18,12.5,36,41,FALSE,0,0,"",5.5,5
2013,17,reg,Tennessee Titans,Houston Texans,TEN,16,10,6,6.5,26,44.5,FALSE,0,0,"",0.5,18.5
2013,Wildcard,post,Indianapolis Colts,Kansas City Chiefs,KC,45,44,1,2.5,89,46.5,FALSE,1,0,DOME,1.5,42.5
2013,Wildcard,post,Philadelphia Eagles,New Orleans Saints,PHI,24,26,2,3,50,53,FALSE,0,0,"",1,3
2013,Wildcard,post,Cincinnati Bengals,San Diego Chargers,CIN,10,27,17,6,37,48,FALSE,0,0,"",11,11
2013,Wildcard,post,Green Bay Packers,San Francisco 49ers,SF,20,23,3,3,43,46,FALSE,0,0,"",0,3
2013,Division,post,New England Patriots,Indianapolis Colts,NE,43,22,21,7,65,51,FALSE,0,0,"",14,14
2013,Division,post,Seattle Seahawks,New Orleans Saints,SEA,23,15,8,9,38,44.5,FALSE,0,0,"",1,6.5
2013,Division,post,Carolina Panthers,San Francisco 49ers,SF,10,23,13,1,33,41.5,FALSE,0,0,"",12,8.5
2013,Division,post,Denver Broncos,San Diego Chargers,DEN,24,17,7,7.5,41,54.5,FALSE,0,0,"",0.5,13.5
2013,Conference,post,Denver Broncos,New England Patriots,DEN,26,16,10,5,42,57,FALSE,0,0,"",5,15
2013,Conference,post,Seattle Seahawks,San Francisco 49ers,SEA,23,17,6,4,40,40.5,FALSE,0,0,"",2,0.5
2013,Superbowl,post,Denver Broncos,Seattle Seahawks,DEN,8,43,35,2,51,47.5,TRUE,0,0,"",33,3.5
2014,1,reg,Seattle Seahawks,Green Bay Packers,SEA,36,16,20,4.5,52,46.5,FALSE,0,0,"",15.5,5.5
2014,1,reg,Atlanta Falcons,New Orleans Saints,NO,37,34,3,3,71,52,FALSE,1,0,DOME,0,19
2014,1,reg,Baltimore Ravens,Cincinnati Bengals,BAL,16,23,7,1,39,42.5,FALSE,0,0,"",6,3.5
2014,1,reg,Chicago Bears,Buffalo Bills,CHI,20,23,3,7,43,47,FALSE,0,0,"",4,4
2014,1,reg,Dallas Cowboys,San Francisco 49ers,SF,17,28,11,3.5,45,51,FALSE,1,0,DOME,7.5,6
2014,1,reg,Denver Broncos,Indianapolis Colts,DEN,31,24,7,8,55,55,FALSE,0,0,"",1,0
2014,1,reg,Houston Texans,Washington Redskins,HOU,17,6,11,3,23,44.5,FALSE,0,0,DOME (Open Roof),8,21.5
2014,1,reg,Kansas City Chiefs,Tennessee Titans,KC,10,26,16,3,36,44,FALSE,0,0,"",13,8
2014,1,reg,Miami Dolphins,New England Patriots,NE,33,20,13,3.5,53,46.5,FALSE,0,0,"",9.5,6.5
2014,1,reg,New York Jets,Oakland Raiders,NYJ,19,14,5,6.5,33,40.5,FALSE,0,0,"",1.5,7.5
2014,1,reg,Philadelphia Eagles,Jacksonville Jaguars,PHI,34,17,17,10,51,51.5,FALSE,0,0,"",7,0.5
2014,1,reg,Pittsburgh Steelers,Cleveland Browns,PIT,30,27,3,5.5,57,41,FALSE,0,0,"",2.5,16
2014,1,reg,St. Louis Rams,Minnesota Vikings,LAR,6,34,28,3,40,43,FALSE,1,0,DOME,25,3
2014,1,reg,Tampa Bay Buccaneers,Carolina Panthers,TB,14,20,6,5.5,34,37.5,FALSE,0,0,"",0.5,3.5
2014,1,reg,Arizona Cardinals,San Diego Chargers,ARI,18,17,1,3,35,47,FALSE,1,0,DOME,2,12
2014,1,reg,Detroit Lions,New York Giants,DET,35,14,21,6.5,49,47,FALSE,1,0,DOME,14.5,2
2014,2,reg,Baltimore Ravens,Pittsburgh Steelers,BAL,26,6,20,2.5,32,44.5,FALSE,0,0,"",17.5,12.5
2014,2,reg,Buffalo Bills,Miami Dolphins,BUF,29,10,19,1,39,43,FALSE,0,0,"",18,4
2014,2,reg,Carolina Panthers,Detroit Lions,CAR,24,7,17,1,31,43.5,FALSE,0,0,"",16,12.5
2014,2,reg,Cincinnati Bengals,Atlanta Falcons,CIN,24,10,14,5.5,34,49,FALSE,0,0,"",8.5,15
2014,2,reg,Cleveland Browns,New Orleans Saints,NO,26,24,2,4.5,50,49.5,FALSE,0,0,"",2.5,0.5
2014,2,reg,Denver Broncos,Kansas City Chiefs,DEN,24,17,7,13,41,49,FALSE,0,1,Rain,6,8
2014,2,reg,Green Bay Packers,New York Jets,GB,31,24,7,7,55,46.5,FALSE,0,0,"",0,8.5
2014,2,reg,Minnesota Vikings,New England Patriots,NE,7,30,23,3.5,37,49,FALSE,0,0,"",19.5,12
2014,2,reg,New York Giants,Arizona Cardinals,NYG,14,25,11,1,39,41.5,FALSE,0,0,"",10,2.5
2014,2,reg,Oakland Raiders,Houston Texans,HOU,14,30,16,3,44,42,FALSE,0,0,"",13,2
2014,2,reg,San Diego Chargers,Seattle Seahawks,SEA,30,21,9,4.5,51,45,FALSE,0,0,"",4.5,6
2014,2,reg,San Francisco 49ers,Chicago Bears,SF,20,28,8,7,48,47.5,FALSE,0,0,"",1,0.5
2014,2,reg,Tampa Bay Buccaneers,St. Louis Rams,TB,17,19,2,4,36,37.5,FALSE,0,0,"",2,1.5
2014,2,reg,Tennessee Titans,Dallas Cowboys,TEN,10,26,16,3,36,49.5,FALSE,0,0,"",13,13.5
2014,2,reg,Washington Redskins,Jacksonville Jaguars,WAS,41,10,31,5,51,43,FALSE,0,0,"",26,8
2014,2,reg,Indianapolis Colts,Philadelphia Eagles,IND,27,30,3,3,57,54,FALSE,1,0,DOME,0,3
2014,3,reg,Atlanta Falcons,Tampa Bay Buccaneers,ATL,56,14,42,6.5,70,47,FALSE,1,0,DOME,35.5,23
2014,3,reg,Arizona Cardinals,San Francisco 49ers,SF,23,14,9,3,37,41,FALSE,1,0,DOME,6,4
2014,3,reg,Buffalo Bills,San Diego Chargers,BUF,10,22,12,2.5,32,45.5,FALSE,0,0,"",9.5,13.5
2014,3,reg,Carolina Panthers,Pittsburgh Steelers,CAR,19,37,18,3,56,42.5,FALSE,0,0,"",15,13.5
2014,3,reg,Cincinnati Bengals,Tennessee Titans,CIN,33,7,26,6.5,40,44.5,FALSE,0,0,"",19.5,4.5
2014,3,reg,Cleveland Browns,Baltimore Ravens,BAL,21,23,2,2,44,43,FALSE,0,0,"",0,1
2014,3,reg,Detroit Lions,Green Bay Packers,DET,19,7,12,1.5,26,52,FALSE,1,0,DOME,10.5,26
2014,3,reg,Jacksonville Jaguars,Indianapolis Colts,IND,17,44,27,6,61,45,FALSE,0,0,"",21,16
2014,3,reg,Miami Dolphins,Kansas City Chiefs,MIA,15,34,19,6,49,42.5,FALSE,0,0,"",13,6.5
2014,3,reg,New England Patriots,Oakland Raiders,NE,16,9,7,14,25,47,FALSE,0,0,"",7,22
2014,3,reg,New Orleans Saints,Minnesota Vikings,NO,20,9,11,10,29,49.5,FALSE,1,0,DOME,1,20.5
2014,3,reg,New York Giants,Houston Texans,NYG,30,17,13,1,47,41.5,FALSE,0,1,Fog,12,5.5
2014,3,reg,Philadelphia Eagles,Washington Redskins,PHI,37,34,3,4,71,50,FALSE,0,0,"",1,21
2014,3,reg,Seattle Seahawks,Denver Broncos,SEA,26,20,6,4,46,48,FALSE,0,0,"",2,2
2014,3,reg,St. Louis Rams,Dallas Cowboys,DAL,31,34,3,1.5,65,45,FALSE,1,0,DOME,1.5,20
2014,3,reg,New York Jets,Chicago Bears,NYJ,19,27,8,1.5,46,45,FALSE,0,0,"",6.5,1
2014,4,reg,Washington Redskins,New York Giants,WAS,14,45,31,3,59,44.5,FALSE,0,0,"",28,14.5
2014,4,reg,Baltimore Ravens,Carolina Panthers,BAL,38,10,28,3.5,48,42,FALSE,0,0,"",24.5,6
2014,4,reg,Chicago Bears,Green Bay Packers,GB,17,38,21,2,55,51,FALSE,0,0,"",19,4
2014,4,reg,Dallas Cowboys,New Orleans Saints,NO,38,17,21,3,55,54,FALSE,1,0,DOME,18,1
2014,4,reg,Houston Texans,Buffalo Bills,HOU,23,17,6,3,40,44,FALSE,0,0,DOME (Open Roof),3,4
2014,4,reg,Indianapolis Colts,Tennessee Titans,IND,41,17,24,7.5,58,46,FALSE,1,0,DOME,16.5,12
2014,4,reg,Minnesota Vikings,Atlanta Falcons,ATL,41,28,13,5.5,69,47.5,FALSE,0,0,"",7.5,21.5
2014,4,reg,New York Jets,Detroit Lions,NYJ,17,24,7,2,41,44,FALSE,0,0,"",5,3
2014,4,reg,Oakland Raiders,Miami Dolphins,MIA,14,38,24,4,52,41,TRUE,0,0,"",20,11
2014,4,reg,Pittsburgh Steelers,Tampa Bay Buccaneers,PIT,24,27,3,7.5,51,45,FALSE,0,0,"",4.5,6
2014,4,reg,San Diego Chargers,Jacksonville Jaguars,LAC,33,14,19,13,47,44.5,FALSE,0,0,"",6,2.5
2014,4,reg,San Francisco 49ers,Philadelphia Eagles,SF,26,21,5,3.5,47,49.5,FALSE,0,0,"",1.5,2.5
2014,4,reg,Kansas City Chiefs,New England Patriots,NE,41,14,27,3,55,45.5,FALSE,0,0,"",24,9.5
2014,5,reg,Green Bay Packers,Minnesota Vikings,GB,42,10,32,8.5,52,46.5,FALSE,0,1,Fog,23.5,5.5
2014,5,reg,Carolina Panthers,Chicago Bears,CAR,31,24,7,1.5,55,47,FALSE,0,0,"",5.5,8
2014,5,reg,Dallas Cowboys,Houston Texans,DAL,20,17,3,5,37,48,FALSE,1,0,DOME,2,11
2014,5,reg,Denver Broncos,Arizona Cardinals,DEN,41,20,21,8,61,47.5,FALSE,0,0,"",13,13.5
2014,5,reg,Detroit Lions,Buffalo Bills,DET,14,17,3,4.5,31,43.5,FALSE,1,0,DOME,1.5,12.5
2014,5,reg,Indianapolis Colts,Baltimore Ravens,IND,20,13,7,2.5,33,49.5,FALSE,1,0,DOME,4.5,16.5
2014,5,reg,Jacksonville Jaguars,Pittsburgh Steelers,PIT,9,17,8,6,26,47.5,FALSE,0,0,"",2,21.5
2014,5,reg,New England Patriots,Cincinnati Bengals,CIN,43,17,26,2.5,60,46.5,FALSE,0,1,Fog,23.5,13.5
2014,5,reg,New Orleans Saints,Tampa Bay Buccaneers,NO,37,31,6,11,68,48,FALSE,1,0,DOME,5,20
2014,5,reg,New York Giants,Atlanta Falcons,NYG,30,20,10,4,50,50.5,FALSE,0,0,"",6,0.5
2014,5,reg,Philadelphia Eagles,St. Louis Rams,PHI,34,28,6,3.5,62,48,FALSE,0,0,"",2.5,14
2014,5,reg,San Diego Chargers,New York Jets,LAC,31,0,31,7,31,44.5,FALSE,0,0,"",24,13.5
2014,5,reg,San Francisco 49ers,Kansas City Chiefs,SF,22,17,5,4,39,43.5,FALSE,0,0,"",1,4.5
2014,5,reg,Tennessee Titans,Cleveland Browns,CLE,28,29,1,1,57,44,FALSE,0,0,"",0,13
2014,5,reg,Washington Redskins,Seattle Seahawks,SEA,17,27,10,7,44,46,FALSE,0,0,"",3,2
2014,6,reg,Houston Texans,Indianapolis Colts,IND,28,33,5,2.5,61,46,FALSE,0,0,DOME (Open Roof),2.5,15
2014,6,reg,Arizona Cardinals,Washington Redskins,ARI,30,20,10,5,50,46.5,FALSE,1,0,DOME,5,3.5
2014,6,reg,Atlanta Falcons,Chicago Bears,ATL,13,27,14,3.5,40,56,FALSE,1,0,DOME,10.5,16
2014,6,reg,Buffalo Bills,New England Patriots,BUF,22,37,15,1,59,44.5,FALSE,0,0,"",14,14.5
2014,6,reg,Cincinnati Bengals,Carolina Panthers,CIN,37,37,0,7,74,44,FALSE,0,0,"",7,30
2014,6,reg,Cleveland Browns,Pittsburgh Steelers,CLE,31,10,21,2.5,41,46.5,FALSE,0,0,"",18.5,5.5
2014,6,reg,Miami Dolphins,Green Bay Packers,GB,24,27,3,1.5,51,47,FALSE,0,0,"",1.5,4
2014,6,reg,Minnesota Vikings,Detroit Lions,MIN,3,17,14,1,20,43,FALSE,0,0,"",13,23
2014,6,reg,New York Jets,Denver Broncos,DEN,17,31,14,10,48,47.5,FALSE,0,0,"",4,0.5
2014,6,reg,Oakland Raiders,San Diego Chargers,LAC,28,31,3,7,59,44,FALSE,0,0,"",4,15
2014,6,reg,Philadelphia Eagles,New York Giants,PHI,27,0,27,1,27,51,FALSE,0,0,"",26,24
2014,6,reg,Seattle Seahawks,Dallas Cowboys,SEA,23,30,7,10,53,47,FALSE,0,0,"",3,6
2014,6,reg,Tampa Bay Buccaneers,Baltimore Ravens,BAL,17,48,31,3.5,65,44.5,FALSE,0,0,"",27.5,20.5
2014,6,reg,Tennessee Titans,Jacksonville Jaguars,TEN,16,14,2,4,30,42.5,FALSE,0,0,"",2,12.5
2014,6,reg,St. Louis Rams,San Francisco 49ers,SF,17,31,14,3.5,48,44.5,FALSE,1,0,DOME,10.5,3.5
2014,7,reg,New England Patriots,New York Jets,NE,27,25,2,9.5,52,44.5,FALSE,0,0,"",7.5,7.5
2014,7,reg,Baltimore Ravens,Atlanta Falcons,BAL,29,7,22,7,36,50,FALSE,0,0,"",15,14
2014,7,reg,Buffalo Bills,Minnesota Vikings,BUF,17,16,1,7,33,43,FALSE,0,0,"",6,10
2014,7,reg,Chicago Bears,Miami Dolphins,CHI,14,27,13,3,41,48,FALSE,0,0,"",10,7
2014,7,reg,Dallas Cowboys,New York Giants,DAL,31,21,10,5,52,47,FALSE,1,0,DOME,5,5
2014,7,reg,Denver Broncos,San Francisco 49ers,DEN,42,17,25,7,59,48.5,FALSE,0,0,"",18,10.5
2014,7,reg,Detroit Lions,New Orleans Saints,DET,24,23,1,1.5,47,46.5,FALSE,1,0,DOME,0.5,0.5
2014,7,reg,Green Bay Packers,Carolina Panthers,GB,38,17,21,6.5,55,49.5,FALSE,0,0,"",14.5,5.5
2014,7,reg,Indianapolis Colts,Cincinnati Bengals,IND,27,0,27,3,27,50.5,FALSE,1,0,DOME,24,23.5
2014,7,reg,Jacksonville Jaguars,Cleveland Browns,CLE,24,6,18,4,30,45,FALSE,0,0,"",14,15
2014,7,reg,Oakland Raiders,Arizona Cardinals,ARI,13,24,11,3.5,37,46.5,FALSE,0,0,"",7.5,9.5
2014,7,reg,San Diego Chargers,Kansas City Chiefs,LAC,20,23,3,3,43,46,FALSE,0,0,"",0,3
2014,7,reg,St. Louis Rams,Seattle Seahawks,SEA,28,26,2,7,54,43.5,FALSE,1,0,DOME,5,10.5
2014,7,reg,Washington Redskins,Tennessee Titans,WAS,19,17,2,6,36,46.5,FALSE,0,0,"",4,10.5
2014,7,reg,Pittsburgh Steelers,Houston Texans,PIT,30,23,7,3,53,44.5,FALSE,0,1,Rain,4,8.5
2014,8,reg,Denver Broncos,San Diego Chargers,DEN,35,21,14,9,56,51,FALSE,0,0,"",5,5
2014,8,reg,Arizona Cardinals,Philadelphia Eagles,ARI,24,20,4,1,44,48.5,FALSE,1,0,DOME,3,4.5
2014,8,reg,Atlanta Falcons,Detroit Lions,DET,21,22,1,3.5,43,45.5,TRUE,0,0,"",2.5,2.5
2014,8,reg,Carolina Panthers,Seattle Seahawks,SEA,9,13,4,6,22,45,FALSE,0,0,"",2,23
2014,8,reg,Cincinnati Bengals,Baltimore Ravens,BAL,27,24,3,2.5,51,44.5,FALSE,0,0,"",0.5,6.5
2014,8,reg,Cleveland Browns,Oakland Raiders,CLE,23,13,10,6.5,36,44.5,FALSE,0,0,"",3.5,8.5
2014,8,reg,Jacksonville Jaguars,Miami Dolphins,MIA,13,27,14,7,40,42,FALSE,0,0,"",7,2
2014,8,reg,Kansas City Chiefs,St. Louis Rams,KC,34,7,27,7.5,41,44,FALSE,0,0,"",19.5,3
2014,8,reg,New England Patriots,Chicago Bears,NE,51,23,28,6,74,52,FALSE,0,0,"",22,22
2014,8,reg,New Orleans Saints,Green Bay Packers,NO,44,23,21,2,67,55.5,FALSE,1,0,DOME,19,11.5
2014,8,reg,New York Jets,Buffalo Bills,NYJ,23,43,20,3,66,40.5,FALSE,0,0,"",17,25.5
2014,8,reg,Pittsburgh Steelers,Indianapolis Colts,IND,51,34,17,5,85,48.5,FALSE,0,0,"",12,36.5
2014,8,reg,Tampa Bay Buccaneers,Minnesota Vikings,TB,13,19,6,1,32,43,FALSE,0,0,"",5,11
2014,8,reg,Tennessee Titans,Houston Texans,HOU,16,30,14,3.5,46,43,FALSE,0,0,"",10.5,3
2014,8,reg,Dallas Cowboys,Washington Redskins,DAL,17,20,3,9.5,37,49,FALSE,1,0,DOME,6.5,12
2014,9,reg,Carolina Panthers,New Orleans Saints,NO,10,28,18,3,38,49,FALSE,0,0,"",15,11
2014,9,reg,Cincinnati Bengals,Jacksonville Jaguars,CIN,33,23,10,10,56,43.5,FALSE,0,0,"",0,12.5
2014,9,reg,Cleveland Browns,Tampa Bay Buccaneers,CLE,22,17,5,7,39,44,FALSE,0,0,"",2,5
2014,9,reg,Dallas Cowboys,Arizona Cardinals,DAL,17,28,11,1.5,45,45,FALSE,1,0,DOME,9.5,0
2014,9,reg,Houston Texans,Philadelphia Eagles,PHI,21,31,10,1.5,52,48.5,FALSE,0,0,DOME (Open Roof),8.5,3.5
2014,9,reg,Kansas City Chiefs,New York Jets,KC,24,10,14,9.5,34,41.5,FALSE,0,0,"",4.5,7.5
2014,9,reg,Miami Dolphins,San Diego Chargers,MIA,37,0,37,3,37,45,FALSE,0,0,"",34,8
2014,9,reg,Minnesota Vikings,Washington Redskins,WAS,29,26,3,1,55,44,FALSE,0,0,"",2,11
2014,9,reg,New England Patriots,Denver Broncos,DEN,43,21,22,3,64,53,FALSE,0,0,"",19,11
2014,9,reg,Pittsburgh Steelers,Baltimore Ravens,PIT,43,23,20,2.5,66,48,FALSE,0,0,"",17.5,18
2014,9,reg,San Francisco 49ers,St. Louis Rams,SF,10,13,3,10.5,23,44,FALSE,0,0,"",7.5,21
2014,9,reg,Seattle Seahawks,Oakland Raiders,SEA,30,24,6,13.5,54,44,FALSE,0,1,Rain,7.5,10
2014,9,reg,New York Giants,Indianapolis Colts,IND,24,40,16,3,64,51.5,FALSE,0,0,"",13,12.5
2014,10,reg,Cincinnati Bengals,Cleveland Browns,CIN,3,24,21,6.5,27,46,FALSE,0,0,"",14.5,19
2014,10,reg,Arizona Cardinals,St. Louis Rams,ARI,31,14,17,7,45,43.5,FALSE,1,0,DOME,10,1.5
2014,10,reg,Baltimore Ravens,Tennessee Titans,BAL,21,7,14,10.5,28,44,FALSE,0,0,"",3.5,16
2014,10,reg,Buffalo Bills,Kansas City Chiefs,BUF,13,17,4,2,30,42,FALSE,0,1,Rain,2,12
2014,10,reg,Detroit Lions,Miami Dolphins,DET,20,16,4,3,36,43,FALSE,1,0,DOME,1,7
2014,10,reg,Green Bay Packers,Chicago Bears,GB,55,14,41,9.5,69,54,FALSE,0,0,"",31.5,15
2014,10,reg,Jacksonville Jaguars,Dallas Cowboys,DAL,17,31,14,7.5,48,45,TRUE,0,1,Rain,6.5,3
2014,10,reg,New Orleans Saints,San Francisco 49ers,NO,24,27,3,6,51,49.5,FALSE,1,0,DOME,3,1.5
2014,10,reg,New York Jets,Pittsburgh Steelers,PIT,20,13,7,4.5,33,47,FALSE,0,0,"",2.5,14
2014,10,reg,Oakland Raiders,Denver Broncos,DEN,17,41,24,13,58,51,FALSE,0,0,"",11,7
2014,10,reg,Seattle Seahawks,New York Giants,SEA,38,17,21,9,55,45,FALSE,0,1,Rain,12,10
2014,10,reg,Tampa Bay Buccaneers,Atlanta Falcons,ATL,17,27,10,3.5,44,47,FALSE,0,0,"",6.5,3
2014,10,reg,Philadelphia Eagles,Carolina Panthers,PHI,45,21,24,7,66,48.5,FALSE,0,0,"",17,17.5
2014,11,reg,Miami Dolphins,Buffalo Bills,MIA,22,9,13,4,31,41,FALSE,0,0,"",9,10
2014,11,reg,Arizona Cardinals,Detroit Lions,DET,14,6,8,1,20,41.5,FALSE,1,0,DOME,7,21.5
2014,11,reg,Carolina Panthers,Atlanta Falcons,ATL,17,19,2,2.5,36,47,FALSE,0,0,"",0.5,11
2014,11,reg,Chicago Bears,Minnesota Vikings,CHI,21,13,8,2.5,34,46.5,FALSE,0,1,Snow,5.5,12.5
2014,11,reg,Cleveland Browns,Houston Texans,CLE,7,23,16,4.5,30,42,FALSE,0,0,"",11.5,12
2014,11,reg,Green Bay Packers,Philadelphia Eagles,GB,53,20,33,4.5,73,55.5,FALSE,0,0,"",28.5,17.5
2014,11,reg,Indianapolis Colts,New England Patriots,IND,20,42,22,3,62,59,FALSE,1,0,DOME,19,3
2014,11,reg,Kansas City Chiefs,Seattle Seahawks,SEA,24,20,4,1,44,43.5,FALSE,0,0,"",3,0.5
2014,11,reg,New Orleans Saints,Cincinnati Bengals,NO,10,27,17,8.5,37,51.5,FALSE,1,0,DOME,8.5,14.5
2014,11,reg,New York Giants,San Francisco 49ers,SF,10,16,6,4,26,45,FALSE,0,0,"",2,19
2014,11,reg,San Diego Chargers,Oakland Raiders,LAC,13,6,7,10.5,19,45.5,FALSE,0,0,"",3.5,26.5
2014,11,reg,St. Louis Rams,Denver Broncos,DEN,22,7,15,8,29,50,FALSE,1,0,DOME,7,21
2014,11,reg,Washington Redskins,Tampa Bay Buccaneers,WAS,7,27,20,6.5,34,46,FALSE,0,0,"",13.5,12
2014,11,reg,Tennessee Titans,Pittsburgh Steelers,PIT,24,27,3,7,51,46,FALSE,0,0,"",4,5
2014,12,reg,Oakland Raiders,Kansas City Chiefs,KC,24,20,4,7.5,44,42,FALSE,0,1,Rain | Fog,3.5,2
2014,12,reg,Atlanta Falcons,Cleveland Browns,ATL,24,26,2,3,50,48.5,FALSE,1,0,DOME,1,1.5
2014,12,reg,Chicago Bears,Tampa Bay Buccaneers,CHI,21,13,8,4,34,46.5,FALSE,0,1,Rain,4,12.5
2014,12,reg,Denver Broncos,Miami Dolphins,DEN,39,36,3,6.5,75,47.5,FALSE,0,1,Rain,3.5,27.5
2014,12,reg,Houston Texans,Cincinnati Bengals,HOU,13,22,9,3,35,44.5,FALSE,0,0,DOME (Open Roof),6,9.5
2014,12,reg,Indianapolis Colts,Jacksonville Jaguars,IND,23,3,20,13,26,49.5,FALSE,1,0,DOME,7,23.5
2014,12,reg,Minnesota Vikings,Green Bay Packers,GB,21,24,3,7.5,45,49.5,FALSE,0,1,Fog,4.5,4.5
2014,12,reg,New England Patriots,Detroit Lions,NE,34,9,25,7.5,43,47.5,FALSE,0,0,"",17.5,4.5
2014,12,reg,New York Giants,Dallas Cowboys,DAL,28,31,3,4,59,49,FALSE,0,0,"",1,10
2014,12,reg,Philadelphia Eagles,Tennessee Titans,PHI,43,24,19,11,67,49,FALSE,0,0,"",8,18
2014,12,reg,San Diego Chargers,St. Louis Rams,LAC,27,24,3,4,51,43.5,FALSE,0,0,"",1,7.5
2014,12,reg,San Francisco 49ers,Washington Redskins,SF,17,13,4,9,30,44,FALSE,0,0,"",5,14
2014,12,reg,Seattle Seahawks,Arizona Cardinals,SEA,19,3,16,7.5,22,41.5,FALSE,0,0,"",8.5,19.5
2014,12,reg,Buffalo Bills,New York Jets,BUF,38,3,35,2.5,41,42.5,FALSE,1,0,DOME,32.5,1.5
2014,12,reg,New Orleans Saints,Baltimore Ravens,NO,27,34,7,2.5,61,50.5,FALSE,1,0,DOME,4.5,10.5
2014,13,reg,Dallas Cowboys,Philadelphia Eagles,DAL,10,33,23,3,43,57,FALSE,1,0,DOME,20,14
2014,13,reg,Detroit Lions,Chicago Bears,DET,34,17,17,7.5,51,46,FALSE,1,0,DOME,9.5,5
2014,13,reg,San Francisco 49ers,Seattle Seahawks,SF,3,19,16,1,22,40.5,FALSE,0,0,"",15,18.5
2014,13,reg,Atlanta Falcons,Arizona Cardinals,ARI,29,18,11,1.5,47,45,FALSE,1,0,DOME,9.5,2
2014,13,reg,Baltimore Ravens,San Diego Chargers,BAL,33,34,1,6.5,67,46,FALSE,0,0,"",5.5,21
2014,13,reg,Buffalo Bills,Cleveland Browns,BUF,26,10,16,3,36,42,FALSE,0,0,"",13,6
2014,13,reg,Green Bay Packers,New England Patriots,GB,26,21,5,3,47,58,FALSE,0,0,"",2,11
2014,13,reg,Houston Texans,Tennessee Titans,HOU,45,21,24,7,66,42.5,FALSE,0,0,DOME (Open Roof),17,23.5
2014,13,reg,Indianapolis Colts,Washington Redskins,IND,49,27,22,7.5,76,49,FALSE,1,0,DOME,14.5,27
2014,13,reg,Jacksonville Jaguars,New York Giants,NYG,25,24,1,3,49,44,FALSE,0,0,"",2,5
2014,13,reg,Kansas City Chiefs,Denver Broncos,KC,16,29,13,1,45,49.5,FALSE,0,0,"",12,4.5
2014,13,reg,Minnesota Vikings,Carolina Panthers,MIN,31,13,18,2.5,44,41.5,FALSE,0,0,"",15.5,2.5
2014,13,reg,Pittsburgh Steelers,New Orleans Saints,PIT,32,35,3,3.5,67,54.5,FALSE,0,0,"",0.5,12.5
2014,13,reg,St. Louis Rams,Oakland Raiders,LAR,52,0,52,6.5,52,43,FALSE,1,0,DOME,45.5,9
2014,13,reg,Tampa Bay Buccaneers,Cincinnati Bengals,CIN,13,14,1,6,27,43.5,FALSE,0,0,"",5,16.5
2014,13,reg,New York Jets,Miami Dolphins,MIA,13,16,3,6.5,29,41.5,FALSE,0,0,"",3.5,12.5
2014,14,reg,Chicago Bears,Dallas Cowboys,DAL,28,41,13,3.5,69,50,FALSE,0,0,"",9.5,19
2014,14,reg,Arizona Cardinals,Kansas City Chiefs,KC,17,14,3,2.5,31,41,FALSE,1,0,DOME,0.5,10
2014,14,reg,Cincinnati Bengals,Pittsburgh Steelers,CIN,21,42,21,3,63,47.5,FALSE,0,0,"",18,15.5
2014,14,reg,Cleveland Browns,Indianapolis Colts,IND,24,25,1,3,49,50,FALSE,0,0,"",2,1
2014,14,reg,Denver Broncos,Buffalo Bills,DEN,24,17,7,9,41,47,FALSE,0,0,"",2,6
2014,14,reg,Detroit Lions,Tampa Bay Buccaneers,DET,34,17,17,10.5,51,42,FALSE,1,0,DOME,6.5,9
2014,14,reg,Jacksonville Jaguars,Houston Texans,HOU,13,27,14,6.5,40,42,FALSE,0,0,"",7.5,2
2014,14,reg,Miami Dolphins,Baltimore Ravens,MIA,13,28,15,3,41,45,FALSE,0,0,"",12,4
2014,14,reg,Minnesota Vikings,New York Jets,MIN,30,24,6,4.5,54,40,FALSE,0,0,"",1.5,14
2014,14,reg,New Orleans Saints,Carolina Panthers,NO,10,41,31,8.5,51,50.5,FALSE,1,0,DOME,22.5,0.5
2014,14,reg,Oakland Raiders,San Francisco 49ers,SF,24,13,11,8,37,40.5,FALSE,0,0,"",3,3.5
2014,14,reg,Philadelphia Eagles,Seattle Seahawks,SEA,14,24,10,1.5,38,48,FALSE,0,0,"",8.5,10
2014,14,reg,San Diego Chargers,New England Patriots,NE,14,23,9,4,37,54,FALSE,0,0,"",5,17
2014,14,reg,Tennessee Titans,New York Giants,NYG,7,36,29,3,43,46.5,FALSE,0,0,"",26,3.5
2014,14,reg,Washington Redskins,St. Louis Rams,LAR,0,24,24,2.5,24,44.5,FALSE,0,0,"",21.5,20.5
2014,14,reg,Green Bay Packers,Atlanta Falcons,GB,43,37,6,13.5,80,55,FALSE,0,0,"",7.5,25
2014,15,reg,St. Louis Rams,Arizona Cardinals,LAR,6,12,6,6,18,40.5,FALSE,1,0,DOME,0,22.5
2014,15,reg,Atlanta Falcons,Pittsburgh Steelers,PIT,20,27,7,3,47,55.5,FALSE,1,0,DOME,4,8.5
2014,15,reg,Baltimore Ravens,Jacksonville Jaguars,BAL,20,12,8,14,32,44.5,FALSE,0,0,"",6,12.5
2014,15,reg,Buffalo Bills,Green Bay Packers,GB,21,13,8,3.5,34,50,FALSE,0,0,"",4.5,16
2014,15,reg,Carolina Panthers,Tampa Bay Buccaneers,CAR,19,17,2,3.5,36,41.5,FALSE,0,0,"",1.5,5.5
2014,15,reg,Cleveland Browns,Cincinnati Bengals,CLE,0,30,30,2.5,30,43.5,FALSE,0,0,"",27.5,13.5
2014,15,reg,Detroit Lions,Minnesota Vikings,DET,16,14,2,8,30,42,FALSE,1,0,DOME,6,12
2014,15,reg,Indianapolis Colts,Houston Texans,IND,17,10,7,7,27,49,FALSE,1,0,DOME,0,22
2014,15,reg,Kansas City Chiefs,Oakland Raiders,KC,31,13,18,11,44,41.5,FALSE,0,0,"",7,2.5
2014,15,reg,New England Patriots,Miami Dolphins,NE,41,13,28,9.5,54,48,FALSE,0,0,"",18.5,6
2014,15,reg,New York Giants,Washington Redskins,NYG,24,13,11,7,37,46.5,FALSE,0,0,"",4,9.5
2014,15,reg,Philadelphia Eagles,Dallas Cowboys,PHI,27,38,11,3.5,65,55,FALSE,0,0,"",7.5,10
2014,15,reg,San Diego Chargers,Denver Broncos,DEN,10,22,12,4,32,49.5,FALSE,0,0,"",8,17.5
2014,15,reg,Seattle Seahawks,San Francisco 49ers,SEA,17,7,10,10,24,38.5,FALSE,0,0,"",0,14.5
2014,15,reg,Tennessee Titans,New York Jets,NYJ,11,16,5,3.5,27,41.5,FALSE,0,0,"",1.5,14.5
2014,15,reg,Chicago Bears,New Orleans Saints,NO,15,31,16,3,46,53.5,FALSE,0,0,"",13,7.5
2014,16,reg,Jacksonville Jaguars,Tennessee Titans,JAX,21,13,8,4,34,39,FALSE,0,0,"",4,5
2014,16,reg,San Francisco 49ers,San Diego Chargers,SF,35,38,3,2,73,40.5,FALSE,0,0,"",1,32.5
2014,16,reg,Washington Redskins,Philadelphia Eagles,PHI,27,24,3,7,51,51,FALSE,0,0,"",4,0
2014,16,reg,Arizona Cardinals,Seattle Seahawks,SEA,6,35,29,9.5,41,36.5,FALSE,1,0,DOME,19.5,4.5
2014,16,reg,Carolina Panthers,Cleveland Browns,CAR,17,13,4,6,30,40,FALSE,0,0,"",2,10
2014,16,reg,Chicago Bears,Detroit Lions,DET,14,20,6,10,34,44.5,FALSE,0,0,"",4,10.5
2014,16,reg,Dallas Cowboys,Indianapolis Colts,DAL,42,7,35,3.5,49,53.5,FALSE,1,0,DOME,31.5,4.5
2014,16,reg,Houston Texans,Baltimore Ravens,BAL,25,13,12,6,38,41.5,FALSE,0,0,DOME (Open Roof),6,3.5
2014,16,reg,Miami Dolphins,Minnesota Vikings,MIA,37,35,2,4.5,72,42.5,FALSE,0,0,"",2.5,29.5
2014,16,reg,New Orleans Saints,Atlanta Falcons,NO,14,30,16,6,44,56,FALSE,1,0,DOME,10,12
2014,16,reg,New York Jets,New England Patriots,NE,16,17,1,10,33,47,FALSE,0,0,"",9,14
2014,16,reg,Oakland Raiders,Buffalo Bills,BUF,26,24,2,7,50,41.5,FALSE,0,0,"",5,8.5
2014,16,reg,Pittsburgh Steelers,Kansas City Chiefs,PIT,20,12,8,2.5,32,49.5,FALSE,0,0,"",5.5,17.5
2014,16,reg,St. Louis Rams,New York Giants,LAR,27,37,10,7,64,43.5,FALSE,1,0,DOME,3,20.5
2014,16,reg,Tampa Bay Buccaneers,Green Bay Packers,GB,3,20,17,11.5,23,49,FALSE,0,0,"",5.5,26
2014,16,reg,Cincinnati Bengals,Denver Broncos,DEN,37,28,9,3.5,65,47.5,FALSE,0,0,"",5.5,17.5
2014,17,reg,Atlanta Falcons,Carolina Panthers,ATL,3,34,31,2.5,37,48,FALSE,1,0,DOME,28.5,11
2014,17,reg,Baltimore Ravens,Cleveland Browns,BAL,20,10,10,14,30,40,FALSE,0,0,"",4,10
2014,17,reg,Denver Broncos,Oakland Raiders,DEN,47,14,33,16.5,61,48.5,FALSE,0,0,"",16.5,12.5
2014,17,reg,Green Bay Packers,Detroit Lions,GB,30,20,10,9,50,47,FALSE,0,0,"",1,3
2014,17,reg,Houston Texans,Jacksonville Jaguars,HOU,23,17,6,8.5,40,38.5,FALSE,0,0,DOME (Open Roof),2.5,1.5
2014,17,reg,Kansas City Chiefs,San Diego Chargers,KC,19,7,12,3,26,42,FALSE,0,0,"",9,16
2014,17,reg,Miami Dolphins,New York Jets,MIA,24,37,13,7,61,41,FALSE,0,0,"",6,20
2014,17,reg,Minnesota Vikings,Chicago Bears,MIN,13,9,4,7,22,47.5,FALSE,0,0,"",3,25.5
2014,17,reg,New England Patriots,Buffalo Bills,NE,9,17,8,4.5,26,43.5,FALSE,0,0,"",3.5,17.5
2014,17,reg,New York Giants,Philadelphia Eagles,PHI,26,34,8,1,60,52,FALSE,0,0,"",7,8
2014,17,reg,Pittsburgh Steelers,Cincinnati Bengals,PIT,27,17,10,3,44,48.5,FALSE,0,0,"",7,4.5
2014,17,reg,San Francisco 49ers,Arizona Cardinals,SF,20,17,3,6,37,37.5,FALSE,0,0,"",3,0.5
2014,17,reg,Seattle Seahawks,St. Louis Rams,SEA,20,6,14,11,26,41.5,FALSE,0,0,"",3,15.5
2014,17,reg,Tampa Bay Buccaneers,New Orleans Saints,NO,20,23,3,6,43,46.5,FALSE,0,0,"",3,3.5
2014,17,reg,Tennessee Titans,Indianapolis Colts,IND,10,27,17,7.5,37,46.5,FALSE,0,0,"",9.5,9.5
2014,17,reg,Washington Redskins,Dallas Cowboys,DAL,17,44,27,6,61,47.5,FALSE,0,0,"",21,13.5
2014,Wildcard,post,Carolina Panthers,Arizona Cardinals,CAR,27,16,11,5.5,43,37.5,FALSE,0,0,"",5.5,5.5
2014,Wildcard,post,Pittsburgh Steelers,Baltimore Ravens,PIT,17,30,13,3,47,45,FALSE,0,0,"",10,2
2014,Wildcard,post,Dallas Cowboys,Detroit Lions,DAL,24,20,4,6,44,48.5,FALSE,1,0,DOME,2,4.5
2014,Wildcard,post,Indianapolis Colts,Cincinnati Bengals,IND,26,10,16,3.5,36,48,FALSE,1,0,DOME,12.5,12
2014,Division,post,New England Patriots,Baltimore Ravens,NE,35,31,4,7,66,47.5,FALSE,0,0,"",3,18.5
2014,Division,post,Seattle Seahawks,Carolina Panthers,SEA,31,17,14,13.5,48,39.5,FALSE,0,0,"",0.5,8.5
2014,Division,post,Denver Broncos,Indianapolis Colts,DEN,13,24,11,9.5,37,53.5,FALSE,0,0,"",1.5,16.5
2014,Division,post,Green Bay Packers,Dallas Cowboys,GB,26,21,5,5.5,47,51.5,FALSE,0,0,"",0.5,4.5
2014,Conference,post,New England Patriots,Indianapolis Colts,NE,45,7,38,7,52,52,FALSE,0,0,"",31,0
2014,Conference,post,Seattle Seahawks,Green Bay Packers,SEA,28,22,6,8.5,50,45,FALSE,0,0,"",2.5,5
2014,Superbowl,post,New England Patriots,Seattle Seahawks,NE,28,24,4,1,52,47.5,TRUE,1,0,DOME,3,4.5
2015,1,reg,New England Patriots,Pittsburgh Steelers,NE,28,21,7,7,49,51,FALSE,0,1,Rain,0,2
2015,1,reg,Arizona Cardinals,New Orleans Saints,ARI,31,19,12,2.5,50,48.5,FALSE,1,0,DOME,9.5,1.5
2015,1,reg,Buffalo Bills,Indianapolis Colts,IND,27,14,13,1,41,44.5,FALSE,0,0,"",12,3.5
2015,1,reg,Chicago Bears,Green Bay Packers,GB,23,31,8,6.5,54,48.5,FALSE,0,0,"",1.5,5.5
2015,1,reg,Dallas Cowboys,New York Giants,DAL,27,26,1,7,53,52.5,FALSE,1,0,DOME,6,0.5
2015,1,reg,Denver Broncos,Baltimore Ravens,DEN,19,13,6,4.5,32,46.5,FALSE,0,0,"",1.5,14.5
2015,1,reg,Houston Texans,Kansas City Chiefs,KC,20,27,7,1,47,40.5,FALSE,0,0,DOME (Open Roof),6,6.5
2015,1,reg,Jacksonville Jaguars,Carolina Panthers,CAR,9,20,11,3,29,41,FALSE,0,0,"",8,12
2015,1,reg,New York Jets,Cleveland Browns,NYJ,31,10,21,3.5,41,38.5,FALSE,0,0,"",17.5,2.5
2015,1,reg,Oakland Raiders,Cincinnati Bengals,OAK,13,33,20,3,46,43,FALSE,0,0,"",17,3
2015,1,reg,San Diego Chargers,Detroit Lions,LAC,33,28,5,3.5,61,45.5,FALSE,0,0,"",1.5,15.5
2015,1,reg,St. Louis Rams,Seattle Seahawks,SEA,34,31,3,3.5,65,41,FALSE,1,0,DOME,0.5,24
2015,1,reg,Tampa Bay Buccaneers,Tennessee Titans,TB,14,42,28,3,56,40.5,FALSE,0,0,"",25,15.5
2015,1,reg,Washington Redskins,Miami Dolphins,MIA,10,17,7,4,27,45.5,FALSE,0,0,"",3,18.5
2015,1,reg,Atlanta Falcons,Philadelphia Eagles,PHI,26,24,2,3,50,56,FALSE,1,0,DOME,1,6
2015,1,reg,San Francisco 49ers,Minnesota Vikings,MIN,20,3,17,2.5,23,42.5,FALSE,0,0,"",14.5,19.5
2015,2,reg,Kansas City Chiefs,Denver Broncos,KC,24,31,7,3,55,42,FALSE,0,0,"",4,13
2015,2,reg,Buffalo Bills,New England Patriots,BUF,32,40,8,1,72,44.5,FALSE,0,0,"",7,27.5
2015,2,reg,Carolina Panthers,Houston Texans,CAR,24,17,7,3,41,41,FALSE,0,0,"",4,0
2015,2,reg,Chicago Bears,Arizona Cardinals,ARI,23,48,25,2,71,46,FALSE,0,0,"",23,25
2015,2,reg,Cincinnati Bengals,San Diego Chargers,CIN,24,19,5,3.5,43,48,FALSE,0,0,"",1.5,5
2015,2,reg,Cleveland Browns,Tennessee Titans,TEN,28,14,14,1,42,41,FALSE,0,0,"",13,1
2015,2,reg,Green Bay Packers,Seattle Seahawks,GB,27,17,10,3,44,49.5,FALSE,0,0,"",7,5.5
2015,2,reg,Jacksonville Jaguars,Miami Dolphins,MIA,23,20,3,6,43,42,FALSE,0,0,"",3,1
2015,2,reg,Minnesota Vikings,Detroit Lions,MIN,26,16,10,2.5,42,44,FALSE,0,0,"",7.5,2
2015,2,reg,New Orleans Saints,Tampa Bay Buccaneers,NO,19,26,7,9,45,47,FALSE,1,0,DOME,2,2
2015,2,reg,New York Giants,Atlanta Falcons,NYG,20,24,4,2,44,50,FALSE,0,0,"",2,6
2015,2,reg,Oakland Raiders,Baltimore Ravens,BAL,37,33,4,6,70,42,FALSE,0,0,"",2,28
2015,2,reg,Philadelphia Eagles,Dallas Cowboys,PHI,10,20,10,6.5,30,54,FALSE,0,0,"",3.5,24
2015,2,reg,Pittsburgh Steelers,San Francisco 49ers,PIT,43,18,25,6,61,46,FALSE,0,0,"",19,15
2015,2,reg,Washington Redskins,St. Louis Rams,LAR,24,10,14,3,34,41,FALSE,0,0,"",11,7
2015,2,reg,Indianapolis Colts,New York Jets,IND,7,20,13,6,27,46,FALSE,1,0,DOME,7,19
2015,3,reg,New York Giants,Washington Redskins,NYG,32,21,11,3,53,45,FALSE,0,0,"",8,8
2015,3,reg,Arizona Cardinals,San Francisco 49ers,ARI,47,7,40,7,54,45,FALSE,1,0,DOME,33,9
2015,3,reg,Baltimore Ravens,Cincinnati Bengals,BAL,24,28,4,1.5,52,45.5,FALSE,0,0,"",2.5,6.5
2015,3,reg,Carolina Panthers,New Orleans Saints,CAR,27,22,5,9.5,49,43,FALSE,0,0,"",4.5,6
2015,3,reg,Cleveland Browns,Oakland Raiders,CLE,20,27,7,3.5,47,44,FALSE,0,0,"",3.5,3
2015,3,reg,Dallas Cowboys,Atlanta Falcons,PICK,28,39,11,0,67,43.5,FALSE,1,0,DOME,11,23.5
2015,3,reg,Detroit Lions,Denver Broncos,DEN,12,24,12,3,36,45,FALSE,1,0,DOME,9,9
2015,3,reg,Houston Texans,Tampa Bay Buccaneers,HOU,19,9,10,6,28,41,FALSE,0,0,DOME (Open Roof),4,13
2015,3,reg,Miami Dolphins,Buffalo Bills,MIA,14,41,27,1,55,43.5,FALSE,0,0,"",26,11.5
2015,3,reg,Minnesota Vikings,San Diego Chargers,MIN,31,14,17,2,45,45.5,FALSE,0,0,"",15,0.5
2015,3,reg,New England Patriots,Jacksonville Jaguars,NE,51,17,34,14,68,49,FALSE,0,0,"",20,19
2015,3,reg,New York Jets,Philadelphia Eagles,NYJ,17,24,7,3,41,47,FALSE,0,0,"",4,6
2015,3,reg,Seattle Seahawks,Chicago Bears,SEA,26,0,26,16.5,26,43.5,FALSE,0,0,"",9.5,17.5
2015,3,reg,St. Louis Rams,Pittsburgh Steelers,LAR,6,12,6,1,18,48.5,FALSE,1,0,DOME,5,30.5
2015,3,reg,Tennessee Titans,Indianapolis Colts,IND,33,35,2,3.5,68,46.5,FALSE,0,0,"",1.5,21.5
2015,3,reg,Green Bay Packers,Kansas City Chiefs,GB,38,28,10,5.5,66,47.5,FALSE,0,0,"",4.5,18.5
2015,4,reg,Pittsburgh Steelers,Baltimore Ravens,BAL,20,23,3,3,43,44,FALSE,0,0,"",0,1
2015,4,reg,Arizona Cardinals,St. Louis Rams,ARI,22,24,2,7,46,43.5,FALSE,1,0,DOME,5,2.5
2015,4,reg,Atlanta Falcons,Houston Texans,ATL,48,21,27,4.5,69,47.5,FALSE,1,0,DOME,22.5,21.5
2015,4,reg,Buffalo Bills,New York Giants,BUF,10,24,14,6,34,46.5,FALSE,0,0,"",8,12.5
2015,4,reg,Chicago Bears,Oakland Raiders,OAK,22,20,2,3,42,44.5,FALSE,0,0,"",1,2.5
2015,4,reg,Cincinnati Bengals,Kansas City Chiefs,CIN,36,21,15,3.5,57,45,FALSE,0,0,"",11.5,12
2015,4,reg,Denver Broncos,Minnesota Vikings,DEN,23,20,3,7,43,43.5,FALSE,0,0,"",4,0.5
2015,4,reg,Indianapolis Colts,Jacksonville Jaguars,IND,16,13,3,4,29,43.5,FALSE,1,0,DOME,1,14.5
2015,4,reg,Miami Dolphins,New York Jets,NYJ,14,27,13,2.5,41,42.5,TRUE,0,0,"",10.5,1.5
2015,4,reg,New Orleans Saints,Dallas Cowboys,NO,26,20,6,3,46,48.5,FALSE,1,0,DOME,3,2.5
2015,4,reg,San Diego Chargers,Cleveland Browns,LAC,30,27,3,5,57,44.5,FALSE,0,0,"",2,12.5
2015,4,reg,San Francisco 49ers,Green Bay Packers,GB,3,17,14,7.5,20,48,FALSE,0,0,"",6.5,28
2015,4,reg,Tampa Bay Buccaneers,Carolina Panthers,CAR,23,37,14,3,60,40.5,FALSE,0,0,"",11,19.5
2015,4,reg,Washington Redskins,Philadelphia Eagles,PHI,23,20,3,3,43,45.5,FALSE,0,0,"",0,2.5
2015,4,reg,Seattle Seahawks,Detroit Lions,SEA,13,10,3,10,23,43,FALSE,0,0,"",7,20
2015,5,reg,Houston Texans,Indianapolis Colts,HOU,20,27,7,5,47,41,FALSE,0,0,DOME (Open Roof),2,6
2015,5,reg,Atlanta Falcons,Washington Redskins,ATL,25,19,6,7,44,48.5,FALSE,1,0,DOME,1,4.5
2015,5,reg,Baltimore Ravens,Cleveland Browns,BAL,30,33,3,6.5,63,43,FALSE,0,0,"",3.5,20
2015,5,reg,Cincinnati Bengals,Seattle Seahawks,CIN,27,24,3,3,51,44.5,FALSE,0,0,"",0,6.5
2015,5,reg,Dallas Cowboys,New England Patriots,NE,6,30,24,8.5,36,50.5,FALSE,1,0,DOME,15.5,14.5
2015,5,reg,Detroit Lions,Arizona Cardinals,ARI,17,42,25,4.5,59,46,FALSE,1,0,DOME,20.5,13
2015,5,reg,Green Bay Packers,St. Louis Rams,GB,24,10,14,9,34,46,FALSE,0,0,"",5,12
2015,5,reg,Kansas City Chiefs,Chicago Bears,KC,17,18,1,9.5,35,44.5,FALSE,0,0,"",8.5,9.5
2015,5,reg,New York Giants,San Francisco 49ers,NYG,30,27,3,7.5,57,44,FALSE,0,0,"",4.5,13
2015,5,reg,Oakland Raiders,Denver Broncos,DEN,10,16,6,5.5,26,45,FALSE,0,0,"",0.5,19
2015,5,reg,Philadelphia Eagles,New Orleans Saints,PHI,39,17,22,6.5,56,49.5,FALSE,0,0,"",15.5,6.5
2015,5,reg,Tampa Bay Buccaneers,Jacksonville Jaguars,TB,38,31,7,1,69,41.5,FALSE,0,0,"",6,27.5
2015,5,reg,Tennessee Titans,Buffalo Bills,BUF,13,14,1,1,27,43,FALSE,0,0,"",0,16
2015,5,reg,San Diego Chargers,Pittsburgh Steelers,LAC,20,24,4,4,44,45.5,FALSE,0,0,"",0,1.5
2015,6,reg,New Orleans Saints,Atlanta Falcons,ATL,31,21,10,3,52,52.5,FALSE,1,0,DOME,7,0.5
2015,6,reg,Buffalo Bills,Cincinnati Bengals,CIN,21,34,13,3,55,42,FALSE,0,0,"",10,13
2015,6,reg,Cleveland Browns,Denver Broncos,DEN,23,26,3,3.5,49,42,FALSE,0,0,"",0.5,7
2015,6,reg,Detroit Lions,Chicago Bears,DET,37,34,3,3.5,71,45.5,FALSE,1,0,DOME,0.5,25.5
2015,6,reg,Green Bay Packers,San Diego Chargers,GB,27,20,7,10.5,47,50.5,FALSE,0,0,"",3.5,3.5
2015,6,reg,Indianapolis Colts,New England Patriots,NE,27,34,7,9,61,54,FALSE,1,0,DOME,2,7
2015,6,reg,Jacksonville Jaguars,Houston Texans,JAX,20,31,11,3,51,43,FALSE,0,0,"",8,8
2015,6,reg,Minnesota Vikings,Kansas City Chiefs,MIN,16,10,6,3.5,26,43,FALSE,0,0,"",2.5,17
2015,6,reg,New York Jets,Washington Redskins,NYJ,34,20,14,7.5,54,40,FALSE,0,0,"",6.5,14
2015,6,reg,Pittsburgh Steelers,Arizona Cardinals,ARI,25,13,12,5.5,38,45,FALSE,0,0,"",6.5,7
2015,6,reg,San Francisco 49ers,Baltimore Ravens,BAL,25,20,5,2.5,45,43.5,FALSE,0,0,"",2.5,1.5
2015,6,reg,Seattle Seahawks,Carolina Panthers,SEA,23,27,4,7,50,41,FALSE,0,0,"",3,9
2015,6,reg,Tennessee Titans,Miami Dolphins,TEN,10,38,28,2.5,48,43.5,FALSE,0,0,"",25.5,4.5
2015,6,reg,Philadelphia Eagles,New York Giants,PHI,27,7,20,3.5,34,50.5,FALSE,0,0,"",16.5,16.5
2015,7,reg,San Francisco 49ers,Seattle Seahawks,SEA,3,20,17,6.5,23,42,FALSE,0,0,"",10.5,19
2015,7,reg,Carolina Panthers,Philadelphia Eagles,CAR,27,16,11,2.5,43,46,FALSE,0,0,"",8.5,3
2015,7,reg,Detroit Lions,Minnesota Vikings,DET,19,28,9,1,47,45,FALSE,1,0,DOME,8,2
2015,7,reg,Indianapolis Colts,New Orleans Saints,IND,21,27,6,5,48,53,FALSE,1,0,DOME,1,5
2015,7,reg,Jacksonville Jaguars,Buffalo Bills,BUF,34,31,3,3.5,65,41.5,TRUE,0,0,"",0.5,23.5
2015,7,reg,Kansas City Chiefs,Pittsburgh Steelers,KC,23,13,10,3.5,36,41.5,FALSE,0,0,"",6.5,5.5
2015,7,reg,Miami Dolphins,Houston Texans,MIA,44,26,18,4.5,70,45.5,FALSE,0,0,"",13.5,24.5
2015,7,reg,New England Patriots,New York Jets,NE,30,23,7,7,53,47.5,FALSE,0,0,"",0,5.5
2015,7,reg,New York Giants,Dallas Cowboys,NYG,27,20,7,3,47,44.5,FALSE,0,0,"",4,2.5
2015,7,reg,San Diego Chargers,Oakland Raiders,LAC,29,37,8,3.5,66,48.5,FALSE,0,0,"",4.5,17.5
2015,7,reg,St. Louis Rams,Cleveland Browns,LAR,24,6,18,6,30,44,FALSE,1,0,DOME,12,14
2015,7,reg,Tennessee Titans,Atlanta Falcons,ATL,7,10,3,6,17,45.5,FALSE,0,0,"",3,28.5
2015,7,reg,Washington Redskins,Tampa Bay Buccaneers,WAS,31,30,1,3,61,41.5,FALSE,0,0,"",2,19.5
2015,7,reg,Arizona Cardinals,Baltimore Ravens,ARI,26,18,8,10,44,49.5,FALSE,1,0,DOME,2,5.5
2015,8,reg,New England Patriots,Miami Dolphins,NE,36,7,29,8,43,51.5,FALSE,0,0,"",21,8.5
2015,8,reg,Atlanta Falcons,Tampa Bay Buccaneers,ATL,20,23,3,8,43,47.5,FALSE,1,0,DOME,5,4.5
2015,8,reg,Baltimore Ravens,San Diego Chargers,BAL,29,26,3,4.5,55,50.5,FALSE,0,0,"",1.5,4.5
2015,8,reg,Chicago Bears,Minnesota Vikings,MIN,20,23,3,1.5,43,44,FALSE,0,0,"",1.5,1
2015,8,reg,Cleveland Browns,Arizona Cardinals,ARI,20,34,14,7,54,46,FALSE,0,0,"",7,8
2015,8,reg,Dallas Cowboys,Seattle Seahawks,SEA,12,13,1,5,25,41.5,FALSE,1,0,DOME,4,16.5
2015,8,reg,Denver Broncos,Green Bay Packers,GB,29,10,19,2.5,39,45.5,FALSE,0,0,"",16.5,6.5
2015,8,reg,Houston Texans,Tennessee Titans,HOU,20,6,14,3.5,26,43,FALSE,0,0,DOME (Open Roof),10.5,17
2015,8,reg,Kansas City Chiefs,Detroit Lions,DET,45,10,35,3,55,45,TRUE,0,0,"",32,10
2015,8,reg,New Orleans Saints,New York Giants,NO,52,49,3,3,101,52,FALSE,1,0,DOME,0,49
2015,8,reg,Oakland Raiders,New York Jets,NYJ,34,20,14,3,54,44,FALSE,0,0,"",11,10
2015,8,reg,Pittsburgh Steelers,Cincinnati Bengals,PICK,10,16,6,0,26,49.5,FALSE,0,0,"",6,23.5
2015,8,reg,St. Louis Rams,San Francisco 49ers,LAR,27,6,21,8,33,41,FALSE,1,0,DOME,13,8
2015,8,reg,Carolina Panthers,Indianapolis Colts,CAR,29,26,3,5.5,55,45.5,FALSE,0,1,Rain,2.5,9.5
2015,9,reg,Cincinnati Bengals,Cleveland Browns,CIN,31,10,21,13,41,46,FALSE,0,0,"",8,5
2015,9,reg,Buffalo Bills,Miami Dolphins,BUF,33,17,16,4,50,44,FALSE,0,0,"",12,6
2015,9,reg,Carolina Panthers,Green Bay Packers,GB,37,29,8,2.5,66,46,FALSE,0,0,"",5.5,20
2015,9,reg,Dallas Cowboys,Philadelphia Eagles,PHI,27,33,6,3,60,44,FALSE,1,0,DOME,3,16
2015,9,reg,Indianapolis Colts,Denver Broncos,DEN,27,24,3,3.5,51,45.5,FALSE,1,0,DOME,0.5,5.5
2015,9,reg,Minnesota Vikings,St. Louis Rams,MIN,21,18,3,1,39,40,FALSE,0,0,"",2,1
2015,9,reg,New England Patriots,Washington Redskins,NE,27,10,17,13.5,37,51.5,FALSE,0,0,"",3.5,14.5
2015,9,reg,New Orleans Saints,Tennessee Titans,NO,28,34,6,6.5,62,50,FALSE,1,0,DOME,0.5,12
2015,9,reg,New York Jets,Jacksonville Jaguars,NYJ,28,23,5,8,51,42.5,FALSE,0,0,"",3,8.5
2015,9,reg,Pittsburgh Steelers,Oakland Raiders,PIT,38,35,3,6,73,48,FALSE,0,0,"",3,25
2015,9,reg,San Francisco 49ers,Atlanta Falcons,ATL,17,16,1,8.5,33,43.5,FALSE,0,0,"",7.5,10.5
2015,9,reg,Tampa Bay Buccaneers,New York Giants,NYG,18,32,14,2,50,49,FALSE,0,0,"",12,1
2015,9,reg,San Diego Chargers,Chicago Bears,LAC,19,22,3,3.5,41,49.5,FALSE,0,0,"",0.5,8.5
2015,10,reg,New York Jets,Buffalo Bills,NYJ,17,22,5,2.5,39,42,FALSE,0,0,"",2.5,3
2015,10,reg,Baltimore Ravens,Jacksonville Jaguars,BAL,20,22,2,5,42,47,FALSE,0,0,"",3,5
2015,10,reg,Denver Broncos,Kansas City Chiefs,DEN,13,29,16,3.5,42,42,FALSE,0,0,"",12.5,0
2015,10,reg,Green Bay Packers,Detroit Lions,GB,16,18,2,10.5,34,50,FALSE,0,0,"",8.5,16
2015,10,reg,New York Giants,New England Patriots,NE,26,27,1,7,53,52.5,FALSE,0,0,"",6,0.5
2015,10,reg,Oakland Raiders,Minnesota Vikings,OAK,14,30,16,3,44,44,FALSE,0,0,"",13,0
2015,10,reg,Philadelphia Eagles,Miami Dolphins,PHI,19,20,1,6,39,49.5,FALSE,0,0,"",5,10.5
2015,10,reg,Pittsburgh Steelers,Cleveland Browns,PIT,30,9,21,7,39,43,FALSE,0,0,"",14,4
2015,10,reg,Seattle Seahawks,Arizona Cardinals,SEA,32,39,7,3,71,43.5,FALSE,0,0,"",4,27.5
2015,10,reg,St. Louis Rams,Chicago Bears,LAR,13,37,24,7,50,42.5,FALSE,1,0,DOME,17,7.5
2015,10,reg,Tampa Bay Buccaneers,Dallas Cowboys,DAL,10,6,4,1,16,43.5,FALSE,0,0,"",3,27.5
2015,10,reg,Tennessee Titans,Carolina Panthers,CAR,10,27,17,3.5,37,43,FALSE,0,0,"",13.5,6
2015,10,reg,Washington Redskins,New Orleans Saints,NO,47,14,33,1,61,52,FALSE,0,0,"",32,9
2015,10,reg,Cincinnati Bengals,Houston Texans,CIN,6,10,4,10,16,46.5,FALSE,0,0,"",6,30.5
2015,11,reg,Jacksonville Jaguars,Tennessee Titans,JAX,19,13,6,3,32,41.5,FALSE,0,0,"",3,9.5
2015,11,reg,Arizona Cardinals,Cincinnati Bengals,ARI,34,31,3,4,65,48,FALSE,1,0,DOME,1,17
2015,11,reg,Atlanta Falcons,Indianapolis Colts,ATL,21,24,3,3.5,45,47.5,FALSE,1,0,DOME,0.5,2.5
2015,11,reg,Baltimore Ravens,St. Louis Rams,BAL,16,13,3,3,29,41.5,FALSE,0,0,"",0,12.5
2015,11,reg,Carolina Panthers,Washington Redskins,CAR,44,16,28,7,60,44.5,FALSE,0,0,"",21,15.5
2015,11,reg,Chicago Bears,Denver Broncos,DEN,15,17,2,2,32,41.5,FALSE,0,0,"",0,9.5
2015,11,reg,Detroit Lions,Oakland Raiders,OAK,18,13,5,1.5,31,50,FALSE,1,0,DOME,3.5,19
2015,11,reg,Houston Texans,New York Jets,NYJ,24,17,7,4,41,40,FALSE,0,0,DOME (Open Roof),3,1
2015,11,reg,Miami Dolphins,Dallas Cowboys,DAL,14,24,10,2,38,45,FALSE,0,0,"",8,7
2015,11,reg,Minnesota Vikings,Green Bay Packers,PICK,13,30,17,0,43,45,FALSE,0,0,"",17,2
2015,11,reg,Philadelphia Eagles,Tampa Bay Buccaneers,PHI,17,45,28,6.5,62,45.5,FALSE,0,0,"",21.5,16.5
2015,11,reg,San Diego Chargers,Kansas City Chiefs,KC,3,33,30,3,36,45.5,FALSE,0,0,"",27,9.5
2015,11,reg,Seattle Seahawks,San Francisco 49ers,SEA,29,13,16,14,42,40,FALSE,0,0,"",2,2
2015,11,reg,New England Patriots,Buffalo Bills,NE,20,13,7,7,33,47.5,FALSE,0,0,"",0,14.5
2015,12,reg,Dallas Cowboys,Carolina Panthers,CAR,14,33,19,1,47,44.5,FALSE,1,0,DOME,18,2.5
2015,12,reg,Detroit Lions,Philadelphia Eagles,DET,45,14,31,3,59,47,FALSE,1,0,DOME,28,12
2015,12,reg,Green Bay Packers,Chicago Bears,GB,13,17,4,8,30,45,FALSE,0,1,Rain,4,15
2015,12,reg,Atlanta Falcons,Minnesota Vikings,ATL,10,20,10,2,30,45,FALSE,1,0,DOME,8,15
2015,12,reg,Cincinnati Bengals,St. Louis Rams,CIN,31,7,24,9.5,38,42,FALSE,0,0,"",14.5,4
2015,12,reg,Denver Broncos,New England Patriots,NE,30,24,6,2.5,54,43,FALSE,0,1,Snow,3.5,11
2015,12,reg,Houston Texans,New Orleans Saints,HOU,24,6,18,3.5,30,51,FALSE,0,0,DOME (Open Roof),14.5,21
2015,12,reg,Indianapolis Colts,Tampa Bay Buccaneers,IND,25,12,13,3,37,46.5,FALSE,1,0,DOME,10,9.5
2015,12,reg,Jacksonville Jaguars,San Diego Chargers,JAX,25,31,6,5,56,47,FALSE,0,0,"",1,9
2015,12,reg,Kansas City Chiefs,Buffalo Bills,KC,30,22,8,4.5,52,41,FALSE,0,1,Rain,3.5,11
2015,12,reg,New York Jets,Miami Dolphins,NYJ,38,20,18,4.5,58,43.5,FALSE,0,0,"",13.5,14.5
2015,12,reg,San Francisco 49ers,Arizona Cardinals,ARI,13,19,6,8.5,32,45,FALSE,0,0,"",2.5,13
2015,12,reg,Seattle Seahawks,Pittsburgh Steelers,SEA,39,30,9,3,69,46.5,FALSE,0,0,"",6,22.5
2015,12,reg,Tennessee Titans,Oakland Raiders,OAK,21,24,3,1,45,45,FALSE,0,0,"",2,0
2015,12,reg,Washington Redskins,New York Giants,NYG,20,14,6,1.5,34,48,FALSE,0,0,"",4.5,14
2015,12,reg,Cleveland Browns,Baltimore Ravens,CLE,27,33,6,6,60,41,FALSE,0,0,"",0,19
2015,13,reg,Detroit Lions,Green Bay Packers,GB,23,27,4,2.5,50,46.5,FALSE,1,0,DOME,1.5,3.5
2015,13,reg,Buffalo Bills,Houston Texans,BUF,30,21,9,3,51,42,FALSE,0,0,"",6,9
2015,13,reg,Chicago Bears,San Francisco 49ers,CHI,20,26,6,6.5,46,43,FALSE,0,0,"",0.5,3
2015,13,reg,Cleveland Browns,Cincinnati Bengals,CIN,3,37,34,7.5,40,44,FALSE,0,0,"",26.5,4
2015,13,reg,Miami Dolphins,Baltimore Ravens,MIA,15,13,2,3.5,28,43,FALSE,0,0,"",1.5,15
2015,13,reg,Minnesota Vikings,Seattle Seahawks,SEA,7,38,31,2.5,45,43,FALSE,0,0,"",28.5,2
2015,13,reg,New England Patriots,Philadelphia Eagles,NE,28,35,7,9.5,63,49,FALSE,0,0,"",2.5,14
2015,13,reg,New Orleans Saints,Carolina Panthers,CAR,38,41,3,6,79,50.5,FALSE,1,0,DOME,3,28.5
2015,13,reg,New York Giants,New York Jets,NYJ,20,23,3,2.5,43,46,FALSE,0,0,"",0.5,3
2015,13,reg,Oakland Raiders,Kansas City Chiefs,KC,20,34,14,3,54,45.5,FALSE,0,0,"",11,8.5
2015,13,reg,Pittsburgh Steelers,Indianapolis Colts,PIT,45,10,35,9.5,55,50.5,FALSE,0,0,"",25.5,4.5
2015,13,reg,San Diego Chargers,Denver Broncos,DEN,3,17,14,6,20,45,FALSE,0,0,"",8,25
2015,13,reg,St. Louis Rams,Arizona Cardinals,ARI,3,27,24,3.5,30,43,FALSE,1,0,DOME,20.5,13
2015,13,reg,Tampa Bay Buccaneers,Atlanta Falcons,PICK,23,19,4,0,42,46.5,FALSE,0,0,"",4,4.5
2015,13,reg,Tennessee Titans,Jacksonville Jaguars,TEN,42,39,3,3,81,43.5,FALSE,0,0,"",0,37.5
2015,13,reg,Washington Redskins,Dallas Cowboys,WAS,16,19,3,2,35,43.5,FALSE,0,0,"",1,8.5
2015,14,reg,Arizona Cardinals,Minnesota Vikings,ARI,23,20,3,10,43,46.5,FALSE,1,0,DOME,7,3.5
2015,14,reg,Baltimore Ravens,Seattle Seahawks,SEA,6,35,29,10.5,41,42,FALSE,0,0,"",18.5,1
2015,14,reg,Carolina Panthers,Atlanta Falcons,CAR,38,0,38,8.5,38,45.5,FALSE,0,0,"",29.5,7.5
2015,14,reg,Chicago Bears,Washington Redskins,CHI,21,24,3,4,45,43.5,FALSE,0,0,"",1,1.5
2015,14,reg,Cincinnati Bengals,Pittsburgh Steelers,CIN,20,33,13,1,53,48.5,FALSE,0,0,"",12,4.5
2015,14,reg,Cleveland Browns,San Francisco 49ers,CLE,24,10,14,2.5,34,43,FALSE,0,0,"",11.5,9
2015,14,reg,Denver Broncos,Oakland Raiders,DEN,12,15,3,6,27,43,FALSE,0,0,"",3,16
2015,14,reg,Green Bay Packers,Dallas Cowboys,GB,28,7,21,6.5,35,42.5,FALSE,0,1,Rain,14.5,7.5
2015,14,reg,Houston Texans,New England Patriots,NE,6,27,21,5,33,46.5,FALSE,0,0,DOME (Open Roof),16,13.5
2015,14,reg,Jacksonville Jaguars,Indianapolis Colts,JAX,51,16,35,1,67,46,FALSE,0,0,"",34,21
2015,14,reg,Kansas City Chiefs,San Diego Chargers,KC,10,3,7,12,13,41.5,FALSE,0,1,Rain,5,28.5
2015,14,reg,New York Jets,Tennessee Titans,NYJ,30,8,22,8,38,43,FALSE,0,0,"",14,5
2015,14,reg,Philadelphia Eagles,Buffalo Bills,PHI,23,20,3,1,43,48.5,FALSE,0,0,"",2,5.5
2015,14,reg,St. Louis Rams,Detroit Lions,DET,21,14,7,3,35,41.5,FALSE,1,0,DOME,4,6.5
2015,14,reg,Tampa Bay Buccaneers,New Orleans Saints,TB,17,24,7,6,41,51.5,FALSE,0,0,"",1,10.5
2015,14,reg,Miami Dolphins,New York Giants,NYG,24,31,7,2,55,48,FALSE,0,0,"",5,7
2015,15,reg,St. Louis Rams,Tampa Bay Buccaneers,LAR,31,23,8,1,54,41,FALSE,1,0,DOME,7,13
2015,15,reg,Dallas Cowboys,New York Jets,NYJ,16,19,3,3.5,35,41,FALSE,1,0,DOME,0.5,6
2015,15,reg,Baltimore Ravens,Kansas City Chiefs,KC,14,34,20,6.5,48,41,FALSE,0,0,"",13.5,7
2015,15,reg,Indianapolis Colts,Houston Texans,IND,10,16,6,2,26,41.5,FALSE,1,0,DOME,4,15.5
2015,15,reg,Jacksonville Jaguars,Atlanta Falcons,JAX,17,23,6,2,40,48,FALSE,0,0,"",4,8
2015,15,reg,Minnesota Vikings,Chicago Bears,MIN,38,17,21,4,55,44,FALSE,0,0,"",17,11
2015,15,reg,New England Patriots,Tennessee Titans,NE,33,16,17,14.5,49,48,FALSE,0,0,"",2.5,1
2015,15,reg,New York Giants,Carolina Panthers,CAR,35,38,3,5,73,46.5,FALSE,0,0,"",2,26.5
2015,15,reg,Oakland Raiders,Green Bay Packers,GB,20,30,10,4,50,47,FALSE,0,0,"",6,3
2015,15,reg,Philadelphia Eagles,Arizona Cardinals,ARI,17,40,23,4,57,51.5,FALSE,0,0,"",19,5.5
2015,15,reg,Pittsburgh Steelers,Denver Broncos,PIT,34,27,7,7.5,61,45.5,FALSE,0,0,"",0.5,15.5
2015,15,reg,San Diego Chargers,Miami Dolphins,LAC,30,14,16,1,44,47,FALSE,0,0,"",15,3
2015,15,reg,San Francisco 49ers,Cincinnati Bengals,CIN,14,24,10,6.5,38,41,FALSE,0,0,"",3.5,3
2015,15,reg,Seattle Seahawks,Cleveland Browns,SEA,30,13,17,14.5,43,45.5,FALSE,0,0,"",2.5,2.5
2015,15,reg,Washington Redskins,Buffalo Bills,BUF,35,25,10,2,60,46,FALSE,0,0,"",8,14
2015,15,reg,New Orleans Saints,Detroit Lions,NO,27,35,8,2.5,62,52,FALSE,1,0,DOME,5.5,10
2015,16,reg,Oakland Raiders,San Diego Chargers,OAK,23,20,3,4,43,45.5,FALSE,0,0,"",1,2.5
2015,16,reg,Philadelphia Eagles,Washington Redskins,PHI,24,38,14,3.5,62,48.5,FALSE,0,0,"",10.5,13.5
2015,16,reg,Arizona Cardinals,Green Bay Packers,ARI,38,8,30,6,46,50.5,FALSE,1,0,DOME,24,4.5
2015,16,reg,Atlanta Falcons,Carolina Panthers,CAR,20,13,7,7,33,46,FALSE,1,0,DOME,0,13
2015,16,reg,Baltimore Ravens,Pittsburgh Steelers,PIT,20,17,3,11.5,37,47.5,FALSE,0,0,"",8.5,10.5
2015,16,reg,Buffalo Bills,Dallas Cowboys,BUF,16,6,10,6.5,22,42,FALSE,0,0,"",3.5,20
2015,16,reg,Detroit Lions,San Francisco 49ers,DET,32,17,15,9,49,42.5,FALSE,1,0,DOME,6,6.5
2015,16,reg,Kansas City Chiefs,Cleveland Browns,KC,17,13,4,11.5,30,42.5,FALSE,0,0,"",7.5,12.5
2015,16,reg,Miami Dolphins,Indianapolis Colts,MIA,12,18,6,2.5,30,44,FALSE,0,0,"",3.5,14
2015,16,reg,Minnesota Vikings,New York Giants,MIN,49,17,32,7,66,44.5,FALSE,0,0,"",25,21.5
2015,16,reg,New Orleans Saints,Jacksonville Jaguars,NO,38,27,11,2.5,65,53.5,FALSE,1,0,DOME,8.5,11.5
2015,16,reg,New York Jets,New England Patriots,NE,26,20,6,2.5,46,45.5,FALSE,0,0,"",3.5,0.5
2015,16,reg,Seattle Seahawks,St. Louis Rams,SEA,17,23,6,11,40,42,FALSE,0,1,Rain,5,2
2015,16,reg,Tampa Bay Buccaneers,Chicago Bears,TB,21,26,5,3,47,44,FALSE,0,0,"",2,3
2015,16,reg,Tennessee Titans,Houston Texans,HOU,6,34,28,3.5,40,39,FALSE,0,0,"",24.5,1
2015,16,reg,Denver Broncos,Cincinnati Bengals,DEN,20,17,3,4,37,39,FALSE,0,0,"",1,2
2015,17,reg,Arizona Cardinals,Seattle Seahawks,ARI,6,36,30,6,42,47,FALSE,1,0,DOME,24,5
2015,17,reg,Atlanta Falcons,New Orleans Saints,ATL,17,20,3,6,37,53.5,FALSE,1,0,DOME,3,16.5
2015,17,reg,Buffalo Bills,New York Jets,NYJ,22,17,5,3,39,41,FALSE,0,0,"",2,2
2015,17,reg,Carolina Panthers,Tampa Bay Buccaneers,CAR,38,10,28,10,48,45,FALSE,0,0,"",18,3
2015,17,reg,Chicago Bears,Detroit Lions,DET,20,24,4,2.5,44,45,FALSE,0,0,"",1.5,1
2015,17,reg,Cincinnati Bengals,Baltimore Ravens,CIN,24,16,8,9.5,40,41,FALSE,0,0,"",1.5,1
2015,17,reg,Cleveland Browns,Pittsburgh Steelers,PIT,12,28,16,13,40,47,FALSE,0,0,"",3,7
2015,17,reg,Dallas Cowboys,Washington Redskins,DAL,23,34,11,3,57,41,FALSE,1,0,DOME,8,16
2015,17,reg,Denver Broncos,San Diego Chargers,DEN,27,20,7,10,47,42,FALSE,0,0,"",3,5
2015,17,reg,Green Bay Packers,Minnesota Vikings,GB,13,20,7,3,33,44,FALSE,0,0,"",4,11
2015,17,reg,Houston Texans,Jacksonville Jaguars,HOU,30,6,24,6,36,45,FALSE,0,0,DOME (Open Roof),18,9
2015,17,reg,Indianapolis Colts,Tennessee Titans,IND,30,24,6,4,54,39,FALSE,1,0,DOME,2,15
2015,17,reg,Kansas City Chiefs,Oakland Raiders,KC,23,17,6,6.5,40,43.5,FALSE,0,0,"",0.5,3.5
2015,17,reg,Miami Dolphins,New England Patriots,NE,20,10,10,10,30,46.5,FALSE,0,0,"",0,16.5
2015,17,reg,New York Giants,Philadelphia Eagles,NYG,30,35,5,3.5,65,51,FALSE,0,0,"",1.5,14
2015,17,reg,San Francisco 49ers,St. Louis Rams,LAR,19,16,3,3,35,38.5,FALSE,0,0,"",0,3.5
2015,Wildcard,post,Cincinnati Bengals,Pittsburgh Steelers,PIT,16,18,2,3,34,45,FALSE,0,0,"",1,11
2015,Wildcard,post,Houston Texans,Kansas City Chiefs,KC,0,30,30,3,30,40,FALSE,1,0,DOME,27,10
2015,Wildcard,post,Minnesota Vikings,Seattle Seahawks,SEA,9,10,1,4.5,19,40,FALSE,0,0,"",3.5,21
2015,Wildcard,post,Washington Redskins,Green Bay Packers,WAS,18,35,17,1,53,46,FALSE,0,0,"",16,7
2015,Division,post,Arizona Cardinals,Green Bay Packers,ARI,26,20,6,7,46,49,FALSE,1,0,DOME,1,3
2015,Division,post,New England Patriots,Kansas City Chiefs,NE,27,20,7,4.5,47,43,FALSE,0,0,"",2.5,4
2015,Division,post,Carolina Panthers,Seattle Seahawks,CAR,31,24,7,2.5,55,44,FALSE,0,0,"",4.5,11
2015,Division,post,Denver Broncos,Pittsburgh Steelers,DEN,23,16,7,7.5,39,41,FALSE,0,0,"",0.5,2
2015,Conference,post,Carolina Panthers,Arizona Cardinals,CAR,49,15,34,3,64,47.5,FALSE,0,0,"",31,16.5
2015,Conference,post,Denver Broncos,New England Patriots,NE,20,18,2,3,38,44.5,FALSE,0,0,"",1,6.5
2015,Superbowl,post,Denver Broncos,Carolina Panthers,CAR,24,10,14,4.5,34,43,TRUE,0,0,"",9.5,9
2016,1,reg,Denver Broncos,Carolina Panthers,CAR,21,20,1,3,41,40.5,FALSE,0,0,"",2,0.5
2016,1,reg,Arizona Cardinals,New England Patriots,ARI,21,23,2,8.5,44,44,FALSE,1,0,DOME,6.5,0
2016,1,reg,Atlanta Falcons,Tampa Bay Buccaneers,ATL,24,31,7,2.5,55,47,FALSE,1,0,DOME,4.5,8
2016,1,reg,Baltimore Ravens,Buffalo Bills,BAL,13,7,6,3,20,44.5,FALSE,0,0,"",3,24.5
2016,1,reg,Dallas Cowboys,New York Giants,NYG,19,20,1,1,39,47.5,FALSE,1,0,DOME,0,8.5
2016,1,reg,Houston Texans,Chicago Bears,HOU,23,14,9,5.5,37,42.5,FALSE,0,0,DOME (Open Roof),3.5,5.5
2016,1,reg,Indianapolis Colts,Detroit Lions,IND,35,39,4,2.5,74,51.5,FALSE,1,0,DOME,1.5,22.5
2016,1,reg,Jacksonville Jaguars,Green Bay Packers,GB,23,27,4,3.5,50,47.5,FALSE,0,0,"",0.5,2.5
2016,1,reg,Kansas City Chiefs,San Diego Chargers,KC,33,27,6,6.5,60,46,FALSE,0,0,"",0.5,14
2016,1,reg,New Orleans Saints,Oakland Raiders,NO,34,35,1,3,69,50.5,FALSE,1,0,DOME,2,18.5
2016,1,reg,New York Jets,Cincinnati Bengals,CIN,22,23,1,1,45,42,FALSE,0,0,"",0,3
2016,1,reg,Philadelphia Eagles,Cleveland Browns,PHI,29,10,19,3.5,39,41,FALSE,0,0,"",15.5,2
2016,1,reg,Seattle Seahawks,Miami Dolphins,SEA,12,10,2,10.5,22,44,FALSE,0,0,"",8.5,22
2016,1,reg,Tennessee Titans,Minnesota Vikings,MIN,16,25,9,2.5,41,40,FALSE,0,0,"",6.5,1
2016,1,reg,San Francisco 49ers,Los Angeles Rams,LAR,28,0,28,2.5,28,43.5,FALSE,0,0,"",25.5,15.5
2016,1,reg,Washington Redskins,Pittsburgh Steelers,PIT,16,38,22,2.5,54,49,FALSE,0,0,"",19.5,5
2016,2,reg,Buffalo Bills,New York Jets,PICK,31,37,6,0,68,40.5,FALSE,0,0,"",6,27.5
2016,2,reg,Arizona Cardinals,Tampa Bay Buccaneers,ARI,40,7,33,7,47,49.5,FALSE,1,0,DOME,26,2.5
2016,2,reg,Carolina Panthers,San Francisco 49ers,CAR,46,27,19,12.5,73,44,FALSE,0,0,"",6.5,29
2016,2,reg,Cleveland Browns,Baltimore Ravens,BAL,20,25,5,4.5,45,42,FALSE,0,0,"",0.5,3
2016,2,reg,Denver Broncos,Indianapolis Colts,DEN,34,20,14,6,54,47,FALSE,0,0,"",8,7
2016,2,reg,Detroit Lions,Tennessee Titans,DET,15,16,1,6,31,48,FALSE,1,0,DOME,5,17
2016,2,reg,Houston Texans,Kansas City Chiefs,HOU,19,12,7,1,31,42,FALSE,0,0,DOME (Open Roof),6,11
2016,2,reg,Los Angeles Rams,Seattle Seahawks,SEA,9,3,6,5.5,12,38,FALSE,0,0,"",0.5,26
2016,2,reg,Minnesota Vikings,Green Bay Packers,GB,17,14,3,2,31,43,FALSE,1,0,DOME,1,12
2016,2,reg,New England Patriots,Miami Dolphins,NE,31,24,7,5.5,55,42,FALSE,0,0,"",1.5,13
2016,2,reg,New York Giants,New Orleans Saints,NYG,16,13,3,4,29,54.5,FALSE,0,0,"",1,25.5
2016,2,reg,Oakland Raiders,Atlanta Falcons,OAK,28,35,7,4,63,48,FALSE,0,0,"",3,15
2016,2,reg,Pittsburgh Steelers,Cincinnati Bengals,PIT,24,16,8,3,40,48,FALSE,0,0,"",5,8
2016,2,reg,San Diego Chargers,Jacksonville Jaguars,LAC,38,14,24,3,52,47.5,FALSE,0,0,"",21,4.5
2016,2,reg,Washington Redskins,Dallas Cowboys,WAS,23,27,4,3,50,47,FALSE,0,0,"",1,3
2016,2,reg,Chicago Bears,Philadelphia Eagles,CHI,14,29,15,3,43,43,FALSE,0,0,"",12,0
2016,3,reg,New England Patriots,Houston Texans,NE,27,0,27,1,27,38.5,FALSE,0,0,"",26,11.5
2016,3,reg,Buffalo Bills,Arizona Cardinals,ARI,33,18,15,5,51,48,FALSE,0,0,"",10,3
2016,3,reg,Carolina Panthers,Minnesota Vikings,CAR,10,22,12,6.5,32,42.5,FALSE,0,0,"",5.5,10.5
2016,3,reg,Cincinnati Bengals,Denver Broncos,CIN,17,29,12,3.5,46,41.5,FALSE,0,0,"",8.5,4.5
2016,3,reg,Dallas Cowboys,Chicago Bears,DAL,31,17,14,6.5,48,45,FALSE,1,0,DOME,7.5,3
2016,3,reg,Green Bay Packers,Detroit Lions,GB,34,27,7,6.5,61,47.5,FALSE,0,0,"",0.5,13.5
2016,3,reg,Indianapolis Colts,San Diego Chargers,IND,26,22,4,1.5,48,51.5,FALSE,1,0,DOME,2.5,3.5
2016,3,reg,Jacksonville Jaguars,Baltimore Ravens,BAL,17,19,2,2,36,45,FALSE,0,0,"",0,9
2016,3,reg,Kansas City Chiefs,New York Jets,KC,24,3,21,3,27,44.5,FALSE,0,0,"",18,17.5
2016,3,reg,Miami Dolphins,Cleveland Browns,MIA,30,24,6,10,54,42.5,FALSE,0,0,"",4,11.5
2016,3,reg,New York Giants,Washington Redskins,NYG,27,29,2,3.5,56,47,FALSE,0,0,"",1.5,9
2016,3,reg,Philadelphia Eagles,Pittsburgh Steelers,PIT,34,3,31,4,37,46.5,FALSE,0,0,"",27,9.5
2016,3,reg,Seattle Seahawks,San Francisco 49ers,SEA,37,18,19,10.5,55,41.5,FALSE,0,0,"",8.5,13.5
2016,3,reg,Tampa Bay Buccaneers,Los Angeles Rams,TB,32,37,5,3.5,69,40.5,FALSE,0,0,"",1.5,28.5
2016,3,reg,Tennessee Titans,Oakland Raiders,OAK,10,17,7,1.5,27,47,FALSE,0,0,"",5.5,20
2016,3,reg,New Orleans Saints,Atlanta Falcons,NO,32,45,13,3,77,54.5,FALSE,1,0,DOME,10,22.5
2016,4,reg,Cincinnati Bengals,Miami Dolphins,CIN,22,7,15,7.5,29,46.5,FALSE,0,0,"",7.5,17.5
2016,4,reg,Arizona Cardinals,Los Angeles Rams,ARI,13,17,4,10,30,43.5,FALSE,1,0,DOME,6,13.5
2016,4,reg,Atlanta Falcons,Carolina Panthers,CAR,48,33,15,3,81,48.5,FALSE,1,0,DOME,12,32.5
2016,4,reg,Baltimore Ravens,Oakland Raiders,BAL,27,28,1,3.5,55,45,FALSE,0,0,"",2.5,10
2016,4,reg,Chicago Bears,Detroit Lions,DET,17,14,3,3,31,48,FALSE,0,0,"",0,17
2016,4,reg,Houston Texans,Tennessee Titans,HOU,27,20,7,3.5,47,40,FALSE,0,0,DOME (Open Roof),3.5,7
2016,4,reg,Jacksonville Jaguars,Indianapolis Colts,IND,30,27,3,1,57,48.5,TRUE,0,0,"",2,8.5
2016,4,reg,New England Patriots,Buffalo Bills,NE,0,16,16,3.5,16,41,FALSE,0,0,"",12.5,25
2016,4,reg,New York Jets,Seattle Seahawks,SEA,17,27,10,1,44,40,FALSE,0,0,"",9,4
2016,4,reg,Pittsburgh Steelers,Kansas City Chiefs,PIT,43,14,29,3.5,57,48.5,FALSE,0,1,Rain,25.5,8.5
2016,4,reg,San Diego Chargers,New Orleans Saints,LAC,34,35,1,3.5,69,54,FALSE,0,0,"",2.5,15
2016,4,reg,San Francisco 49ers,Dallas Cowboys,DAL,17,24,7,1,41,44,FALSE,0,0,"",6,3
2016,4,reg,Tampa Bay Buccaneers,Denver Broncos,DEN,7,27,20,3,34,42.5,FALSE,0,1,Rain,17,8.5
2016,4,reg,Washington Redskins,Cleveland Browns,WAS,31,20,11,7.5,51,47.5,FALSE,0,0,"",3.5,3.5
2016,4,reg,Minnesota Vikings,New York Giants,MIN,24,10,14,3.5,34,42.5,FALSE,1,0,DOME,10.5,8.5
2016,5,reg,San Francisco 49ers,Arizona Cardinals,ARI,21,33,12,3.5,54,42.5,FALSE,0,0,"",8.5,11.5
2016,5,reg,Baltimore Ravens,Washington Redskins,BAL,10,16,6,4,26,44.5,FALSE,0,0,"",2,18.5
2016,5,reg,Cleveland Browns,New England Patriots,NE,13,33,20,10,46,47.5,FALSE,0,0,"",10,1.5
2016,5,reg,Dallas Cowboys,Cincinnati Bengals,CIN,28,14,14,2.5,42,46,FALSE,1,0,DOME,11.5,4
2016,5,reg,Denver Broncos,Atlanta Falcons,DEN,16,23,7,3.5,39,44.5,FALSE,0,0,"",3.5,5.5
2016,5,reg,Detroit Lions,Philadelphia Eagles,PHI,24,23,1,3.5,47,46,FALSE,1,0,DOME,2.5,1
2016,5,reg,Green Bay Packers,New York Giants,GB,23,16,7,7,39,49,FALSE,0,0,"",0,10
2016,5,reg,Indianapolis Colts,Chicago Bears,IND,29,23,6,4,52,47.5,FALSE,1,0,DOME,2,4.5
2016,5,reg,Los Angeles Rams,Buffalo Bills,BUF,19,30,11,2.5,49,41.5,FALSE,0,0,"",8.5,7.5
2016,5,reg,Miami Dolphins,Tennessee Titans,MIA,17,30,13,2.5,47,44.5,FALSE,0,0,"",10.5,2.5
2016,5,reg,Minnesota Vikings,Houston Texans,MIN,31,13,18,6,44,39,FALSE,1,0,DOME,12,5
2016,5,reg,Oakland Raiders,San Diego Chargers,OAK,34,31,3,3.5,65,50.5,FALSE,0,0,"",0.5,14.5
2016,5,reg,Pittsburgh Steelers,New York Jets,PIT,31,13,18,10,44,50,FALSE,0,0,"",8,6
2016,5,reg,Carolina Panthers,Tampa Bay Buccaneers,CAR,14,17,3,6,31,46.5,FALSE,0,0,"",3,15.5
2016,6,reg,San Diego Chargers,Denver Broncos,DEN,21,13,8,3,34,44,FALSE,0,0,"",5,10
2016,6,reg,Buffalo Bills,San Francisco 49ers,BUF,45,16,29,7.5,61,44,FALSE,0,0,"",21.5,17
2016,6,reg,Chicago Bears,Jacksonville Jaguars,CHI,16,17,1,2.5,33,46,FALSE,0,0,"",1.5,13
2016,6,reg,Detroit Lions,Los Angeles Rams,DET,31,28,3,2.5,59,44,FALSE,1,0,DOME,0.5,15
2016,6,reg,Green Bay Packers,Dallas Cowboys,GB,16,30,14,5,46,47,FALSE,0,0,"",9,1
2016,6,reg,Houston Texans,Indianapolis Colts,HOU,26,23,3,3,49,47.5,FALSE,0,0,DOME (Open Roof),0,1.5
2016,6,reg,Miami Dolphins,Pittsburgh Steelers,PIT,30,15,15,7.5,45,49.5,FALSE,0,0,"",7.5,4.5
2016,6,reg,New England Patriots,Cincinnati Bengals,NE,35,17,18,7.5,52,48,FALSE,0,0,"",10.5,4
2016,6,reg,New Orleans Saints,Carolina Panthers,CAR,41,38,3,2.5,79,53.5,FALSE,1,0,DOME,0.5,25.5
2016,6,reg,New York Giants,Baltimore Ravens,NYG,27,23,4,3.5,50,42.5,FALSE,0,0,"",0.5,7.5
2016,6,reg,Oakland Raiders,Kansas City Chiefs,KC,10,26,16,1,36,46.5,FALSE,0,1,Rain,15,10.5
2016,6,reg,Seattle Seahawks,Atlanta Falcons,SEA,26,24,2,7,50,45.5,FALSE,0,0,"",5,4.5
2016,6,reg,Tennessee Titans,Cleveland Browns,TEN,28,26,2,7.5,54,44.5,FALSE,0,0,"",5.5,9.5
2016,6,reg,Washington Redskins,Philadelphia Eagles,PHI,27,20,7,3,47,45,FALSE,0,0,"",4,2
2016,6,reg,Arizona Cardinals,New York Jets,ARI,28,3,25,7,31,45.5,FALSE,1,0,DOME,18,14.5
2016,7,reg,Green Bay Packers,Chicago Bears,GB,26,10,16,7.5,36,46.5,FALSE,0,0,"",8.5,10.5
2016,7,reg,Arizona Cardinals,Seattle Seahawks,ARI,6,6,0,2.5,12,43,FALSE,1,0,DOME,2.5,31
2016,7,reg,Atlanta Falcons,San Diego Chargers,ATL,30,33,3,4.5,63,52.5,FALSE,1,0,DOME,1.5,10.5
2016,7,reg,Cincinnati Bengals,Cleveland Browns,CIN,31,17,14,11,48,46.5,FALSE,0,0,"",3,1.5
2016,7,reg,Detroit Lions,Washington Redskins,WAS,20,17,3,1,37,50,FALSE,1,0,DOME,2,13
2016,7,reg,Jacksonville Jaguars,Oakland Raiders,JAX,16,33,17,2,49,47.5,FALSE,0,0,"",15,1.5
2016,7,reg,Kansas City Chiefs,New Orleans Saints,KC,27,21,6,7,48,51.5,FALSE,0,0,"",1,3.5
2016,7,reg,Los Angeles Rams,New York Giants,NYG,10,17,7,2.5,27,44.5,TRUE,0,0,"",4.5,17.5
2016,7,reg,Miami Dolphins,Buffalo Bills,BUF,28,25,3,2.5,53,46,FALSE,0,0,"",0.5,7
2016,7,reg,New York Jets,Baltimore Ravens,NYJ,24,16,8,2.5,40,40,FALSE,0,0,"",5.5,0
2016,7,reg,Philadelphia Eagles,Minnesota Vikings,MIN,21,10,11,3,31,39,FALSE,0,0,"",8,8
2016,7,reg,Pittsburgh Steelers,New England Patriots,NE,16,27,11,7.5,43,49,FALSE,0,0,"",3.5,6
2016,7,reg,San Francisco 49ers,Tampa Bay Buccaneers,SF,17,34,17,1,51,45,FALSE,0,0,"",16,6
2016,7,reg,Tennessee Titans,Indianapolis Colts,TEN,26,34,8,4,60,48,FALSE,0,0,"",4,12
2016,7,reg,Denver Broncos,Houston Texans,DEN,27,9,18,8.5,36,40,FALSE,0,0,"",9.5,4
2016,8,reg,Tennessee Titans,Jacksonville Jaguars,TEN,36,22,14,3,58,43.5,FALSE,0,0,"",11,14.5
2016,8,reg,Atlanta Falcons,Green Bay Packers,ATL,33,32,1,3,65,51,FALSE,1,0,DOME,2,14
2016,8,reg,Buffalo Bills,New England Patriots,NE,25,41,16,5.5,66,48,FALSE,0,1,Rain,10.5,18
2016,8,reg,Carolina Panthers,Arizona Cardinals,CAR,30,20,10,2.5,50,45.5,FALSE,0,0,"",7.5,4.5
2016,8,reg,Cincinnati Bengals,Washington Redskins,CIN,27,27,0,3,54,49,TRUE,0,0,"",3,5
2016,8,reg,Cleveland Browns,New York Jets,NYJ,28,31,3,2.5,59,45.5,FALSE,0,0,"",0.5,13.5
2016,8,reg,Dallas Cowboys,Philadelphia Eagles,DAL,29,23,6,5,52,44,FALSE,1,0,DOME,1,8
2016,8,reg,Denver Broncos,San Diego Chargers,DEN,27,19,8,3.5,46,43,FALSE,0,0,"",4.5,3
2016,8,reg,Houston Texans,Detroit Lions,HOU,20,13,7,1,33,46.5,FALSE,0,0,DOME (Open Roof),6,13.5
2016,8,reg,Indianapolis Colts,Kansas City Chiefs,KC,14,30,16,3,44,50.5,FALSE,1,0,DOME,13,6.5
2016,8,reg,New Orleans Saints,Seattle Seahawks,SEA,25,20,5,1,45,50,FALSE,1,0,DOME,4,5
2016,8,reg,Tampa Bay Buccaneers,Oakland Raiders,TB,24,30,6,1,54,48,FALSE,0,0,"",5,6
2016,8,reg,Chicago Bears,Minnesota Vikings,MIN,20,10,10,4.5,30,39.5,FALSE,0,1,Rain,5.5,9.5
2016,9,reg,Tampa Bay Buccaneers,Atlanta Falcons,ATL,28,43,15,4.5,71,49,FALSE,0,0,"",10.5,22
2016,9,reg,Baltimore Ravens,Pittsburgh Steelers,PIT,21,14,7,3.5,35,46,FALSE,0,0,"",3.5,11
2016,9,reg,Cleveland Browns,Dallas Cowboys,DAL,10,35,25,7,45,49,FALSE,0,0,"",18,4
2016,9,reg,Green Bay Packers,Indianapolis Colts,GB,26,31,5,7.5,57,52,FALSE,0,0,"",2.5,5
2016,9,reg,Kansas City Chiefs,Jacksonville Jaguars,KC,19,14,5,7,33,42.5,FALSE,0,0,"",2,9.5
2016,9,reg,Los Angeles Rams,Carolina Panthers,CAR,10,13,3,3,23,44.5,FALSE,0,0,"",0,21.5
2016,9,reg,Miami Dolphins,New York Jets,MIA,27,23,4,3.5,50,45,FALSE,0,0,"",0.5,5
2016,9,reg,Minnesota Vikings,Detroit Lions,MIN,16,22,6,4.5,38,42.5,FALSE,1,0,DOME,1.5,4.5
2016,9,reg,New York Giants,Philadelphia Eagles,NYG,28,23,5,3,51,42.5,FALSE,0,0,"",2,8.5
2016,9,reg,Oakland Raiders,Denver Broncos,OAK,30,20,10,1,50,44.5,FALSE,0,0,"",9,5.5
2016,9,reg,San Diego Chargers,Tennessee Titans,LAC,43,35,8,3.5,78,47.5,FALSE,0,0,"",4.5,30.5
2016,9,reg,San Francisco 49ers,New Orleans Saints,NO,23,41,18,5,64,53,FALSE,0,0,"",13,11
2016,9,reg,Seattle Seahawks,Buffalo Bills,SEA,31,25,6,5.5,56,43.5,FALSE,0,0,"",0.5,12.5
2016,10,reg,Baltimore Ravens,Cleveland Browns,BAL,28,7,21,7.5,35,44,FALSE,0,0,"",13.5,9
2016,10,reg,Arizona Cardinals,San Francisco 49ers,ARI,23,20,3,14,43,47,FALSE,1,0,DOME,11,4
2016,10,reg,Carolina Panthers,Kansas City Chiefs,CAR,17,20,3,3,37,44,FALSE,0,0,"",0,7
2016,10,reg,Jacksonville Jaguars,Houston Texans,JAX,21,24,3,3,45,42,FALSE,0,0,"",0,3
2016,10,reg,New England Patriots,Seattle Seahawks,NE,24,31,7,7.5,55,49.5,FALSE,0,0,"",0.5,5.5
2016,10,reg,New Orleans Saints,Denver Broncos,NO,23,25,2,3,48,50,FALSE,1,0,DOME,1,2
2016,10,reg,New York Jets,Los Angeles Rams,LAR,6,9,3,1,15,38.5,FALSE,0,0,"",2,23.5
2016,10,reg,Philadelphia Eagles,Atlanta Falcons,PHI,24,15,9,1.5,39,49,FALSE,0,0,"",7.5,10
2016,10,reg,Pittsburgh Steelers,Dallas Cowboys,PIT,30,35,5,3,65,51,FALSE,0,0,"",2,14
2016,10,reg,San Diego Chargers,Miami Dolphins,LAC,24,31,7,4.5,55,49,FALSE,0,0,"",2.5,6
2016,10,reg,Tampa Bay Buccaneers,Chicago Bears,CHI,36,10,26,2.5,46,45,FALSE,0,0,"",23.5,1
2016,10,reg,Tennessee Titans,Green Bay Packers,GB,47,25,22,3,72,49,FALSE,0,0,"",19,23
2016,10,reg,Washington Redskins,Minnesota Vikings,WAS,26,20,6,2.5,46,41.5,FALSE,0,0,"",3.5,4.5
2016,10,reg,New York Giants,Cincinnati Bengals,PICK,21,20,1,0,41,49.5,FALSE,0,0,"",1,8.5
2016,11,reg,Carolina Panthers,New Orleans Saints,CAR,23,20,3,3.5,43,53.5,FALSE,0,0,"",0.5,10.5
2016,11,reg,Cincinnati Bengals,Buffalo Bills,CIN,12,16,4,2.5,28,48,FALSE,0,0,"",1.5,20
2016,11,reg,Cleveland Browns,Pittsburgh Steelers,PIT,9,24,15,8.5,33,45.5,FALSE,0,0,"",6.5,12.5
2016,11,reg,Dallas Cowboys,Baltimore Ravens,DAL,27,17,10,7,44,44.5,FALSE,1,0,DOME,3,0.5
2016,11,reg,Detroit Lions,Jacksonville Jaguars,DET,26,19,7,5.5,45,47,FALSE,1,0,DOME,1.5,2
2016,11,reg,Indianapolis Colts,Tennessee Titans,IND,24,17,7,3,41,54,FALSE,1,0,DOME,4,13
2016,11,reg,Kansas City Chiefs,Tampa Bay Buccaneers,KC,17,19,2,7,36,45,FALSE,0,0,"",5,9
2016,11,reg,Los Angeles Rams,Miami Dolphins,MIA,10,14,4,1,24,38.5,FALSE,0,0,"",3,14.5
2016,11,reg,Minnesota Vikings,Arizona Cardinals,MIN,30,24,6,2,54,40,FALSE,1,0,DOME,4,14
2016,11,reg,New York Giants,Chicago Bears,NYG,22,16,6,7,38,41.5,FALSE,0,0,"",1,3.5
2016,11,reg,San Francisco 49ers,New England Patriots,NE,17,30,13,11.5,47,51.5,FALSE,0,1,Rain,1.5,4.5
2016,11,reg,Seattle Seahawks,Philadelphia Eagles,SEA,26,15,11,6.5,41,43,FALSE,0,0,"",4.5,2
2016,11,reg,Washington Redskins,Green Bay Packers,WAS,42,24,18,3,66,48.5,FALSE,0,0,"",15,17.5
2016,11,reg,Oakland Raiders,Houston Texans,OAK,27,20,7,6.5,47,46,TRUE,0,0,"",0.5,1
2016,12,reg,Dallas Cowboys,Washington Redskins,DAL,31,26,5,6,57,53.5,FALSE,1,0,DOME,1,3.5
2016,12,reg,Detroit Lions,Minnesota Vikings,DET,16,13,3,1.5,29,42,FALSE,1,0,DOME,1.5,13
2016,12,reg,Indianapolis Colts,Pittsburgh Steelers,PIT,7,28,21,8.5,35,49.5,FALSE,1,0,DOME,12.5,14.5
2016,12,reg,Atlanta Falcons,Arizona Cardinals,ATL,38,19,19,4,57,49,FALSE,1,0,DOME,15,8
2016,12,reg,Baltimore Ravens,Cincinnati Bengals,BAL,19,14,5,3.5,33,42,FALSE,0,0,"",1.5,9
2016,12,reg,Buffalo Bills,Jacksonville Jaguars,BUF,28,21,7,8.5,49,44,FALSE,0,0,"",1.5,5
2016,12,reg,Chicago Bears,Tennessee Titans,TEN,21,27,6,6.5,48,42,FALSE,0,1,Fog,0.5,6
2016,12,reg,Cleveland Browns,New York Giants,NYG,13,27,14,6.5,40,46.5,FALSE,0,0,"",7.5,6.5
2016,12,reg,Denver Broncos,Kansas City Chiefs,DEN,27,30,3,3.5,57,40,FALSE,0,0,"",0.5,17
2016,12,reg,Houston Texans,San Diego Chargers,LAC,13,21,8,2.5,34,46,FALSE,0,0,DOME (Open Roof),5.5,12
2016,12,reg,Miami Dolphins,San Francisco 49ers,MIA,31,24,7,7,55,45,FALSE,0,0,"",0,10
2016,12,reg,New Orleans Saints,Los Angeles Rams,NO,49,21,28,8,70,45,FALSE,1,0,DOME,20,25
2016,12,reg,New York Jets,New England Patriots,NE,17,22,5,9.5,39,48.5,FALSE,0,0,"",4.5,9.5
2016,12,reg,Oakland Raiders,Carolina Panthers,OAK,35,32,3,3.5,67,48.5,FALSE,0,0,"",0.5,18.5
2016,12,reg,Tampa Bay Buccaneers,Seattle Seahawks,SEA,14,5,9,5.5,19,46,FALSE,0,0,"",3.5,27
2016,12,reg,Philadelphia Eagles,Green Bay Packers,PHI,13,27,14,4,40,47.5,FALSE,0,0,"",10,7.5
2016,13,reg,Minnesota Vikings,Dallas Cowboys,DAL,15,17,2,3,32,43.5,FALSE,1,0,DOME,1,11.5
2016,13,reg,Arizona Cardinals,Washington Redskins,ARI,31,23,8,2.5,54,48.5,FALSE,1,0,DOME,5.5,5.5
2016,13,reg,Atlanta Falcons,Kansas City Chiefs,ATL,28,29,1,5,57,50,FALSE,1,0,DOME,4,7
2016,13,reg,Baltimore Ravens,Miami Dolphins,BAL,38,6,32,3.5,44,41.5,FALSE,0,0,"",28.5,2.5
2016,13,reg,Chicago Bears,San Francisco 49ers,SF,26,6,20,1,32,44,FALSE,0,1,Rain,19,12
2016,13,reg,Cincinnati Bengals,Philadelphia Eagles,CIN,32,14,18,1.5,46,42,FALSE,0,0,"",16.5,4
2016,13,reg,Green Bay Packers,Houston Texans,GB,21,13,8,7,34,44.5,FALSE,0,1,Snow,1,10.5
2016,13,reg,Jacksonville Jaguars,Denver Broncos,DEN,10,20,10,3.5,30,38.5,FALSE,0,0,"",6.5,8.5
2016,13,reg,New England Patriots,Los Angeles Rams,NE,26,10,16,13.5,36,45,FALSE,0,0,"",2.5,9
2016,13,reg,New Orleans Saints,Detroit Lions,NO,13,28,15,6.5,41,53.5,FALSE,1,0,DOME,8.5,12.5
2016,13,reg,Oakland Raiders,Buffalo Bills,OAK,38,24,14,3,62,48.5,FALSE,0,0,"",11,13.5
2016,13,reg,Pittsburgh Steelers,New York Giants,PIT,24,14,10,6.5,38,49.5,FALSE,0,0,"",3.5,11.5
2016,13,reg,San Diego Chargers,Tampa Bay Buccaneers,LAC,21,28,7,3.5,49,49,FALSE,0,0,"",3.5,0
2016,13,reg,Seattle Seahawks,Carolina Panthers,SEA,40,7,33,8.5,47,44,FALSE,0,0,"",24.5,3
2016,13,reg,New York Jets,Indianapolis Colts,NYJ,10,41,31,1,51,48.5,FALSE,0,0,"",30,2.5
2016,14,reg,Kansas City Chiefs,Oakland Raiders,KC,21,13,8,3.5,34,46,FALSE,0,0,"",4.5,12
2016,14,reg,Buffalo Bills,Pittsburgh Steelers,PIT,20,27,7,2,47,45.5,FALSE,0,1,Snow,5,1.5
2016,14,reg,Carolina Panthers,San Diego Chargers,CAR,28,16,12,1,44,48.5,FALSE,0,0,"",11,4.5
2016,14,reg,Cleveland Browns,Cincinnati Bengals,CIN,10,23,13,5,33,41.5,FALSE,0,1,Snow,8,8.5
2016,14,reg,Detroit Lions,Chicago Bears,DET,20,17,3,7.5,37,42,FALSE,1,0,DOME,4.5,5
2016,14,reg,Green Bay Packers,Seattle Seahawks,SEA,38,10,28,3,48,47,FALSE,0,0,"",25,1
2016,14,reg,Indianapolis Colts,Houston Texans,IND,17,22,5,6.5,39,47.5,FALSE,1,0,DOME,1.5,8.5
2016,14,reg,Jacksonville Jaguars,Minnesota Vikings,MIN,16,25,9,3.5,41,38,FALSE,0,0,"",5.5,3
2016,14,reg,Los Angeles Rams,Atlanta Falcons,ATL,14,42,28,5,56,44,FALSE,0,0,"",23,12
2016,14,reg,Miami Dolphins,Arizona Cardinals,ARI,26,23,3,2,49,44,FALSE,0,0,"",1,5
2016,14,reg,New York Giants,Dallas Cowboys,DAL,10,7,3,3.5,17,47,FALSE,0,0,"",0.5,30
2016,14,reg,Philadelphia Eagles,Washington Redskins,WAS,22,27,5,2.5,49,48.5,FALSE,0,0,"",2.5,0.5
2016,14,reg,San Francisco 49ers,New York Jets,SF,17,23,6,3,40,43,FALSE,0,0,"",3,3
2016,14,reg,Tampa Bay Buccaneers,New Orleans Saints,TB,16,11,5,2,27,52,FALSE,0,0,"",3,25
2016,14,reg,Tennessee Titans,Denver Broncos,TEN,13,10,3,2,23,44,FALSE,0,0,"",1,21
2016,14,reg,New England Patriots,Baltimore Ravens,NE,30,23,7,6,53,45,FALSE,0,0,"",1,8
2016,15,reg,Seattle Seahawks,Los Angeles Rams,SEA,24,3,21,15,27,39.5,FALSE,0,0,"",6,12.5
2016,15,reg,New York Jets,Miami Dolphins,MIA,13,34,21,2.5,47,40,FALSE,0,0,"",18.5,7
2016,15,reg,Arizona Cardinals,New Orleans Saints,ARI,41,48,7,3,89,48.5,FALSE,1,0,DOME,4,40.5
2016,15,reg,Atlanta Falcons,San Francisco 49ers,ATL,41,13,28,13.5,54,51.5,FALSE,1,0,DOME,14.5,2.5
2016,15,reg,Baltimore Ravens,Philadelphia Eagles,BAL,27,26,1,5,53,41,FALSE,0,1,Rain,4,12
2016,15,reg,Buffalo Bills,Cleveland Browns,BUF,33,13,20,10.5,46,43,FALSE,0,0,"",9.5,3
2016,15,reg,Chicago Bears,Green Bay Packers,GB,27,30,3,4.5,57,40,FALSE,0,0,"",1.5,17
2016,15,reg,Cincinnati Bengals,Pittsburgh Steelers,PIT,20,24,4,3,44,45.5,FALSE,0,0,"",1,1.5
2016,15,reg,Dallas Cowboys,Tampa Bay Buccaneers,DAL,26,20,6,7,46,47.5,FALSE,1,0,DOME,1,1.5
2016,15,reg,Denver Broncos,New England Patriots,NE,3,16,13,3,19,43,FALSE,0,0,"",10,24
2016,15,reg,Houston Texans,Jacksonville Jaguars,HOU,21,20,1,3.5,41,39.5,FALSE,0,0,DOME (Open Roof),2.5,1.5
2016,15,reg,Kansas City Chiefs,Tennessee Titans,KC,17,19,2,6,36,43,FALSE,0,0,"",4,7
2016,15,reg,Minnesota Vikings,Indianapolis Colts,MIN,6,34,28,5,40,44.5,FALSE,1,0,DOME,23,4.5
2016,15,reg,New York Giants,Detroit Lions,NYG,17,6,11,4,23,42.5,FALSE,0,0,"",7,19.5
2016,15,reg,San Diego Chargers,Oakland Raiders,OAK,16,19,3,2.5,35,49.5,FALSE,0,0,"",0.5,14.5
2016,15,reg,Washington Redskins,Carolina Panthers,WAS,15,26,11,7,41,50.5,FALSE,0,0,"",4,9.5
2016,16,reg,Philadelphia Eagles,New York Giants,PHI,24,19,5,1.5,43,42.5,FALSE,0,0,"",3.5,0.5
2016,16,reg,Buffalo Bills,Miami Dolphins,BUF,31,34,3,4.5,65,44.5,FALSE,0,0,"",1.5,20.5
2016,16,reg,Carolina Panthers,Atlanta Falcons,ATL,16,33,17,3,49,49,FALSE,0,0,"",14,0
2016,16,reg,Chicago Bears,Washington Redskins,WAS,21,41,20,3,62,49,FALSE,0,0,"",17,13
2016,16,reg,Cleveland Browns,San Diego Chargers,LAC,20,17,3,4.5,37,45,FALSE,0,0,"",1.5,8
2016,16,reg,Green Bay Packers,Minnesota Vikings,GB,38,25,13,6,63,44.5,FALSE,0,0,"",7,18.5
2016,16,reg,Houston Texans,Cincinnati Bengals,HOU,12,10,2,3,22,41.5,FALSE,0,0,DOME (Open Roof),1,19.5
2016,16,reg,Jacksonville Jaguars,Tennessee Titans,TEN,38,17,21,4,55,44,FALSE,0,0,"",17,11
2016,16,reg,Los Angeles Rams,San Francisco 49ers,LAR,21,22,1,6,43,39.5,FALSE,0,0,"",5,3.5
2016,16,reg,New England Patriots,New York Jets,NE,41,3,38,17,44,45,FALSE,0,1,Rain,21,1
2016,16,reg,New Orleans Saints,Tampa Bay Buccaneers,NO,31,24,7,3,55,53,FALSE,1,0,DOME,4,2
2016,16,reg,Oakland Raiders,Indianapolis Colts,OAK,33,25,8,3.5,58,52,FALSE,0,0,"",4.5,6
2016,16,reg,Seattle Seahawks,Arizona Cardinals,SEA,31,34,3,9,65,43.5,FALSE,0,0,"",6,21.5
2016,16,reg,Kansas City Chiefs,Denver Broncos,KC,33,10,23,3.5,43,38,FALSE,0,1,Rain,19.5,5
2016,16,reg,Pittsburgh Steelers,Baltimore Ravens,PIT,31,27,4,5.5,58,46.5,FALSE,0,0,"",1.5,11.5
2016,16,reg,Dallas Cowboys,Detroit Lions,DAL,42,21,21,6.5,63,46.5,FALSE,1,0,DOME,14.5,16.5
2016,17,reg,Atlanta Falcons,New Orleans Saints,ATL,38,32,6,7.5,70,58.5,FALSE,1,0,DOME,1.5,11.5
2016,17,reg,Cincinnati Bengals,Baltimore Ravens,BAL,27,10,17,2.5,37,40.5,FALSE,0,1,Fog,14.5,3.5
2016,17,reg,Denver Broncos,Oakland Raiders,DEN,24,6,18,1,30,40,FALSE,0,0,"",17,10
2016,17,reg,Detroit Lions,Green Bay Packers,GB,24,31,7,3.5,55,50,FALSE,1,0,DOME,3.5,5
2016,17,reg,Indianapolis Colts,Jacksonville Jaguars,IND,24,20,4,5.5,44,48.5,FALSE,1,0,DOME,1.5,4.5
2016,17,reg,Los Angeles Rams,Arizona Cardinals,ARI,6,44,38,7,50,39,FALSE,0,0,"",31,11
2016,17,reg,Miami Dolphins,New England Patriots,NE,14,35,21,7.5,49,47,FALSE,0,0,"",13.5,2
2016,17,reg,Minnesota Vikings,Chicago Bears,MIN,38,10,28,6,48,44,FALSE,1,0,DOME,22,4
2016,17,reg,New York Jets,Buffalo Bills,BUF,30,10,20,3.5,40,43,FALSE,0,0,"",16.5,3
2016,17,reg,Philadelphia Eagles,Dallas Cowboys,PHI,27,13,14,6.5,40,44,FALSE,0,0,"",7.5,4
2016,17,reg,Pittsburgh Steelers,Cleveland Browns,PIT,27,24,3,3,51,41.5,FALSE,0,0,"",0,9.5
2016,17,reg,San Diego Chargers,Kansas City Chiefs,KC,27,37,10,5.5,64,45,FALSE,0,0,"",4.5,19
2016,17,reg,San Francisco 49ers,Seattle Seahawks,SEA,23,25,2,11.5,48,45,FALSE,0,0,"",9.5,3
2016,17,reg,Tampa Bay Buccaneers,Carolina Panthers,TB,17,16,1,3,33,44.5,FALSE,0,0,"",2,11.5
2016,17,reg,Tennessee Titans,Houston Texans,TEN,24,17,7,3,41,41.5,FALSE,0,0,"",4,0.5
2016,17,reg,Washington Redskins,New York Giants,WAS,10,19,9,9,29,47.5,FALSE,0,0,"",0,18.5
2016,WildCard,post,Houston Texans,Oakland Raiders,HOU,27,14,13,4,41,38,FALSE,1,0,DOME,9,3
2016,WildCard,post,Seattle Seahawks,Detroit Lions,SEA,26,6,20,8,32,45.5,FALSE,0,0,"",12,13.5
2016,WildCard,post,Green Bay Packers,New York Giants,GB,38,13,25,5,51,46.5,FALSE,0,0,"",20,4.5
2016,WildCard,post,Pittsburgh Steelers,Miami Dolphins,PIT,30,12,18,11,42,47.5,FALSE,0,0,"",7,5.5
2016,Division,post,Atlanta Falcons,Seattle Seahawks,ATL,36,20,16,6.5,56,51,FALSE,1,0,DOME,9.5,5
2016,Division,post,New England Patriots,Houston Texans,NE,34,16,18,16,50,44,FALSE,0,0,"",2,6
2016,Division,post,Dallas Cowboys,Green Bay Packers,DAL,31,34,3,5.5,65,52.5,FALSE,1,0,DOME,2.5,12.5
2016,Division,post,Kansas City Chiefs,Pittsburgh Steelers,KC,16,18,2,2.5,34,45.5,FALSE,0,0,"",0.5,11.5
2016,Conference,post,Atlanta Falcons,Green Bay Packers,ATL,44,21,23,6.5,65,59.5,FALSE,1,0,DOME,16.5,5.5
2016,Conference,post,New England Patriots,Pittsburgh Steelers,NE,36,17,19,5.5,53,50,FALSE,0,0,"",13.5,3
2016,SuperBowl,post,New England Patriots,Atlanta Falcons,NE,34,28,6,3,62,57.5,TRUE,1,0,DOME,3,4.5
2017,1,reg,New England Patriots,Kansas City Chiefs,NE,27,42,15,9,69,48.5,FALSE,0,0,"",6,20.5
2017,1,reg,Buffalo Bills,New York Jets,BUF,21,12,9,9.5,33,40,FALSE,0,0,"",0.5,7
2017,1,reg,Chicago Bears,Atlanta Falcons,ATL,17,23,6,7,40,49.5,FALSE,0,0,"",1,9.5
2017,1,reg,Cincinnati Bengals,Baltimore Ravens,CIN,0,20,20,3,20,42.5,FALSE,0,0,"",17,22.5
2017,1,reg,Cleveland Browns,Pittsburgh Steelers,PIT,18,21,3,9,39,47,FALSE,0,0,"",6,8
2017,1,reg,Dallas Cowboys,New York Giants,DAL,19,3,16,3.5,22,47.5,FALSE,1,0,DOME,12.5,25.5
2017,1,reg,Detroit Lions,Arizona Cardinals,ARI,35,23,12,2,58,48,FALSE,1,0,DOME,10,10
2017,1,reg,Green Bay Packers,Seattle Seahawks,GB,17,9,8,3,26,50.5,FALSE,0,0,"",5,24.5
2017,1,reg,Houston Texans,Jacksonville Jaguars,HOU,7,29,22,5.5,36,39.5,FALSE,0,0,DOME (Open Roof),16.5,3.5
2017,1,reg,Los Angeles Rams,Indianapolis Colts,IND,46,9,37,1.5,55,41.5,FALSE,0,0,"",35.5,13.5
2017,1,reg,San Francisco 49ers,Carolina Panthers,CAR,3,23,20,5.5,26,48,FALSE,0,0,"",14.5,22
2017,1,reg,Tennessee Titans,Oakland Raiders,TEN,16,26,10,2,42,50.5,FALSE,0,0,"",8,8.5
2017,1,reg,Washington Redskins,Philadelphia Eagles,PHI,17,30,13,1,47,47.5,FALSE,0,0,"",12,0.5
2017,1,reg,Denver Broncos,Los Angeles Chargers,DEN,24,21,3,3.5,45,43.5,FALSE,0,1,Rain,0.5,1.5
2017,1,reg,Minnesota Vikings,New Orleans Saints,MIN,29,19,10,3.5,48,48,FALSE,1,0,DOME,6.5,0
2017,2,reg,Cincinnati Bengals,Houston Texans,CIN,9,13,4,6.5,22,38,FALSE,0,0,"",2.5,16
2017,2,reg,Atlanta Falcons,Green Bay Packers,ATL,34,23,11,2.5,57,41,FALSE,1,0,DOME,8.5,16
2017,2,reg,Baltimore Ravens,Cleveland Browns,BAL,24,10,14,7.5,34,40,FALSE,0,0,"",6.5,6
2017,2,reg,Carolina Panthers,Buffalo Bills,CAR,9,3,6,7,12,42.5,FALSE,0,0,"",1,30.5
2017,2,reg,Denver Broncos,Dallas Cowboys,DAL,42,17,25,2,59,42,FALSE,0,0,"",23,17
2017,2,reg,Indianapolis Colts,Arizona Cardinals,ARI,13,16,3,7.5,29,44.5,FALSE,1,0,DOME,4.5,15.5
2017,2,reg,Jacksonville Jaguars,Tennessee Titans,TEN,16,37,21,1.5,53,43.5,FALSE,0,0,"",19.5,9.5
2017,2,reg,Kansas City Chiefs,Philadelphia Eagles,KC,27,20,7,4.5,47,47.5,FALSE,0,0,"",2.5,0.5
2017,2,reg,Los Angeles Chargers,Miami Dolphins,LAC,17,19,2,4.5,36,45,FALSE,0,0,"",2.5,9
2017,2,reg,Los Angeles Rams,Washington Redskins,LAR,20,27,7,2.5,47,46,FALSE,0,0,"",4.5,1
2017,2,reg,New Orleans Saints,New England Patriots,NE,20,36,16,7,56,55,FALSE,1,0,DOME,9,1
2017,2,reg,Oakland Raiders,New York Jets,OAK,45,20,25,14,65,43.5,FALSE,0,0,"",11,21.5
2017,2,reg,Pittsburgh Steelers,Minnesota Vikings,PIT,26,9,17,6,35,45.5,FALSE,0,0,"",11,10.5
2017,2,reg,Seattle Seahawks,San Francisco 49ers,SEA,12,9,3,13.5,21,42.5,FALSE,0,0,"",10.5,21.5
2017,2,reg,Tampa Bay Buccaneers,Chicago Bears,TB,29,7,22,7,36,43,FALSE,0,0,"",15,7
2017,2,reg,New York Giants,Detroit Lions,NYG,10,24,14,3.5,34,43.5,FALSE,0,0,"",10.5,9.5
2017,3,reg,San Francisco 49ers,Los Angeles Rams,LAR,39,41,2,2,80,40.5,FALSE,0,0,"",0,39.5
2017,3,reg,Buffalo Bills,Denver Broncos,DEN,26,16,10,3,42,40,FALSE,0,0,"",7,2
2017,3,reg,Carolina Panthers,New Orleans Saints,CAR,13,34,21,5,47,46.5,FALSE,0,0,"",16,0.5
2017,3,reg,Chicago Bears,Pittsburgh Steelers,PIT,23,17,6,7,40,43.5,FALSE,0,0,"",1,3.5
2017,3,reg,Detroit Lions,Atlanta Falcons,ATL,26,30,4,3,56,51,FALSE,1,0,DOME,1,5
2017,3,reg,Green Bay Packers,Cincinnati Bengals,GB,27,24,3,9,51,47.5,FALSE,0,0,"",6,3.5
2017,3,reg,Indianapolis Colts,Cleveland Browns,CLE,31,28,3,1,59,42,FALSE,1,0,DOME,2,17
2017,3,reg,Jacksonville Jaguars,Baltimore Ravens,BAL,44,7,37,4,51,38,TRUE,0,0,"",33,13
2017,3,reg,Los Angeles Chargers,Kansas City Chiefs,KC,10,24,14,3,34,47.5,FALSE,0,0,"",11,13.5
2017,3,reg,Minnesota Vikings,Tampa Bay Buccaneers,TB,34,17,17,1.5,51,41,FALSE,1,0,DOME,15.5,10
2017,3,reg,New England Patriots,Houston Texans,NE,36,33,3,13,69,44.5,FALSE,0,0,"",10,24.5
2017,3,reg,New York Jets,Miami Dolphins,MIA,20,6,14,5.5,26,43,FALSE,0,0,"",8.5,17
2017,3,reg,Philadelphia Eagles,New York Giants,PHI,27,24,3,6,51,43,FALSE,0,0,"",3,8
2017,3,reg,Tennessee Titans,Seattle Seahawks,TEN,33,27,6,3,60,42,FALSE,0,0,"",3,18
2017,3,reg,Washington Redskins,Oakland Raiders,OAK,27,10,17,3,37,53.5,FALSE,0,0,"",14,16.5
2017,3,reg,Arizona Cardinals,Dallas Cowboys,DAL,17,28,11,3,45,46.5,FALSE,1,0,DOME,8,1.5
2017,4,reg,Green Bay Packers,Chicago Bears,GB,35,14,21,7.5,49,44.5,FALSE,0,0,"",13.5,4.5
2017,4,reg,Arizona Cardinals,San Francisco 49ers,ARI,18,15,3,6.5,33,44.5,FALSE,1,0,DOME,3.5,11.5
2017,4,reg,Atlanta Falcons,Buffalo Bills,ATL,17,23,6,8,40,48.5,FALSE,1,0,DOME,2,8.5
2017,4,reg,Baltimore Ravens,Pittsburgh Steelers,PIT,9,26,17,3,35,42,FALSE,0,0,"",14,7
2017,4,reg,Cleveland Browns,Cincinnati Bengals,CIN,7,31,24,3,38,41.5,FALSE,0,0,"",21,3.5
2017,4,reg,Dallas Cowboys,Los Angeles Rams,DAL,30,35,5,6,65,48.5,FALSE,1,0,DOME,1,16.5
2017,4,reg,Denver Broncos,Oakland Raiders,DEN,16,10,6,3,26,46,FALSE,0,0,"",3,20
2017,4,reg,Houston Texans,Tennessee Titans,TEN,57,14,43,2,71,43.5,FALSE,1,0,DOME,41,27.5
2017,4,reg,Los Angeles Chargers,Philadelphia Eagles,LAC,24,26,2,1,50,47.5,FALSE,0,0,"",1,2.5
2017,4,reg,Miami Dolphins,New Orleans Saints,NO,0,20,20,3,20,50.5,TRUE,0,0,"",17,30.5
2017,4,reg,Minnesota Vikings,Detroit Lions,MIN,7,14,7,2,21,42.5,FALSE,1,0,DOME,5,21.5
2017,4,reg,New England Patriots,Carolina Panthers,NE,30,33,3,9,63,49,FALSE,0,0,"",6,14
2017,4,reg,New York Jets,Jacksonville Jaguars,JAX,23,20,3,3,43,38,FALSE,0,0,"",0,5
2017,4,reg,Seattle Seahawks,Indianapolis Colts,SEA,46,17,29,13,63,41.5,FALSE,0,0,"",16,21.5
2017,4,reg,Tampa Bay Buccaneers,New York Giants,TB,25,23,2,3,48,44.5,FALSE,0,1,Rain,1,3.5
2017,4,reg,Kansas City Chiefs,Washington Redskins,KC,29,20,9,7,49,49.5,FALSE,0,0,"",2,0.5
2017,5,reg,Tampa Bay Buccaneers,New England Patriots,NE,14,19,5,5,33,55.5,FALSE,0,1,Rain,0,22.5
2017,5,reg,Cincinnati Bengals,Buffalo Bills,CIN,20,16,4,3,36,39,FALSE,0,1,Rain,1,3
2017,5,reg,Cleveland Browns,New York Jets,NYJ,14,17,3,1.5,31,41.5,FALSE,0,0,"",1.5,10.5
2017,5,reg,Dallas Cowboys,Green Bay Packers,DAL,31,35,4,2,66,52.5,FALSE,1,0,DOME,2,13.5
2017,5,reg,Detroit Lions,Carolina Panthers,DET,24,27,3,2.5,51,43.5,FALSE,1,0,DOME,0.5,7.5
2017,5,reg,Houston Texans,Kansas City Chiefs,KC,34,42,8,1,76,46.5,FALSE,1,0,DOME,7,29.5
2017,5,reg,Indianapolis Colts,San Francisco 49ers,IND,26,23,3,1.5,49,44,FALSE,1,0,DOME,1.5,5
2017,5,reg,Los Angeles Rams,Seattle Seahawks,LAR,10,16,6,1,26,47.5,FALSE,0,0,"",5,21.5
2017,5,reg,Miami Dolphins,Tennessee Titans,TEN,16,10,6,3,26,43.5,FALSE,0,0,"",3,17.5
2017,5,reg,New York Giants,Los Angeles Chargers,NYG,22,27,5,3.5,49,44.5,FALSE,0,0,"",1.5,4.5
2017,5,reg,Oakland Raiders,Baltimore Ravens,OAK,17,30,13,2.5,47,39,FALSE,0,0,"",10.5,8
2017,5,reg,Philadelphia Eagles,Arizona Cardinals,PHI,34,7,27,6.5,41,45,FALSE,0,0,"",20.5,4
2017,5,reg,Pittsburgh Steelers,Jacksonville Jaguars,PIT,9,30,21,8.5,39,43.5,FALSE,0,0,"",12.5,4.5
2017,5,reg,Chicago Bears,Minnesota Vikings,MIN,17,20,3,3,37,40,FALSE,0,0,"",0,3
2017,6,reg,Carolina Panthers,Philadelphia Eagles,CAR,23,28,5,3,51,45.5,FALSE,0,0,"",2,5.5
2017,6,reg,Arizona Cardinals,Tampa Bay Buccaneers,TB,38,33,5,1.5,71,46,FALSE,1,0,DOME,3.5,25
2017,6,reg,Atlanta Falcons,Miami Dolphins,ATL,17,20,3,13.5,37,45.5,FALSE,1,0,DOME,10.5,8.5
2017,6,reg,Baltimore Ravens,Chicago Bears,BAL,24,27,3,6.5,51,38.5,FALSE,0,0,"",3.5,12.5
2017,6,reg,Denver Broncos,New York Giants,DEN,10,23,13,12,33,39,FALSE,0,0,"",1,6
2017,6,reg,Houston Texans,Cleveland Browns,HOU,33,17,16,9.5,50,47,FALSE,1,0,DOME,6.5,3
2017,6,reg,Jacksonville Jaguars,Los Angeles Rams,JAX,17,27,10,2.5,44,42.5,FALSE,0,0,"",7.5,1.5
2017,6,reg,Kansas City Chiefs,Pittsburgh Steelers,KC,13,19,6,3.5,32,47,FALSE,0,0,"",2.5,15
2017,6,reg,Minnesota Vikings,Green Bay Packers,GB,23,10,13,3,33,44.5,FALSE,1,0,DOME,10,11.5
2017,6,reg,New Orleans Saints,Detroit Lions,NO,52,38,14,4,90,49.5,FALSE,1,0,DOME,10,40.5
2017,6,reg,New York Jets,New England Patriots,NE,17,24,7,9,41,48.5,FALSE,0,0,"",2,7.5
2017,6,reg,Oakland Raiders,Los Angeles Chargers,OAK,16,17,1,3,33,48.5,FALSE,0,0,"",2,15.5
2017,6,reg,Washington Redskins,San Francisco 49ers,WAS,26,24,2,12,50,46,FALSE,0,0,"",10,4
2017,6,reg,Tennessee Titans,Indianapolis Colts,TEN,36,22,14,7,58,46,FALSE,0,0,"",7,12
2017,7,reg,Oakland Raiders,Kansas City Chiefs,KC,31,30,1,3,61,46.5,FALSE,0,0,"",2,14.5
2017,7,reg,Buffalo Bills,Tampa Bay Buccaneers,BUF,30,27,3,3,57,45.5,FALSE,0,0,"",0,11.5
2017,7,reg,Chicago Bears,Carolina Panthers,CAR,17,3,14,3,20,40,FALSE,0,0,"",11,20
2017,7,reg,Cleveland Browns,Tennessee Titans,TEN,9,12,3,5.5,21,42.5,FALSE,0,0,"",2.5,21.5
2017,7,reg,Green Bay Packers,New Orleans Saints,NO,17,26,9,3.5,43,46,FALSE,0,1,Rain,5.5,3
2017,7,reg,Indianapolis Colts,Jacksonville Jaguars,JAX,0,27,27,3,27,41.5,FALSE,1,0,DOME,24,14.5
2017,7,reg,Los Angeles Chargers,Denver Broncos,DEN,21,0,21,1.5,21,41,FALSE,0,0,"",19.5,20
2017,7,reg,Los Angeles Rams,Arizona Cardinals,LAR,33,0,33,3,33,46,TRUE,0,0,"",30,13
2017,7,reg,Miami Dolphins,New York Jets,MIA,31,28,3,3,59,39.5,FALSE,0,0,"",0,19.5
2017,7,reg,Minnesota Vikings,Baltimore Ravens,MIN,24,16,8,4,40,38,FALSE,1,0,DOME,4,2
2017,7,reg,New England Patriots,Atlanta Falcons,NE,23,7,16,3,30,56.5,FALSE,0,0,"",13,26.5
2017,7,reg,New York Giants,Seattle Seahawks,SEA,7,24,17,3.5,31,39,FALSE,0,0,"",13.5,8
2017,7,reg,Pittsburgh Steelers,Cincinnati Bengals,PIT,29,14,15,4,43,40,FALSE,0,0,"",11,3
2017,7,reg,San Francisco 49ers,Dallas Cowboys,DAL,10,40,30,6.5,50,48.5,FALSE,0,0,"",23.5,1.5
2017,7,reg,Philadelphia Eagles,Washington Redskins,PHI,34,24,10,4.5,58,49,FALSE,0,0,"",5.5,9
2017,8,reg,Baltimore Ravens,Miami Dolphins,BAL,40,0,40,3,40,37.5,FALSE,0,0,"",37,2.5
2017,8,reg,Buffalo Bills,Oakland Raiders,BUF,34,14,20,2.5,48,45.5,FALSE,0,0,"",17.5,2.5
2017,8,reg,Cincinnati Bengals,Indianapolis Colts,CIN,24,23,1,11,47,41.5,FALSE,0,0,"",10,5.5
2017,8,reg,Cleveland Browns,Minnesota Vikings,MIN,16,33,17,9.5,49,38,TRUE,0,0,"",7.5,11
2017,8,reg,Detroit Lions,Pittsburgh Steelers,PIT,15,20,5,3,35,45.5,FALSE,1,0,DOME,2,10.5
2017,8,reg,New England Patriots,Los Angeles Chargers,NE,21,13,8,7,34,48.5,FALSE,0,0,"",1,14.5
2017,8,reg,New Orleans Saints,Chicago Bears,NO,20,12,8,9,32,47.5,FALSE,1,0,DOME,1,15.5
2017,8,reg,New York Jets,Atlanta Falcons,ATL,20,25,5,4.5,45,46,FALSE,0,1,Rain,0.5,1
2017,8,reg,Philadelphia Eagles,San Francisco 49ers,PHI,33,10,23,13,43,46,FALSE,0,1,Rain,10,3
2017,8,reg,Seattle Seahawks,Houston Texans,SEA,41,38,3,5.5,79,46,FALSE,0,0,"",2.5,33
2017,8,reg,Tampa Bay Buccaneers,Carolina Panthers,TB,3,17,14,2,20,46,FALSE,0,0,"",12,26
2017,8,reg,Washington Redskins,Dallas Cowboys,DAL,19,33,14,2,52,50,FALSE,0,1,Rain,12,2
2017,8,reg,Kansas City Chiefs,Denver Broncos,KC,29,19,10,7,48,43,FALSE,0,0,"",3,5
2017,9,reg,New York Jets,Buffalo Bills,BUF,34,21,13,3,55,43,FALSE,0,0,"",10,12
2017,9,reg,Carolina Panthers,Atlanta Falcons,ATL,20,17,3,3,37,42,FALSE,0,0,"",0,5
2017,9,reg,Dallas Cowboys,Kansas City Chiefs,DAL,28,17,11,2.5,45,53,FALSE,1,0,DOME,8.5,8
2017,9,reg,Houston Texans,Indianapolis Colts,HOU,14,20,6,6,34,45,FALSE,1,0,DOME,0,11
2017,9,reg,Jacksonville Jaguars,Cincinnati Bengals,JAX,23,7,16,6,30,38,FALSE,0,0,"",10,8
2017,9,reg,Miami Dolphins,Oakland Raiders,OAK,24,27,3,3,51,44.5,FALSE,0,0,"",0,6.5
2017,9,reg,New Orleans Saints,Tampa Bay Buccaneers,NO,30,10,20,7,40,54,FALSE,1,0,DOME,13,14
2017,9,reg,New York Giants,Los Angeles Rams,LAR,17,51,34,5.5,68,42.5,FALSE,0,0,"",28.5,25.5
2017,9,reg,Philadelphia Eagles,Denver Broncos,PHI,51,23,28,7,74,41,FALSE,0,0,"",21,33
2017,9,reg,San Francisco 49ers,Arizona Cardinals,ARI,10,20,10,2,30,39,FALSE,0,0,"",8,9
2017,9,reg,Seattle Seahawks,Washington Redskins,SEA,14,17,3,8,31,44.5,FALSE,0,1,Rain,5,13.5
2017,9,reg,Tennessee Titans,Baltimore Ravens,TEN,23,20,3,3,43,41,FALSE,0,0,"",0,2
2017,9,reg,Green Bay Packers,Detroit Lions,DET,17,30,13,2.5,47,42.5,FALSE,0,0,"",10.5,4.5
2017,10,reg,Arizona Cardinals,Seattle Seahawks,SEA,16,22,6,6,38,40,FALSE,1,0,DOME,0,2
2017,10,reg,Atlanta Falcons,Dallas Cowboys,ATL,27,7,20,3.5,34,49,FALSE,1,0,DOME,16.5,15
2017,10,reg,Buffalo Bills,New Orleans Saints,NO,10,47,37,2,57,48.5,FALSE,0,0,"",35,8.5
2017,10,reg,Chicago Bears,Green Bay Packers,CHI,16,23,7,4.5,39,37.5,FALSE,0,1,Rain,2.5,1.5
2017,10,reg,Denver Broncos,New England Patriots,NE,16,41,25,7,57,45,FALSE,0,0,"",18,12
2017,10,reg,Detroit Lions,Cleveland Browns,DET,38,24,14,10.5,62,42.5,FALSE,1,0,DOME,3.5,19.5
2017,10,reg,Indianapolis Colts,Pittsburgh Steelers,PIT,17,20,3,10.5,37,47,FALSE,1,0,DOME,7.5,10
2017,10,reg,Jacksonville Jaguars,Los Angeles Chargers,JAX,20,17,3,5,37,40.5,FALSE,0,0,"",2,3.5
2017,10,reg,Los Angeles Rams,Houston Texans,LAR,33,7,26,12,40,45,FALSE,0,0,"",14,5
2017,10,reg,San Francisco 49ers,New York Giants,NYG,31,21,10,3,52,41.5,FALSE,0,0,"",7,10.5
2017,10,reg,Tampa Bay Buccaneers,New York Jets,TB,15,10,5,1,25,44.5,FALSE,0,0,"",4,19.5
2017,10,reg,Tennessee Titans,Cincinnati Bengals,TEN,24,20,4,4.5,44,40.5,FALSE,0,0,"",0.5,3.5
2017,10,reg,Washington Redskins,Minnesota Vikings,MIN,30,38,8,1,68,43,FALSE,0,0,"",7,25
2017,10,reg,Carolina Panthers,Miami Dolphins,CAR,45,21,24,8,66,38.5,FALSE,0,0,"",16,27.5
2017,11,reg,Pittsburgh Steelers,Tennessee Titans,PIT,40,17,23,7,57,44.5,FALSE,0,0,"",16,12.5
2017,11,reg,Chicago Bears,Detroit Lions,DET,24,27,3,3,51,41,FALSE,0,0,"",0,10
2017,11,reg,Cleveland Browns,Jacksonville Jaguars,JAX,7,19,12,7.5,26,37.5,FALSE,0,1,Rain,4.5,11.5
2017,11,reg,Dallas Cowboys,Philadelphia Eagles,PHI,9,37,28,6,46,48,FALSE,1,0,DOME,22,2
2017,11,reg,Denver Broncos,Cincinnati Bengals,DEN,17,20,3,2.5,37,38,FALSE,0,0,"",0.5,1
2017,11,reg,Green Bay Packers,Baltimore Ravens,BAL,0,23,23,2,23,38,FALSE,0,0,"",21,15
2017,11,reg,Houston Texans,Arizona Cardinals,HOU,31,21,10,2,52,37.5,FALSE,1,0,DOME,8,14.5
2017,11,reg,Los Angeles Chargers,Buffalo Bills,LAC,54,24,30,6.5,78,41,FALSE,0,0,"",23.5,37
2017,11,reg,Miami Dolphins,Tampa Bay Buccaneers,TB,20,30,10,1,50,42,FALSE,0,0,"",9,8
2017,11,reg,Minnesota Vikings,Los Angeles Rams,MIN,24,7,17,2.5,31,45.5,FALSE,1,0,DOME,14.5,14.5
2017,11,reg,New Orleans Saints,Washington Redskins,NO,34,31,3,7.5,65,52.5,FALSE,1,0,DOME,4.5,12.5
2017,11,reg,New York Giants,Kansas City Chiefs,KC,12,9,3,10,21,45.5,FALSE,0,0,"",7,24.5
2017,11,reg,Oakland Raiders,New England Patriots,NE,8,33,25,7,41,54.5,TRUE,0,0,"",18,13.5
2017,11,reg,Seattle Seahawks,Atlanta Falcons,SEA,31,34,3,2,65,45.5,FALSE,0,0,"",1,19.5
2017,12,reg,Dallas Cowboys,Los Angeles Chargers,LAC,6,28,22,1,34,48,FALSE,1,0,DOME,21,14
2017,12,reg,Detroit Lions,Minnesota Vikings,MIN,23,30,7,3,53,44.5,FALSE,1,0,DOME,4,8.5
2017,12,reg,Washington Redskins,New York Giants,WAS,20,10,10,7.5,30,45,FALSE,0,0,"",2.5,15
2017,12,reg,Arizona Cardinals,Jacksonville Jaguars,JAX,27,24,3,5,51,38,FALSE,1,0,DOME,2,13
2017,12,reg,Atlanta Falcons,Tampa Bay Buccaneers,ATL,34,20,14,10,54,48.5,FALSE,1,0,DOME,4,5.5
2017,12,reg,Cincinnati Bengals,Cleveland Browns,CIN,30,16,14,8,46,38,FALSE,0,0,"",6,8
2017,12,reg,Indianapolis Colts,Tennessee Titans,TEN,16,20,4,3.5,36,44,FALSE,1,0,DOME,0.5,8
2017,12,reg,Kansas City Chiefs,Buffalo Bills,KC,10,16,6,10,26,46,FALSE,0,0,"",4,20
2017,12,reg,Los Angeles Rams,New Orleans Saints,LAR,26,20,6,2.5,46,53.5,FALSE,0,0,"",3.5,7.5
2017,12,reg,New England Patriots,Miami Dolphins,NE,35,17,18,16.5,52,47.5,FALSE,0,0,"",1.5,4.5
2017,12,reg,New York Jets,Carolina Panthers,CAR,27,35,8,5,62,40,FALSE,0,0,"",3,22
2017,12,reg,Oakland Raiders,Denver Broncos,OAK,21,14,7,5,35,43.5,FALSE,0,0,"",2,8.5
2017,12,reg,Philadelphia Eagles,Chicago Bears,PHI,31,3,28,13.5,34,44,FALSE,0,0,"",14.5,10
2017,12,reg,Pittsburgh Steelers,Green Bay Packers,PIT,31,28,3,14,59,41.5,FALSE,0,0,"",11,17.5
2017,12,reg,San Francisco 49ers,Seattle Seahawks,SEA,13,24,11,7,37,43,FALSE,0,0,"",4,6
2017,12,reg,Baltimore Ravens,Houston Texans,BAL,23,16,7,7,39,38,FALSE,0,0,"",0,1
2017,13,reg,Dallas Cowboys,Washington Redskins,WAS,38,14,24,2,52,47,FALSE,1,0,DOME,22,5
2017,13,reg,Arizona Cardinals,Los Angeles Rams,LAR,16,32,16,7,48,44.5,FALSE,1,0,DOME,9,3.5
2017,13,reg,Atlanta Falcons,Minnesota Vikings,ATL,9,14,5,3,23,47,FALSE,1,0,DOME,2,24
2017,13,reg,Baltimore Ravens,Detroit Lions,BAL,44,20,24,3,64,43.5,FALSE,0,0,"",21,20.5
2017,13,reg,Buffalo Bills,New England Patriots,NE,3,23,20,9,26,48,FALSE,0,0,"",11,22
2017,13,reg,Chicago Bears,San Francisco 49ers,CHI,14,15,1,3,29,41,FALSE,0,0,"",2,12
2017,13,reg,Green Bay Packers,Tampa Bay Buccaneers,GB,26,20,6,2,46,45,FALSE,0,0,"",4,1
2017,13,reg,Jacksonville Jaguars,Indianapolis Colts,JAX,30,10,20,9.5,40,41,FALSE,0,0,"",10.5,1
2017,13,reg,Los Angeles Chargers,Cleveland Browns,LAC,19,10,9,13.5,29,43.5,FALSE,0,0,"",4.5,14.5
2017,13,reg,Miami Dolphins,Denver Broncos,DEN,35,9,26,1.5,44,39.5,FALSE,0,0,"",24.5,4.5
2017,13,reg,New Orleans Saints,Carolina Panthers,NO,31,21,10,4.5,52,48,FALSE,1,0,DOME,5.5,4
2017,13,reg,New York Jets,Kansas City Chiefs,KC,38,31,7,3,69,43.5,FALSE,0,0,"",4,25.5
2017,13,reg,Oakland Raiders,New York Giants,OAK,24,17,7,9,41,41.5,FALSE,0,0,"",2,0.5
2017,13,reg,Seattle Seahawks,Philadelphia Eagles,PHI,24,10,14,5.5,34,47.5,FALSE,0,0,"",8.5,13.5
2017,13,reg,Tennessee Titans,Houston Texans,TEN,24,13,11,6.5,37,43,FALSE,0,0,"",4.5,6
2017,13,reg,Cincinnati Bengals,Pittsburgh Steelers,PIT,20,23,3,4.5,43,43.5,FALSE,0,0,"",1.5,0.5
2017,14,reg,Atlanta Falcons,New Orleans Saints,ATL,20,17,3,2.5,37,51.5,FALSE,1,0,DOME,0.5,14.5
2017,14,reg,Arizona Cardinals,Tennessee Titans,TEN,12,7,5,2.5,19,42,FALSE,1,0,DOME,2.5,23
2017,14,reg,Buffalo Bills,Indianapolis Colts,BUF,13,7,6,3.5,20,36.5,FALSE,0,1,Snow,2.5,16.5
2017,14,reg,Carolina Panthers,Minnesota Vikings,MIN,31,24,7,2.5,55,40.5,FALSE,0,0,"",4.5,14.5
2017,14,reg,Cincinnati Bengals,Chicago Bears,CIN,7,33,26,6,40,40.5,FALSE,0,0,"",20,0.5
2017,14,reg,Cleveland Browns,Green Bay Packers,GB,21,27,6,2.5,48,38.5,FALSE,0,0,"",3.5,9.5
2017,14,reg,Denver Broncos,New York Jets,NYJ,23,0,23,1,23,40.5,FALSE,0,0,"",22,17.5
2017,14,reg,Houston Texans,San Francisco 49ers,HOU,16,26,10,1,42,45.5,FALSE,1,0,DOME,9,3.5
2017,14,reg,Jacksonville Jaguars,Seattle Seahawks,JAX,30,24,6,3,54,40,FALSE,0,0,"",3,14
2017,14,reg,Kansas City Chiefs,Oakland Raiders,KC,26,15,11,4.5,41,48.5,FALSE,0,0,"",6.5,7.5
2017,14,reg,Los Angeles Chargers,Washington Redskins,LAC,30,13,17,6,43,46.5,FALSE,0,0,"",11,3.5
2017,14,reg,Los Angeles Rams,Philadelphia Eagles,LAR,35,43,8,1,78,47.5,FALSE,0,0,"",7,30.5
2017,14,reg,New York Giants,Dallas Cowboys,DAL,10,30,20,4,40,42,FALSE,0,0,"",16,2
2017,14,reg,Pittsburgh Steelers,Baltimore Ravens,PIT,39,38,1,6,77,43,FALSE,0,0,"",5,34
2017,14,reg,Tampa Bay Buccaneers,Detroit Lions,PICK,21,24,3,0,45,47.5,FALSE,0,0,"",3,2.5
2017,14,reg,Miami Dolphins,New England Patriots,NE,27,20,7,10.5,47,48,FALSE,0,0,"",3.5,1
2017,15,reg,Indianapolis Colts,Denver Broncos,DEN,13,25,12,3,38,40.5,FALSE,1,0,DOME,9,2.5
2017,15,reg,Detroit Lions,Chicago Bears,DET,20,10,10,5,30,43.5,FALSE,1,0,DOME,5,13.5
2017,15,reg,Kansas City Chiefs,Los Angeles Chargers,LAC,30,13,17,1,43,47,FALSE,0,0,"",16,4
2017,15,reg,Buffalo Bills,Miami Dolphins,BUF,24,16,8,3.5,40,39.5,FALSE,0,0,"",4.5,0.5
2017,15,reg,Carolina Panthers,Green Bay Packers,CAR,31,24,7,3,55,46.5,FALSE,0,0,"",4,8.5
2017,15,reg,Cleveland Browns,Baltimore Ravens,BAL,10,27,17,6.5,37,42,FALSE,0,0,"",10.5,5
2017,15,reg,Jacksonville Jaguars,Houston Texans,JAX,45,7,38,10.5,52,39,FALSE,0,0,"",27.5,13
2017,15,reg,Minnesota Vikings,Cincinnati Bengals,MIN,34,7,27,12.5,41,42.5,FALSE,1,0,DOME,14.5,1.5
2017,15,reg,New Orleans Saints,New York Jets,NO,31,19,12,16.5,50,47,FALSE,1,0,DOME,4.5,3
2017,15,reg,New York Giants,Philadelphia Eagles,PHI,29,34,5,7.5,63,40,FALSE,0,0,"",2.5,23
2017,15,reg,Oakland Raiders,Dallas Cowboys,DAL,17,20,3,3,37,46,FALSE,0,0,"",0,9
2017,15,reg,Pittsburgh Steelers,New England Patriots,NE,24,27,3,2.5,51,52.5,FALSE,0,1,Rain,0.5,1.5
2017,15,reg,San Francisco 49ers,Tennessee Titans,SF,25,23,2,2.5,48,44.5,FALSE,0,0,"",0.5,3.5
2017,15,reg,Seattle Seahawks,Los Angeles Rams,LAR,7,42,35,1,49,47.5,FALSE,0,0,"",34,1.5
2017,15,reg,Washington Redskins,Arizona Cardinals,WAS,20,15,5,4,35,40,FALSE,0,0,"",1,5
2017,15,reg,Tampa Bay Buccaneers,Atlanta Falcons,ATL,21,24,3,7,45,49.5,FALSE,0,0,"",4,4.5
2017,16,reg,Baltimore Ravens,Indianapolis Colts,BAL,23,16,7,13.5,39,41,FALSE,0,0,"",6.5,2
2017,16,reg,Green Bay Packers,Minnesota Vikings,MIN,0,16,16,8.5,16,41,FALSE,0,0,"",7.5,25
2017,16,reg,Arizona Cardinals,New York Giants,ARI,23,0,23,3,23,39,FALSE,1,0,DOME,20,16
2017,16,reg,Carolina Panthers,Tampa Bay Buccaneers,CAR,22,19,3,10,41,46.5,FALSE,0,0,"",7,5.5
2017,16,reg,Chicago Bears,Cleveland Browns,CHI,20,3,17,5.5,23,37,FALSE,0,0,"",11.5,14
2017,16,reg,Cincinnati Bengals,Detroit Lions,DET,26,17,9,3.5,43,43.5,FALSE,0,0,"",5.5,0.5
2017,16,reg,Dallas Cowboys,Seattle Seahawks,DAL,12,21,9,4.5,33,47,FALSE,1,0,DOME,4.5,14
2017,16,reg,Kansas City Chiefs,Miami Dolphins,KC,29,13,16,11,42,43.5,FALSE,0,0,"",5,1.5
2017,16,reg,New England Patriots,Buffalo Bills,NE,37,16,21,11,53,47.5,FALSE,0,0,"",10,5.5
2017,16,reg,New Orleans Saints,Atlanta Falcons,NO,23,13,10,5.5,36,52,FALSE,1,0,DOME,4.5,16
2017,16,reg,New York Jets,Los Angeles Chargers,LAC,7,14,7,7.5,21,42.5,FALSE,0,0,"",0.5,21.5
2017,16,reg,San Francisco 49ers,Jacksonville Jaguars,JAX,44,33,11,4,77,43,FALSE,0,0,"",7,34
2017,16,reg,Tennessee Titans,Los Angeles Rams,LAR,23,27,4,5.5,50,46,FALSE,0,0,"",1.5,4
2017,16,reg,Washington Redskins,Denver Broncos,WAS,27,11,16,3,38,39.5,FALSE,0,0,"",13,1.5
2017,16,reg,Houston Texans,Pittsburgh Steelers,PIT,6,34,28,8,40,45.5,FALSE,1,0,DOME,20,5.5
2017,16,reg,Philadelphia Eagles,Oakland Raiders,PHI,19,10,9,10,29,46,FALSE,0,0,"",1,17
2017,17,reg,Atlanta Falcons,Carolina Panthers,ATL,22,10,12,5,32,44.5,FALSE,1,0,DOME,7,12.5
2017,17,reg,Baltimore Ravens,Cincinnati Bengals,BAL,27,31,4,8,58,40,FALSE,0,0,"",4,18
2017,17,reg,Denver Broncos,Kansas City Chiefs,DEN,24,27,3,3,51,37.5,FALSE,0,0,"",0,13.5
2017,17,reg,Detroit Lions,Green Bay Packers,DET,35,11,24,7.5,46,44.5,FALSE,1,0,DOME,16.5,1.5
2017,17,reg,Indianapolis Colts,Houston Texans,IND,22,13,9,5.5,35,41.5,FALSE,1,0,DOME,3.5,6.5
2017,17,reg,Los Angeles Chargers,Oakland Raiders,LAC,30,10,20,7,40,43,FALSE,0,0,"",13,3
2017,17,reg,Los Angeles Rams,San Francisco 49ers,SF,13,34,21,6,47,44.5,FALSE,0,0,"",15,2.5
2017,17,reg,Miami Dolphins,Buffalo Bills,BUF,16,22,6,2.5,38,41.5,FALSE,0,0,"",3.5,3.5
2017,17,reg,Minnesota Vikings,Chicago Bears,MIN,23,10,13,13.5,33,38.5,FALSE,1,0,DOME,0.5,5.5
2017,17,reg,New England Patriots,New York Jets,NE,26,6,20,17,32,43.5,FALSE,0,0,"",3,11.5
2017,17,reg,New York Giants,Washington Redskins,WAS,18,10,8,4.5,28,41,FALSE,0,0,"",3.5,13
2017,17,reg,Philadelphia Eagles,Dallas Cowboys,DAL,0,6,6,3.5,6,41,FALSE,0,0,"",2.5,35
2017,17,reg,Pittsburgh Steelers,Cleveland Browns,PIT,28,24,4,5,52,38.5,FALSE,0,0,"",1,13.5
2017,17,reg,Seattle Seahawks,Arizona Cardinals,SEA,24,26,2,8,50,38,FALSE,0,0,"",6,12
2017,17,reg,Tampa Bay Buccaneers,New Orleans Saints,NO,31,24,7,6,55,49,FALSE,0,0,"",1,6
2017,17,reg,Tennessee Titans,Jacksonville Jaguars,TEN,15,10,5,2.5,25,40,FALSE,0,0,"",2.5,15
2017,Wildcard,post,Kansas City Chiefs,Tennessee Titans,KC,21,22,1,8.5,43,44,FALSE,0,0,"",7.5,1
2017,Wildcard,post,Los Angeles Rams,Atlanta Falcons,LAR,13,26,13,6.5,39,48,FALSE,0,0,"",6.5,9
2017,Wildcard,post,Jacksonville Jaguars,Buffalo Bills,JAX,10,3,7,8,13,39.5,FALSE,0,0,"",1,26.5
2017,Wildcard,post,New Orleans Saints,Carolina Panthers,NO,31,26,5,6.5,57,47.5,FALSE,1,0,DOME,1.5,9.5
2017,Division,post,New England Patriots,Tennessee Titans,NE,35,14,21,13.5,49,48.5,FALSE,0,0,"",7.5,0.5
2017,Division,post,Philadelphia Eagles,Atlanta Falcons,ATL,15,10,5,2.5,25,40,FALSE,0,0,"",2.5,15
2017,Division,post,Minnesota Vikings,New Orleans Saints,MIN,29,24,5,5.5,53,46.5,FALSE,1,0,DOME,0.5,6.5
2017,Division,post,Pittsburgh Steelers,Jacksonville Jaguars,PIT,42,45,3,7,87,40.5,FALSE,0,0,"",4,46.5
2017,Conference,post,New England Patriots,Jacksonville Jaguars,NE,24,20,4,7.5,44,46,FALSE,0,0,"",3.5,2
2017,Conference,post,Philadelphia Eagles,Minnesota Vikings,MIN,38,7,31,3,45,39,FALSE,0,0,"",28,6
2017,Superbowl,post,New England Patriots,Philadelphia Eagles,NE,33,41,8,4.5,74,48.5,TRUE,1,0,DOME,3.5,25.5
2018,1,reg,Philadelphia Eagles,Atlanta Falcons,PHI,18,12,6,1,30,44.5,FALSE,0,1,Rain,5,14.5
2018,1,reg,Arizona Cardinals,Washington Redskins,ARI,6,24,18,2,30,43.5,FALSE,1,0,DOME,16,13.5
2018,1,reg,Baltimore Ravens,Buffalo Bills,BAL,47,3,44,7.5,50,39,FALSE,0,1,Rain,36.5,11
2018,1,reg,Carolina Panthers,Dallas Cowboys,CAR,16,8,8,2.5,24,42.5,FALSE,0,1,Rain,5.5,18.5
2018,1,reg,Cleveland Browns,Pittsburgh Steelers,PIT,21,21,0,3.5,42,41,FALSE,0,1,Rain,3.5,1
2018,1,reg,Denver Broncos,Seattle Seahawks,DEN,27,24,3,3,51,42.5,FALSE,0,0,"",0,8.5
2018,1,reg,Green Bay Packers,Chicago Bears,GB,24,23,1,6.5,47,45,FALSE,0,0,"",5.5,2
2018,1,reg,Indianapolis Colts,Cincinnati Bengals,CIN,23,34,11,1,57,47.5,FALSE,1,0,DOME,10,9.5
2018,1,reg,Los Angeles Chargers,Kansas City Chiefs,LAC,28,38,10,3.5,66,48,FALSE,0,0,"",6.5,18
2018,1,reg,Miami Dolphins,Tennessee Titans,TEN,27,20,7,1,47,43.5,FALSE,0,1,Rain,6,3.5
2018,1,reg,Minnesota Vikings,San Francisco 49ers,MIN,24,16,8,6,40,46.5,FALSE,1,0,DOME,2,6.5
2018,1,reg,New England Patriots,Houston Texans,NE,27,20,7,6,47,49.5,FALSE,0,0,"",1,2.5
2018,1,reg,New Orleans Saints,Tampa Bay Buccaneers,NO,40,48,8,10,88,50,FALSE,1,0,DOME,2,38
2018,1,reg,New York Giants,Jacksonville Jaguars,JAX,15,20,5,2.5,35,43,FALSE,0,1,Rain,2.5,8
2018,1,reg,Detroit Lions,New York Jets,DET,17,48,31,7,65,44,FALSE,1,0,DOME,24,21
2018,1,reg,Oakland Raiders,Los Angeles Rams,LAR,13,33,20,6.5,46,47.5,FALSE,0,0,"",13.5,1.5
2018,2,reg,Cincinnati Bengals,Baltimore Ravens,CIN,34,23,11,1,57,43,FALSE,0,0,"",10,14
2018,2,reg,Atlanta Falcons,Carolina Panthers,ATL,31,24,7,5.5,55,44,FALSE,1,0,DOME,1.5,11
2018,2,reg,Buffalo Bills,Los Angeles Chargers,LAC,20,31,11,7.5,51,41.5,FALSE,0,0,"",3.5,9.5
2018,2,reg,Dallas Cowboys,New York Giants,DAL,20,13,7,3,33,42,FALSE,1,0,DOME,4,9
2018,2,reg,Denver Broncos,Oakland Raiders,DEN,20,19,1,5.5,39,44,FALSE,0,0,"",4.5,5
2018,2,reg,Green Bay Packers,Minnesota Vikings,MIN,29,29,0,2,58,45,FALSE,0,0,"",2,13
2018,2,reg,Jacksonville Jaguars,New England Patriots,NE,31,20,11,2,51,44.5,FALSE,0,1,Rain,9,6.5
2018,2,reg,Los Angeles Rams,Arizona Cardinals,LAR,34,0,34,13.5,34,43.5,FALSE,0,0,"",20.5,9.5
2018,2,reg,New Orleans Saints,Cleveland Browns,NO,21,18,3,10,39,51,FALSE,1,0,DOME,7,12
2018,2,reg,New York Jets,Miami Dolphins,NYJ,12,20,8,3,32,43,FALSE,0,0,"",5,11
2018,2,reg,Pittsburgh Steelers,Kansas City Chiefs,PIT,37,42,5,4.5,79,52,FALSE,0,0,"",0.5,27
2018,2,reg,San Francisco 49ers,Detroit Lions,SF,30,27,3,6,57,48.5,FALSE,0,0,"",3,8.5
2018,2,reg,Tampa Bay Buccaneers,Philadelphia Eagles,PHI,27,21,6,3,48,46.5,FALSE,0,0,"",3,1.5
2018,2,reg,Tennessee Titans,Houston Texans,HOU,20,17,3,3.5,37,41,FALSE,0,0,"",0.5,4
2018,2,reg,Washington Redskins,Indianapolis Colts,WAS,9,21,12,6,30,48,FALSE,0,0,"",6,18
2018,2,reg,Chicago Bears,Seattle Seahawks,CHI,24,17,7,4.5,41,42.5,FALSE,0,0,"",2.5,1.5
2018,3,reg,Cleveland Browns,New York Jets,CLE,21,17,4,3,38,41,FALSE,0,0,"",1,3
2018,3,reg,Arizona Cardinals,Chicago Bears,CHI,14,16,2,5.5,30,39,FALSE,1,0,DOME,3.5,9
2018,3,reg,Atlanta Falcons,New Orleans Saints,ATL,37,43,6,1.5,80,54,FALSE,1,0,DOME,4.5,26
2018,3,reg,Baltimore Ravens,Denver Broncos,BAL,27,14,13,5.5,41,46,FALSE,0,1,Rain,7.5,5
2018,3,reg,Carolina Panthers,Cincinnati Bengals,CAR,31,21,10,2.5,52,44,FALSE,0,0,"",7.5,8
2018,3,reg,Detroit Lions,New England Patriots,NE,26,10,16,7,36,55,FALSE,1,0,DOME,9,19
2018,3,reg,Houston Texans,New York Giants,HOU,22,27,5,6.5,49,44,FALSE,1,0,DOME,1.5,5
2018,3,reg,Jacksonville Jaguars,Tennessee Titans,JAX,6,9,3,10,15,39,FALSE,0,0,"",7,24
2018,3,reg,Kansas City Chiefs,San Francisco 49ers,KC,38,27,11,5.5,65,53,FALSE,0,0,"",5.5,12
2018,3,reg,Los Angeles Rams,Los Angeles Chargers,LAR,35,23,12,7.5,58,49,FALSE,0,0,"",4.5,9
2018,3,reg,Miami Dolphins,Oakland Raiders,MIA,28,20,8,3,48,46,FALSE,0,0,"",5,2
2018,3,reg,Minnesota Vikings,Buffalo Bills,MIN,6,27,21,16.5,33,41,FALSE,1,0,DOME,4.5,8
2018,3,reg,Philadelphia Eagles,Indianapolis Colts,PHI,20,16,4,6.5,36,45.5,FALSE,0,1,Rain,2.5,9.5
2018,3,reg,Seattle Seahawks,Dallas Cowboys,SEA,24,13,11,1,37,40,FALSE,0,0,"",10,3
2018,3,reg,Washington Redskins,Green Bay Packers,GB,31,17,14,2.5,48,45.5,FALSE,0,1,Rain,11.5,2.5
2018,3,reg,Tampa Bay Buccaneers,Pittsburgh Steelers,PIT,27,30,3,1,57,55,FALSE,0,0,"",2,2
2018,4,reg,Los Angeles Rams,Minnesota Vikings,LAR,38,31,7,7.5,69,48.5,FALSE,0,0,"",0.5,20.5
2018,4,reg,Arizona Cardinals,Seattle Seahawks,SEA,17,20,3,3.5,37,40,FALSE,1,0,DOME,0.5,3
2018,4,reg,Atlanta Falcons,Cincinnati Bengals,ATL,36,37,1,3.5,73,52.5,FALSE,1,0,DOME,2.5,20.5
2018,4,reg,Chicago Bears,Tampa Bay Buccaneers,CHI,48,10,38,3,58,46,FALSE,0,0,"",35,12
2018,4,reg,Dallas Cowboys,Detroit Lions,DAL,26,24,2,2.5,50,43.5,FALSE,1,0,DOME,0.5,6.5
2018,4,reg,Green Bay Packers,Buffalo Bills,GB,22,0,22,8.5,22,43.5,FALSE,0,0,"",13.5,21.5
2018,4,reg,Indianapolis Colts,Houston Texans,IND,34,37,3,1,71,48,FALSE,1,0,DOME,2,23
2018,4,reg,Jacksonville Jaguars,New York Jets,JAX,31,12,19,7.5,43,40.5,FALSE,0,0,"",11.5,2.5
2018,4,reg,Los Angeles Chargers,San Francisco 49ers,LAC,29,27,2,10.5,56,46,FALSE,0,0,"",8.5,10
2018,4,reg,New England Patriots,Miami Dolphins,NE,38,7,31,6.5,45,50.5,FALSE,0,0,"",24.5,5.5
2018,4,reg,New York Giants,New Orleans Saints,NO,18,33,15,3.5,51,51.5,FALSE,0,0,"",11.5,0.5
2018,4,reg,Oakland Raiders,Cleveland Browns,OAK,45,42,3,2.5,87,44.5,FALSE,0,0,"",0.5,42.5
2018,4,reg,Pittsburgh Steelers,Baltimore Ravens,PIT,14,26,12,3,40,51,FALSE,0,0,"",9,11
2018,4,reg,Tennessee Titans,Philadelphia Eagles,PHI,26,23,3,3,49,41.5,FALSE,0,0,"",0,7.5
2018,4,reg,Denver Broncos,Kansas City Chiefs,KC,23,27,4,3.5,50,53.5,FALSE,0,0,"",0.5,3.5
2018,5,reg,New England Patriots,Indianapolis Colts,NE,38,24,14,10.5,62,49.5,FALSE,0,0,"",3.5,12.5
2018,5,reg,Buffalo Bills,Tennessee Titans,TEN,13,12,1,6,25,38.5,FALSE,0,0,"",5,13.5
2018,5,reg,Carolina Panthers,New York Giants,CAR,33,31,2,7,64,43.5,FALSE,0,0,"",5,20.5
2018,5,reg,Cincinnati Bengals,Miami Dolphins,CIN,27,17,10,6.5,44,47.5,FALSE,0,0,"",3.5,3.5
2018,5,reg,Cleveland Browns,Baltimore Ravens,BAL,12,9,3,3,21,44.5,FALSE,0,0,"",0,23.5
2018,5,reg,Detroit Lions,Green Bay Packers,GB,31,23,8,1,54,50,FALSE,1,0,DOME,7,4
2018,5,reg,Houston Texans,Dallas Cowboys,HOU,19,16,3,3.5,35,45.5,FALSE,1,0,DOME,0.5,10.5
2018,5,reg,Kansas City Chiefs,Jacksonville Jaguars,KC,30,14,16,3,44,48,FALSE,0,1,Rain,13,4
2018,5,reg,Los Angeles Chargers,Oakland Raiders,LAC,26,10,16,5,36,52,FALSE,0,0,"",11,16
2018,5,reg,New York Jets,Denver Broncos,NYJ,34,16,18,1,50,43,FALSE,0,0,"",17,7
2018,5,reg,Philadelphia Eagles,Minnesota Vikings,PHI,21,23,2,3.5,44,48,FALSE,0,0,"",1.5,4
2018,5,reg,Pittsburgh Steelers,Atlanta Falcons,PIT,41,17,24,3.5,58,57,FALSE,0,0,"",20.5,1
2018,5,reg,San Francisco 49ers,Arizona Cardinals,SF,18,28,10,3,46,40.5,FALSE,0,0,"",7,5.5
2018,5,reg,Seattle Seahawks,Los Angeles Rams,LAR,31,33,2,7.5,64,50.5,FALSE,0,0,"",5.5,13.5
2018,5,reg,New Orleans Saints,Washington Redskins,NO,43,19,24,5.5,62,51.5,FALSE,1,0,DOME,18.5,10.5
2018,6,reg,New York Giants,Philadelphia Eagles,PHI,13,34,21,1.5,47,45,FALSE,0,1,Rain,19.5,2
2018,6,reg,Atlanta Falcons,Tampa Bay Buccaneers,ATL,34,29,5,3,63,57,FALSE,1,0,DOME,2,6
2018,6,reg,Cincinnati Bengals,Pittsburgh Steelers,CIN,21,28,7,1.5,49,49.5,FALSE,0,0,"",5.5,0.5
2018,6,reg,Cleveland Browns,Los Angeles Chargers,CLE,14,38,24,1,52,47,FALSE,0,0,"",23,5
2018,6,reg,Dallas Cowboys,Jacksonville Jaguars,JAX,40,7,33,3,47,39,FALSE,1,0,DOME,30,8
2018,6,reg,Denver Broncos,Los Angeles Rams,LAR,20,23,3,7,43,50,FALSE,0,0,"",4,7
2018,6,reg,Houston Texans,Buffalo Bills,HOU,20,13,7,10.5,33,40.5,FALSE,1,0,DOME,3.5,7.5
2018,6,reg,Miami Dolphins,Chicago Bears,CHI,31,28,3,7.5,59,40.5,FALSE,0,0,"",4.5,18.5
2018,6,reg,Minnesota Vikings,Arizona Cardinals,MIN,27,17,10,10,44,43.5,FALSE,1,0,DOME,0,0.5
2018,6,reg,New England Patriots,Kansas City Chiefs,NE,43,40,3,3.5,83,59.5,FALSE,0,0,"",0.5,23.5
2018,6,reg,New York Jets,Indianapolis Colts,NYJ,42,34,8,2.5,76,47.5,FALSE,0,0,"",5.5,28.5
2018,6,reg,Oakland Raiders,Seattle Seahawks,SEA,3,27,24,3,30,48,TRUE,0,1,Rain,21,18
2018,6,reg,Tennessee Titans,Baltimore Ravens,BAL,0,21,21,2.5,21,43.5,FALSE,0,0,"",18.5,22.5
2018,6,reg,Washington Redskins,Carolina Panthers,CAR,23,17,6,1,40,44.5,FALSE,0,0,"",5,4.5
2018,6,reg,Green Bay Packers,San Francisco 49ers,GB,33,30,3,9,63,46.5,FALSE,0,0,"",6,16.5
2018,7,reg,Arizona Cardinals,Denver Broncos,DEN,10,45,35,1,55,42.5,FALSE,1,0,DOME,34,12.5
2018,7,reg,Baltimore Ravens,New Orleans Saints,BAL,23,24,1,2.5,47,49,FALSE,0,0,"",1.5,2
2018,7,reg,Chicago Bears,New England Patriots,NE,31,38,7,1,69,48.5,FALSE,0,0,"",6,20.5
2018,7,reg,Indianapolis Colts,Buffalo Bills,IND,37,5,32,7,42,43.5,FALSE,1,0,DOME,25,1.5
2018,7,reg,Jacksonville Jaguars,Houston Texans,JAX,7,20,13,3.5,27,42.5,FALSE,0,0,"",9.5,15.5
2018,7,reg,Kansas City Chiefs,Cincinnati Bengals,KC,45,10,35,6.5,55,56,FALSE,0,0,"",28.5,1
2018,7,reg,Los Angeles Chargers,Tennessee Titans,LAC,20,19,1,6.5,39,46,TRUE,0,0,"",5.5,7
2018,7,reg,Miami Dolphins,Detroit Lions,DET,21,32,11,3,53,47,FALSE,0,0,"",8,6
2018,7,reg,New York Jets,Minnesota Vikings,MIN,17,37,20,3.5,54,45,FALSE,0,0,"",16.5,9
2018,7,reg,Philadelphia Eagles,Carolina Panthers,PHI,17,21,4,5,38,45,FALSE,0,0,"",1,7
2018,7,reg,San Francisco 49ers,Los Angeles Rams,LAR,10,39,29,8,49,52,FALSE,0,0,"",21,3
2018,7,reg,Tampa Bay Buccaneers,Cleveland Browns,TB,26,23,3,3.5,49,52.5,FALSE,0,0,"",0.5,3.5
2018,7,reg,Washington Redskins,Dallas Cowboys,DAL,20,17,3,1,37,40.5,FALSE,0,0,"",2,3.5
2018,7,reg,Atlanta Falcons,New York Giants,ATL,23,20,3,4,43,53,FALSE,1,0,DOME,1,10
2018,8,reg,Houston Texans,Miami Dolphins,HOU,42,23,19,7.5,65,45,FALSE,1,0,DOME,11.5,20
2018,8,reg,Arizona Cardinals,San Francisco 49ers,ARI,18,15,3,2.5,33,40,FALSE,1,0,DOME,0.5,7
2018,8,reg,Carolina Panthers,Baltimore Ravens,BAL,36,21,15,2.5,57,44,FALSE,0,0,"",12.5,13
2018,8,reg,Chicago Bears,New York Jets,CHI,24,10,14,8.5,34,42.5,FALSE,0,0,"",5.5,8.5
2018,8,reg,Cincinnati Bengals,Tampa Bay Buccaneers,CIN,37,34,3,3.5,71,55,FALSE,0,0,"",0.5,16
2018,8,reg,Detroit Lions,Seattle Seahawks,DET,14,28,14,3,42,48,FALSE,1,0,DOME,11,6
2018,8,reg,Jacksonville Jaguars,Philadelphia Eagles,PHI,18,24,6,3.5,42,44,TRUE,0,0,"",2.5,2
2018,8,reg,Kansas City Chiefs,Denver Broncos,KC,30,23,7,8.5,53,53,FALSE,0,0,"",1.5,0
2018,8,reg,Los Angeles Rams,Green Bay Packers,LAR,29,27,2,7.5,56,57,FALSE,0,0,"",5.5,1
2018,8,reg,Minnesota Vikings,New Orleans Saints,MIN,20,30,10,2.5,50,53.5,FALSE,1,0,DOME,7.5,3.5
2018,8,reg,New York Giants,Washington Redskins,WAS,13,20,7,1,33,44,FALSE,0,0,"",6,11
2018,8,reg,Oakland Raiders,Indianapolis Colts,IND,28,42,14,3.5,70,51,FALSE,0,0,"",10.5,19
2018,8,reg,Pittsburgh Steelers,Cleveland Browns,PIT,33,18,15,8.5,51,47.5,FALSE,0,0,"",6.5,3.5
2018,8,reg,Buffalo Bills,New England Patriots,NE,6,25,19,13.5,31,44.5,FALSE,0,0,"",5.5,13.5
2018,9,reg,San Francisco 49ers,Oakland Raiders,OAK,34,3,31,1.5,37,44,FALSE,0,0,"",29.5,7
2018,9,reg,Baltimore Ravens,Pittsburgh Steelers,BAL,16,23,7,1.5,39,46.5,FALSE,0,0,"",5.5,7.5
2018,9,reg,Buffalo Bills,Chicago Bears,CHI,9,41,32,10.5,50,38,FALSE,0,0,"",21.5,12
2018,9,reg,Carolina Panthers,Tampa Bay Buccaneers,CAR,42,28,14,6,70,55.5,FALSE,0,0,"",8,14.5
2018,9,reg,Cleveland Browns,Kansas City Chiefs,KC,21,37,16,7.5,58,51.5,FALSE,0,0,"",8.5,6.5
2018,9,reg,Denver Broncos,Houston Texans,DEN,17,19,2,1,36,46.5,FALSE,0,0,"",1,10.5
2018,9,reg,Miami Dolphins,New York Jets,MIA,13,6,7,3,19,43,FALSE,0,0,"",4,24
2018,9,reg,Minnesota Vikings,Detroit Lions,MIN,24,9,15,4.5,33,47.5,FALSE,1,0,DOME,10.5,14.5
2018,9,reg,New England Patriots,Green Bay Packers,NE,31,17,14,5,48,56,FALSE,0,0,"",9,8
2018,9,reg,New Orleans Saints,Los Angeles Rams,LAR,45,35,10,1.5,80,57,FALSE,1,0,DOME,8.5,23
2018,9,reg,Seattle Seahawks,Los Angeles Chargers,SEA,17,25,8,1,42,48,FALSE,0,1,Rain,7,6
2018,9,reg,Washington Redskins,Atlanta Falcons,WAS,14,38,24,1.5,52,46.5,FALSE,0,0,"",22.5,5.5
2018,9,reg,Dallas Cowboys,Tennessee Titans,DAL,14,28,14,4.5,42,40.5,FALSE,1,0,DOME,9.5,1.5
2018,10,reg,Pittsburgh Steelers,Carolina Panthers,PIT,52,21,31,3.5,73,51,FALSE,0,0,"",27.5,22
2018,10,reg,Chicago Bears,Detroit Lions,CHI,34,22,12,7.5,56,44.5,FALSE,0,0,"",4.5,11.5
2018,10,reg,Cincinnati Bengals,New Orleans Saints,NO,14,51,37,6,65,53.5,FALSE,0,0,"",31,11.5
2018,10,reg,Cleveland Browns,Atlanta Falcons,ATL,28,16,12,5.5,44,49.5,FALSE,0,0,"",6.5,5.5
2018,10,reg,Green Bay Packers,Miami Dolphins,GB,31,12,19,11,43,48.5,FALSE,0,0,"",8,5.5
2018,10,reg,Indianapolis Colts,Jacksonville Jaguars,IND,29,26,3,3,55,48,FALSE,1,0,DOME,0,7
2018,10,reg,Kansas City Chiefs,Arizona Cardinals,KC,26,14,12,16.5,40,49.5,FALSE,0,0,"",4.5,9.5
2018,10,reg,Los Angeles Rams,Seattle Seahawks,LAR,36,31,5,10,67,51,FALSE,0,0,"",5,16
2018,10,reg,New York Jets,Buffalo Bills,NYJ,10,41,31,7,51,38,FALSE,0,0,"",24,13
2018,10,reg,Oakland Raiders,Los Angeles Chargers,LAC,6,20,14,10.5,26,50,FALSE,0,0,"",3.5,24
2018,10,reg,Philadelphia Eagles,Dallas Cowboys,PHI,20,27,7,7.5,47,45.5,FALSE,0,0,"",0.5,1.5
2018,10,reg,Tampa Bay Buccaneers,Washington Redskins,TB,3,16,13,3.5,19,51,FALSE,0,0,"",9.5,32
2018,10,reg,Tennessee Titans,New England Patriots,NE,34,10,24,6.5,44,47,FALSE,0,0,"",17.5,3
2018,10,reg,San Francisco 49ers,New York Giants,SF,23,27,4,3,50,45,FALSE,0,0,"",1,5
2018,11,reg,Seattle Seahawks,Green Bay Packers,SEA,27,24,3,3,51,49,FALSE,0,0,"",0,2
2018,11,reg,Arizona Cardinals,Oakland Raiders,ARI,21,23,2,4.5,44,41,FALSE,1,0,DOME,2.5,3
2018,11,reg,Atlanta Falcons,Dallas Cowboys,ATL,19,22,3,3.5,41,50,FALSE,1,0,DOME,0.5,9
2018,11,reg,Baltimore Ravens,Cincinnati Bengals,BAL,24,21,3,6.5,45,44,FALSE,0,0,"",3.5,1
2018,11,reg,Chicago Bears,Minnesota Vikings,CHI,25,20,5,2.5,45,44,FALSE,0,0,"",2.5,1
2018,11,reg,Detroit Lions,Carolina Panthers,CAR,20,19,1,4,39,48,FALSE,1,0,DOME,3,9
2018,11,reg,Indianapolis Colts,Tennessee Titans,IND,38,10,28,1,48,50,FALSE,1,0,DOME,27,2
2018,11,reg,Jacksonville Jaguars,Pittsburgh Steelers,PIT,16,20,4,4,36,47,FALSE,0,0,"",0,11
2018,11,reg,Los Angeles Chargers,Denver Broncos,LAC,22,23,1,7.5,45,46.5,FALSE,0,0,"",6.5,1.5
2018,11,reg,New Orleans Saints,Philadelphia Eagles,NO,48,7,41,7,55,56.5,FALSE,1,0,DOME,34,1.5
2018,11,reg,New York Giants,Tampa Bay Buccaneers,NYG,38,35,3,3,73,53.5,FALSE,0,0,"",0,19.5
2018,11,reg,Washington Redskins,Houston Texans,HOU,21,23,2,3,44,40.5,FALSE,0,0,"",1,3.5
2018,11,reg,Los Angeles Rams,Kansas City Chiefs,LAR,54,51,3,3,105,63.5,FALSE,0,0,"",0,41.5
2018,12,reg,Dallas Cowboys,Washington Redskins,DAL,31,23,8,7,54,40,FALSE,1,0,DOME,1,14
2018,12,reg,Detroit Lions,Chicago Bears,CHI,16,23,7,3,39,43,FALSE,1,0,DOME,4,4
2018,12,reg,New Orleans Saints,Atlanta Falcons,NO,31,17,14,11.5,48,61.5,FALSE,1,0,DOME,2.5,13.5
2018,12,reg,Baltimore Ravens,Oakland Raiders,BAL,34,17,17,13,51,42,FALSE,0,0,"",4,9
2018,12,reg,Buffalo Bills,Jacksonville Jaguars,JAX,24,21,3,3,45,36.5,FALSE,0,0,"",0,8.5
2018,12,reg,Carolina Panthers,Seattle Seahawks,CAR,27,30,3,3,57,46.5,FALSE,0,0,"",0,10.5
2018,12,reg,Cincinnati Bengals,Cleveland Browns,CLE,20,35,15,1,55,46.5,FALSE,0,0,"",14,8.5
2018,12,reg,Denver Broncos,Pittsburgh Steelers,PIT,24,17,7,3,41,47.5,FALSE,0,0,"",4,6.5
2018,12,reg,Indianapolis Colts,Miami Dolphins,IND,27,24,3,9,51,52.5,FALSE,1,0,DOME,6,1.5
2018,12,reg,Los Angeles Chargers,Arizona Cardinals,LAC,45,10,35,14,55,43,FALSE,0,0,"",21,12
2018,12,reg,Minnesota Vikings,Green Bay Packers,MIN,24,17,7,3.5,41,48,FALSE,1,0,DOME,3.5,7
2018,12,reg,New York Jets,New England Patriots,NE,13,27,14,13,40,46.5,FALSE,0,0,"",1,6.5
2018,12,reg,Philadelphia Eagles,New York Giants,PHI,25,22,3,4.5,47,49,FALSE,0,0,"",1.5,2
2018,12,reg,Tampa Bay Buccaneers,San Francisco 49ers,TB,27,9,18,1.5,36,54.5,FALSE,0,0,"",16.5,18.5
2018,12,reg,Houston Texans,Tennessee Titans,HOU,34,17,17,3.5,51,42.5,FALSE,1,0,DOME,13.5,8.5
2018,13,reg,Dallas Cowboys,New Orleans Saints,NO,13,10,3,7.5,23,51.5,FALSE,1,0,DOME,4.5,28.5
2018,13,reg,Atlanta Falcons,Baltimore Ravens,ATL,16,26,10,2.5,42,46.5,FALSE,1,0,DOME,7.5,4.5
2018,13,reg,Cincinnati Bengals,Denver Broncos,DEN,10,24,14,4,34,45,FALSE,0,0,"",10,11
2018,13,reg,Detroit Lions,Los Angeles Rams,LAR,16,30,14,10.5,46,54,FALSE,1,0,DOME,3.5,8
2018,13,reg,Green Bay Packers,Arizona Cardinals,GB,17,20,3,13.5,37,41,FALSE,0,1,Rain,10.5,4
2018,13,reg,Houston Texans,Cleveland Browns,HOU,29,13,16,5,42,47.5,FALSE,1,0,DOME,11,5.5
2018,13,reg,Jacksonville Jaguars,Indianapolis Colts,IND,6,0,6,4,6,45.5,FALSE,0,1,Rain,2,39.5
2018,13,reg,Miami Dolphins,Buffalo Bills,MIA,21,17,4,3.5,38,40,FALSE,0,0,"",0.5,2
2018,13,reg,New England Patriots,Minnesota Vikings,NE,24,10,14,6,34,49.5,FALSE,0,0,"",8,15.5
2018,13,reg,New York Giants,Chicago Bears,CHI,30,27,3,4,57,44,FALSE,0,1,Fog,1,13
2018,13,reg,Oakland Raiders,Kansas City Chiefs,KC,33,40,7,14,73,53.5,FALSE,0,0,"",7,19.5
2018,13,reg,Pittsburgh Steelers,Los Angeles Chargers,PIT,30,33,3,3,63,52.5,FALSE,0,0,"",0,10.5
2018,13,reg,Seattle Seahawks,San Francisco 49ers,SEA,43,16,27,10,59,45.5,FALSE,0,0,"",17,13.5
2018,13,reg,Tampa Bay Buccaneers,Carolina Panthers,CAR,24,17,7,3.5,41,52,FALSE,0,0,"",3.5,11
2018,13,reg,Tennessee Titans,New York Jets,TEN,26,22,4,10.5,48,40.5,FALSE,0,0,"",6.5,7.5
2018,13,reg,Philadelphia Eagles,Washington Redskins,PHI,28,13,15,5.5,41,45,FALSE,0,0,"",9.5,4
2018,14,reg,Tennessee Titans,Jacksonville Jaguars,TEN,30,9,21,5.5,39,37.5,FALSE,0,0,"",15.5,1.5
2018,14,reg,Arizona Cardinals,Detroit Lions,DET,3,17,14,2.5,20,40.5,FALSE,1,0,DOME,11.5,20.5
2018,14,reg,Buffalo Bills,New York Jets,BUF,23,27,4,4.5,50,37,FALSE,0,0,"",0.5,13
2018,14,reg,Chicago Bears,Los Angeles Rams,LAR,15,6,9,3,21,51,FALSE,0,0,"",6,30
2018,14,reg,Cleveland Browns,Carolina Panthers,CAR,26,20,6,1,46,47.5,FALSE,0,0,"",5,1.5
2018,14,reg,Dallas Cowboys,Philadelphia Eagles,DAL,29,23,6,3.5,52,45.5,FALSE,1,0,DOME,2.5,6.5
2018,14,reg,Green Bay Packers,Atlanta Falcons,GB,34,20,14,4,54,50.5,FALSE,0,0,"",10,3.5
2018,14,reg,Houston Texans,Indianapolis Colts,HOU,21,24,3,4,45,49,FALSE,1,0,DOME,1,4
2018,14,reg,Kansas City Chiefs,Baltimore Ravens,KC,27,24,3,6.5,51,48.5,FALSE,0,0,"",3.5,2.5
2018,14,reg,Los Angeles Chargers,Cincinnati Bengals,LAC,26,21,5,17,47,48.5,FALSE,0,0,"",12,1.5
2018,14,reg,Miami Dolphins,New England Patriots,NE,34,33,1,9.5,67,49.5,FALSE,0,0,"",8.5,17.5
2018,14,reg,Oakland Raiders,Pittsburgh Steelers,PIT,24,21,3,10.5,45,51,FALSE,0,0,"",7.5,6
2018,14,reg,San Francisco 49ers,Denver Broncos,DEN,20,14,6,3,34,45.5,FALSE,0,0,"",3,11.5
2018,14,reg,Tampa Bay Buccaneers,New Orleans Saints,NO,14,28,14,10,42,54,FALSE,0,1,Rain,4,12
2018,14,reg,Washington Redskins,New York Giants,NYG,16,40,24,3,56,40.5,FALSE,0,0,"",21,15.5
2018,14,reg,Seattle Seahawks,Minnesota Vikings,SEA,21,7,14,3,28,45.5,FALSE,0,0,"",11,17.5
2018,15,reg,Kansas City Chiefs,Los Angeles Chargers,KC,28,29,1,3.5,57,54,FALSE,0,1,Rain,2.5,3
2018,15,reg,Denver Broncos,Cleveland Browns,DEN,16,17,1,1,33,47,FALSE,0,0,"",0,14
2018,15,reg,New York Jets,Houston Texans,HOU,22,29,7,7,51,44,FALSE,0,1,Rain,0,7
2018,15,reg,Atlanta Falcons,Arizona Cardinals,ATL,40,14,26,10,54,43.5,FALSE,1,0,DOME,16,10.5
2018,15,reg,Baltimore Ravens,Tampa Bay Buccaneers,BAL,20,12,8,8.5,32,45,FALSE,0,1,Rain,0.5,13
2018,15,reg,Buffalo Bills,Detroit Lions,BUF,14,13,1,2.5,27,40,FALSE,0,1,Rain,1.5,13
2018,15,reg,Chicago Bears,Green Bay Packers,CHI,24,17,7,5.5,41,46.5,FALSE,0,0,"",1.5,5.5
2018,15,reg,Cincinnati Bengals,Oakland Raiders,CIN,30,16,14,3,46,46,FALSE,0,0,"",11,0
2018,15,reg,Indianapolis Colts,Dallas Cowboys,IND,23,0,23,3,23,46.5,FALSE,1,0,DOME,20,23.5
2018,15,reg,Jacksonville Jaguars,Washington Redskins,JAX,13,16,3,7.5,29,36.5,FALSE,0,0,"",4.5,7.5
2018,15,reg,Los Angeles Rams,Philadelphia Eagles,LAR,23,30,7,13.5,53,52.5,FALSE,0,0,"",6.5,0.5
2018,15,reg,Minnesota Vikings,Miami Dolphins,MIN,41,17,24,7.5,58,45,FALSE,1,0,DOME,16.5,13
2018,15,reg,New York Giants,Tennessee Titans,TEN,0,17,17,2.5,17,42,FALSE,0,1,Rain,14.5,25
2018,15,reg,Pittsburgh Steelers,New England Patriots,NE,17,10,7,2.5,27,56,FALSE,0,0,"",4.5,29
2018,15,reg,San Francisco 49ers,Seattle Seahawks,SEA,26,23,3,3.5,49,44,FALSE,0,0,"",0.5,5
2018,15,reg,Carolina Panthers,New Orleans Saints,NO,9,12,3,6,21,50.5,FALSE,0,0,"",3,29.5
2018,16,reg,Los Angeles Chargers,Baltimore Ravens,LAC,10,22,12,4,32,42.5,FALSE,0,0,"",8,10.5
2018,16,reg,Tennessee Titans,Washington Redskins,TEN,25,16,9,11.5,41,37.5,FALSE,0,0,"",2.5,3.5
2018,16,reg,Arizona Cardinals,Los Angeles Rams,LAR,9,31,22,14.5,40,43,FALSE,1,0,DOME,7.5,3
2018,16,reg,Carolina Panthers,Atlanta Falcons,ATL,10,24,14,3,34,46,FALSE,0,0,"",11,12
2018,16,reg,Cleveland Browns,Cincinnati Bengals,CLE,26,18,8,10,44,44,FALSE,0,0,"",2,0
2018,16,reg,Dallas Cowboys,Tampa Bay Buccaneers,DAL,27,20,7,7.5,47,48,FALSE,1,0,DOME,0.5,1
2018,16,reg,Detroit Lions,Minnesota Vikings,MIN,9,27,18,6.5,36,42.5,FALSE,1,0,DOME,11.5,6.5
2018,16,reg,Indianapolis Colts,New York Giants,IND,28,27,1,10,55,48.5,FALSE,1,0,DOME,9,6.5
2018,16,reg,Miami Dolphins,Jacksonville Jaguars,MIA,7,17,10,3,24,39.5,FALSE,0,0,"",7,15.5
2018,16,reg,New England Patriots,Buffalo Bills,NE,24,12,12,13.5,36,45,FALSE,0,0,"",1.5,9
2018,16,reg,New Orleans Saints,Pittsburgh Steelers,NO,31,28,3,6.5,59,53,FALSE,1,0,DOME,3.5,6
2018,16,reg,New York Jets,Green Bay Packers,GB,38,44,6,3,82,47.5,FALSE,0,0,"",3,34.5
2018,16,reg,Philadelphia Eagles,Houston Texans,PHI,32,30,2,1,62,46.5,FALSE,0,0,"",1,15.5
2018,16,reg,San Francisco 49ers,Chicago Bears,CHI,9,14,5,4,23,44,FALSE,0,0,"",1,21
2018,16,reg,Seattle Seahawks,Kansas City Chiefs,KC,38,31,7,1,69,54.5,FALSE,0,0,"",6,14.5
2018,16,reg,Oakland Raiders,Denver Broncos,DEN,27,14,13,2.5,41,42.5,FALSE,0,1,Rain,10.5,1.5
2018,17,reg,Baltimore Ravens,Cleveland Browns,BAL,26,24,2,7,50,41,FALSE,0,0,"",5,9
2018,17,reg,Buffalo Bills,Miami Dolphins,BUF,42,17,25,5.5,59,39.5,FALSE,0,0,"",19.5,19.5
2018,17,reg,Denver Broncos,Los Angeles Chargers,LAC,9,23,14,7,32,43.5,FALSE,0,0,"",7,11.5
2018,17,reg,Green Bay Packers,Detroit Lions,GB,0,31,31,7.5,31,44.5,FALSE,0,0,"",23.5,13.5
2018,17,reg,Houston Texans,Jacksonville Jaguars,HOU,20,3,17,7,23,39.5,FALSE,1,0,DOME,10,16.5
2018,17,reg,Kansas City Chiefs,Oakland Raiders,KC,35,3,32,14.5,38,52.5,FALSE,0,0,"",17.5,14.5
2018,17,reg,Los Angeles Rams,San Francisco 49ers,LAR,48,32,16,10.5,80,49.5,FALSE,0,0,"",5.5,30.5
2018,17,reg,Minnesota Vikings,Chicago Bears,MIN,10,24,14,6,34,40.5,FALSE,1,0,DOME,8,6.5
2018,17,reg,New England Patriots,New York Jets,NE,38,3,35,14.5,41,46.5,FALSE,0,0,"",20.5,5.5
2018,17,reg,New Orleans Saints,Carolina Panthers,NO,14,33,19,8,47,42,FALSE,1,0,DOME,11,5
2018,17,reg,New York Giants,Dallas Cowboys,NYG,35,36,1,7.5,71,38.5,FALSE,0,0,"",6.5,32.5
2018,17,reg,Pittsburgh Steelers,Cincinnati Bengals,PIT,16,13,3,14,29,45,FALSE,0,0,"",11,16
2018,17,reg,Seattle Seahawks,Arizona Cardinals,SEA,27,24,3,14,51,39.5,FALSE,0,0,"",11,11.5
2018,17,reg,Tampa Bay Buccaneers,Atlanta Falcons,ATL,32,34,2,2.5,66,51.5,FALSE,0,0,"",0.5,14.5
2018,17,reg,Tennessee Titans,Indianapolis Colts,IND,17,33,16,5.5,50,42.5,FALSE,0,0,"",10.5,7.5
2018,17,reg,Washington Redskins,Philadelphia Eagles,PHI,0,24,24,6,24,42.5,FALSE,0,0,"",18,18.5
2018,Wildcard,post,Dallas Cowboys,Seattle Seahawks,DAL,24,22,2,2.5,46,43,FALSE,1,0,DOME,0.5,3
2018,Wildcard,post,Houston Texans,Indianapolis Colts,HOU,7,21,14,2,28,48.5,FALSE,1,0,DOME,12,20.5
2018,Wildcard,post,Baltimore Ravens,Los Angeles Chargers,BAL,17,23,6,3,40,43,FALSE,0,0,"",3,3
2018,Wildcard,post,Chicago Bears,Philadelphia Eagles,CHI,15,16,1,6.5,31,41.5,FALSE,0,0,"",5.5,10.5
2018,Division,post,Kansas City Chiefs,Indianapolis Colts,KC,31,13,18,4,44,54,FALSE,0,0,"",14,10
2018,Division,post,Los Angeles Rams,Dallas Cowboys,LAR,30,22,8,7.5,52,48,FALSE,0,0,"",0.5,4
2018,Division,post,New England Patriots,Los Angeles Chargers,NE,41,28,13,3.5,69,47.5,FALSE,0,0,"",9.5,21.5
2018,Division,post,New Orleans Saints,Philadelphia Eagles,NO,20,14,6,8.5,34,52,FALSE,1,0,DOME,2.5,18
2018,Conference,post,Kansas City Chiefs,New England Patriots,KC,31,37,6,3,68,56,FALSE,0,0,"",3,12
2018,Conference,post,New Orleans Saints,Los Angeles Rams,NO,23,26,3,3,49,55.5,FALSE,1,0,DOME,0,6.5
2018,Superbowl,post,Los Angeles Rams,New England Patriots,NE,3,13,10,2,16,55.5,TRUE,1,0,DOME,8,39.5
2019,1,reg,Chicago Bears,Green Bay Packers,CHI,3,10,7,3,13,46.5,FALSE,0,0,"",4,33.5
2019,1,reg,Arizona Cardinals,Detroit Lions,DET,27,27,0,3,54,45.5,FALSE,1,0,DOME,3,8.5
2019,1,reg,Carolina Panthers,Los Angeles Rams,LAR,27,30,3,2,57,49.5,FALSE,0,0,"",1,7.5
2019,1,reg,Cleveland Browns,Tennessee Titans,CLE,13,43,30,5.5,56,44,FALSE,0,0,"",24.5,12
2019,1,reg,Dallas Cowboys,New York Giants,DAL,35,17,18,7,52,44,FALSE,1,0,DOME,11,8
2019,1,reg,Jacksonville Jaguars,Kansas City Chiefs,KC,26,40,14,3.5,66,49,FALSE,0,0,"",10.5,17
2019,1,reg,Los Angeles Chargers,Indianapolis Colts,LAC,30,24,6,6,54,44.5,FALSE,0,0,"",0,9.5
2019,1,reg,Miami Dolphins,Baltimore Ravens,BAL,10,59,49,7,69,40.5,FALSE,0,0,"",42,28.5
2019,1,reg,Minnesota Vikings,Atlanta Falcons,MIN,28,12,16,3.5,40,47,FALSE,0,0,"",12.5,7
2019,1,reg,New England Patriots,Pittsburgh Steelers,NE,33,3,30,5.5,36,49,FALSE,0,0,"",24.5,13
2019,1,reg,New York Jets,Buffalo Bills,NYJ,16,17,1,2.5,33,41,FALSE,0,0,"",1.5,8
2019,1,reg,Philadelphia Eagles,Washington Redskins,PHI,32,27,5,10,59,44.5,FALSE,0,0,"",5,14.5
2019,1,reg,Seattle Seahawks,Cincinnati Bengals,SEA,21,20,1,9,41,44,FALSE,0,0,"",8,3
2019,1,reg,Tampa Bay Buccaneers,San Francisco 49ers,TB,17,31,14,1,48,51,FALSE,0,0,"",13,3
2019,1,reg,New Orleans Saints,Houston Texans,NO,30,28,2,6.5,58,51.5,FALSE,1,0,DOME,4.5,6.5
2019,1,reg,Oakland Raiders,Denver Broncos,DEN,24,16,8,3,40,42.5,FALSE,0,0,"",5,2.5
2019,2,reg,Carolina Panthers,Tampa Bay Buccaneers,CAR,14,20,6,6.5,34,48,FALSE,0,0,"",0.5,14
2019,2,reg,Atlanta Falcons,Philadelphia Eagles,PHI,24,20,4,1,44,53,FALSE,1,0,DOME,3,9
2019,2,reg,Baltimore Ravens,Arizona Cardinals,BAL,23,17,6,13,40,45.5,FALSE,0,0,"",7,5.5
2019,2,reg,Cincinnati Bengals,San Francisco 49ers,CIN,17,41,24,1,58,46,FALSE,0,0,"",23,12
2019,2,reg,Denver Broncos,Chicago Bears,CHI,14,16,2,3,30,40.5,FALSE,0,0,"",1,10.5
2019,2,reg,Detroit Lions,Los Angeles Chargers,LAC,13,10,3,1,23,46.5,FALSE,1,0,DOME,2,23.5
2019,2,reg,Green Bay Packers,Minnesota Vikings,GB,21,16,5,3,37,43,FALSE,0,0,"",2,6
2019,2,reg,Houston Texans,Jacksonville Jaguars,HOU,13,12,1,7,25,43,FALSE,1,0,DOME,6,18
2019,2,reg,Los Angeles Rams,New Orleans Saints,LAR,27,9,18,2,36,52,FALSE,0,0,"",16,16
2019,2,reg,Miami Dolphins,New England Patriots,NE,0,43,43,18,43,48.5,FALSE,0,0,"",25,5.5
2019,2,reg,New York Giants,Buffalo Bills,BUF,14,28,14,1,42,44.5,FALSE,0,0,"",13,2.5
2019,2,reg,Oakland Raiders,Kansas City Chiefs,KC,10,28,18,7,38,53,FALSE,0,0,"",11,15
2019,2,reg,Pittsburgh Steelers,Seattle Seahawks,PIT,26,28,2,4,54,47,FALSE,0,0,"",2,7
2019,2,reg,Tennessee Titans,Indianapolis Colts,TEN,17,19,2,3.5,36,43.5,FALSE,0,0,"",1.5,7.5
2019,2,reg,Washington Redskins,Dallas Cowboys,DAL,21,31,10,6,52,46,FALSE,0,0,"",4,6
2019,2,reg,New York Jets,Cleveland Browns,CLE,3,23,20,6.5,26,45,FALSE,0,0,"",13.5,19
2019,3,reg,Jacksonville Jaguars,Tennessee Titans,TEN,20,7,13,2,27,38,FALSE,0,0,"",11,11
2019,3,reg,Arizona Cardinals,Carolina Panthers,ARI,20,38,18,2.5,58,45.5,FALSE,1,0,DOME,15.5,12.5
2019,3,reg,Buffalo Bills,Cincinnati Bengals,BUF,21,17,4,6,38,43.5,FALSE,0,0,"",2,5.5
2019,3,reg,Cleveland Browns,Los Angeles Rams,LAR,13,20,7,4,33,48,FALSE,0,0,"",3,15
2019,3,reg,Dallas Cowboys,Miami Dolphins,DAL,31,6,25,21.5,37,46.5,FALSE,1,0,DOME,3.5,9.5
2019,3,reg,Green Bay Packers,Denver Broncos,GB,27,16,11,7,43,41.5,FALSE,0,0,"",4,1.5
2019,3,reg,Indianapolis Colts,Atlanta Falcons,IND,27,24,3,1.5,51,48,FALSE,1,0,DOME,1.5,3
2019,3,reg,Kansas City Chiefs,Baltimore Ravens,KC,33,28,5,5,61,52,FALSE,0,0,"",0,9
2019,3,reg,Los Angeles Chargers,Houston Texans,LAC,20,27,7,3,47,49,FALSE,0,0,"",4,2
2019,3,reg,Minnesota Vikings,Oakland Raiders,MIN,34,14,20,9,48,43.5,FALSE,0,0,"",11,4.5
2019,3,reg,New England Patriots,New York Jets,NE,30,14,16,21,44,43,FALSE,0,0,"",5,1
2019,3,reg,Philadelphia Eagles,Detroit Lions,PHI,24,27,3,4,51,45,FALSE,0,0,"",1,6
2019,3,reg,San Francisco 49ers,Pittsburgh Steelers,SF,24,20,4,6,44,44.5,FALSE,0,0,"",2,0.5
2019,3,reg,Seattle Seahawks,New Orleans Saints,SEA,27,33,6,5,60,44,FALSE,0,0,"",1,16
2019,3,reg,Tampa Bay Buccaneers,New York Giants,TB,31,32,1,5,63,48,FALSE,0,0,"",4,15
2019,3,reg,Washington Redskins,Chicago Bears,CHI,15,31,16,5,46,41,FALSE,0,0,"",11,5
2019,4,reg,Green Bay Packers,Philadelphia Eagles,GB,27,34,7,3.5,61,46.5,FALSE,0,0,"",3.5,14.5
2019,4,reg,Arizona Cardinals,Seattle Seahawks,SEA,10,27,17,5.5,37,48.5,FALSE,1,0,DOME,11.5,11.5
2019,4,reg,Atlanta Falcons,Tennessee Titans,ATL,10,24,14,3.5,34,46.5,FALSE,1,0,DOME,10.5,12.5
2019,4,reg,Baltimore Ravens,Cleveland Browns,BAL,25,40,15,7,65,47.5,FALSE,0,0,"",8,17.5
2019,4,reg,Buffalo Bills,New England Patriots,NE,10,16,6,7,26,41.5,FALSE,0,0,"",1,15.5
2019,4,reg,Chicago Bears,Minnesota Vikings,CHI,16,6,10,1,22,38.5,FALSE,0,0,"",9,16.5
2019,4,reg,Denver Broncos,Jacksonville Jaguars,DEN,24,26,2,2.5,50,37.5,FALSE,0,0,"",0.5,12.5
2019,4,reg,Detroit Lions,Kansas City Chiefs,KC,30,34,4,7,64,54.5,FALSE,1,0,DOME,3,9.5
2019,4,reg,Houston Texans,Carolina Panthers,HOU,10,16,6,5,26,47.5,FALSE,1,0,DOME,1,21.5
2019,4,reg,Indianapolis Colts,Oakland Raiders,IND,24,31,7,6,55,46.5,FALSE,1,0,DOME,1,8.5
2019,4,reg,Los Angeles Rams,Tampa Bay Buccaneers,LAR,40,55,15,9,95,48.5,FALSE,0,0,"",6,46.5
2019,4,reg,Miami Dolphins,Los Angeles Chargers,LAC,10,30,20,15,40,43.5,FALSE,0,0,"",5,3.5
2019,4,reg,New Orleans Saints,Dallas Cowboys,DAL,12,10,2,2.5,22,47,FALSE,1,0,DOME,0.5,25
2019,4,reg,New York Giants,Washington Redskins,NYG,24,3,21,3,27,48,FALSE,0,0,"",18,21
2019,4,reg,Pittsburgh Steelers,Cincinnati Bengals,PIT,27,3,24,3.5,30,45,FALSE,0,0,"",20.5,15
2019,5,reg,Seattle Seahawks,Los Angeles Rams,SEA,30,29,1,1.5,59,48.5,FALSE,0,0,"",0.5,10.5
2019,5,reg,Carolina Panthers,Jacksonville Jaguars,CAR,34,27,7,3,61,40.5,FALSE,0,0,"",4,20.5
2019,5,reg,Cincinnati Bengals,Arizona Cardinals,CIN,23,26,3,3,49,46.5,FALSE,0,0,"",0,2.5
2019,5,reg,Dallas Cowboys,Green Bay Packers,DAL,24,34,10,3,58,46.5,FALSE,1,0,DOME,7,11.5
2019,5,reg,Houston Texans,Atlanta Falcons,HOU,53,32,21,4,85,49,FALSE,1,0,DOME,17,36
2019,5,reg,Kansas City Chiefs,Indianapolis Colts,KC,13,19,6,10.5,32,55.5,FALSE,0,0,"",4.5,23.5
2019,5,reg,Los Angeles Chargers,Denver Broncos,LAC,13,20,7,4.5,33,45.5,FALSE,0,0,"",2.5,12.5
2019,5,reg,New Orleans Saints,Tampa Bay Buccaneers,NO,31,24,7,3,55,46.5,FALSE,1,0,DOME,4,8.5
2019,5,reg,New York Giants,Minnesota Vikings,MIN,10,28,18,5.5,38,43.5,FALSE,0,0,"",12.5,5.5
2019,5,reg,Oakland Raiders,Chicago Bears,CHI,24,21,3,6.5,45,39.5,TRUE,0,0,"",3.5,5.5
2019,5,reg,Philadelphia Eagles,New York Jets,PHI,31,6,25,14,37,43,FALSE,0,0,"",11,6
2019,5,reg,Pittsburgh Steelers,Baltimore Ravens,BAL,23,26,3,3,49,44,FALSE,0,0,"",0,5
2019,5,reg,Tennessee Titans,Buffalo Bills,TEN,7,14,7,3,21,39.5,FALSE,0,0,"",4,18.5
2019,5,reg,Washington Redskins,New England Patriots,NE,7,33,26,16.5,40,41.5,FALSE,0,0,"",9.5,1.5
2019,5,reg,San Francisco 49ers,Cleveland Browns,SF,31,3,28,4.5,34,48,FALSE,0,0,"",23.5,14
2019,6,reg,New England Patriots,New York Giants,NE,35,14,21,16.5,49,43,FALSE,0,0,"",4.5,6
2019,6,reg,Arizona Cardinals,Atlanta Falcons,ATL,34,33,1,3,67,52,FALSE,1,0,DOME,2,15
2019,6,reg,Baltimore Ravens,Cincinnati Bengals,BAL,23,17,6,10.5,40,46.5,FALSE,0,0,"",4.5,6.5
2019,6,reg,Cleveland Browns,Seattle Seahawks,CLE,28,32,4,1,60,45.5,FALSE,0,0,"",3,14.5
2019,6,reg,Denver Broncos,Tennessee Titans,DEN,16,0,16,1.5,16,41,FALSE,0,0,"",14.5,25
2019,6,reg,Jacksonville Jaguars,New Orleans Saints,JAX,6,13,7,2.5,19,42.5,FALSE,0,0,"",4.5,23.5
2019,6,reg,Kansas City Chiefs,Houston Texans,KC,24,31,7,3.5,55,54.5,FALSE,0,0,"",3.5,0.5
2019,6,reg,Los Angeles Chargers,Pittsburgh Steelers,LAC,17,24,7,6,41,42.5,FALSE,0,0,"",1,1.5
2019,6,reg,Los Angeles Rams,San Francisco 49ers,LAR,7,20,13,3,27,50,FALSE,0,0,"",10,23
2019,6,reg,Miami Dolphins,Washington Redskins,WAS,16,17,1,5.5,33,42.5,FALSE,0,0,"",4.5,9.5
2019,6,reg,Minnesota Vikings,Philadelphia Eagles,MIN,38,20,18,3.5,58,44.5,FALSE,0,0,"",14.5,13.5
2019,6,reg,New York Jets,Dallas Cowboys,DAL,24,22,2,7,46,43.5,FALSE,0,0,"",5,2.5
2019,6,reg,Tampa Bay Buccaneers,Carolina Panthers,CAR,26,37,11,2,63,47.5,TRUE,0,0,"",9,15.5
2019,6,reg,Green Bay Packers,Detroit Lions,GB,23,22,1,3.5,45,47,FALSE,0,0,"",2.5,2
2019,7,reg,Denver Broncos,Kansas City Chiefs,KC,6,30,24,3,36,49.5,FALSE,0,0,"",21,13.5
2019,7,reg,Atlanta Falcons,Los Angeles Rams,LAR,10,37,27,3,47,54.5,FALSE,1,0,DOME,24,7.5
2019,7,reg,Buffalo Bills,Miami Dolphins,BUF,31,21,10,17,52,42.5,FALSE,0,0,"",7,9.5
2019,7,reg,Chicago Bears,New Orleans Saints,CHI,25,36,11,4,61,37,FALSE,0,0,"",7,24
2019,7,reg,Cincinnati Bengals,Jacksonville Jaguars,JAX,17,27,10,4,44,44,FALSE,0,0,"",6,0
2019,7,reg,Dallas Cowboys,Philadelphia Eagles,DAL,37,10,27,3,47,50,FALSE,1,0,DOME,24,3
2019,7,reg,Detroit Lions,Minnesota Vikings,MIN,30,42,12,2.5,72,43.5,FALSE,1,0,DOME,9.5,28.5
2019,7,reg,Green Bay Packers,Oakland Raiders,GB,42,24,18,5.5,66,47.5,FALSE,0,0,"",12.5,18.5
2019,7,reg,Indianapolis Colts,Houston Texans,IND,30,23,7,1,53,46.5,FALSE,1,0,DOME,6,6.5
2019,7,reg,New York Giants,Arizona Cardinals,NYG,21,27,6,3.5,48,50,FALSE,0,0,"",2.5,2
2019,7,reg,Seattle Seahawks,Baltimore Ravens,SEA,16,30,14,3,46,48.5,FALSE,0,0,"",11,2.5
2019,7,reg,Tennessee Titans,Los Angeles Chargers,TEN,23,20,3,2.5,43,42.5,FALSE,0,0,"",0.5,0.5
2019,7,reg,Washington Redskins,San Francisco 49ers,SF,0,9,9,10,9,39,FALSE,0,0,"",1,30
2019,7,reg,New York Jets,New England Patriots,NE,0,33,33,10,33,43,FALSE,0,0,"",23,10
2019,8,reg,Minnesota Vikings,Washington Redskins,MIN,19,9,10,16.5,28,42,FALSE,0,0,"",6.5,14
2019,8,reg,Atlanta Falcons,Seattle Seahawks,SEA,20,27,7,7.5,47,48.5,FALSE,1,0,DOME,0.5,1.5
2019,8,reg,Buffalo Bills,Philadelphia Eagles,BUF,13,31,18,1,44,39.5,FALSE,0,0,"",17,4.5
2019,8,reg,Chicago Bears,Los Angeles Chargers,CHI,16,17,1,3.5,33,41,FALSE,0,0,"",2.5,8
2019,8,reg,Detroit Lions,New York Giants,DET,31,26,5,6.5,57,49,FALSE,1,0,DOME,1.5,8
2019,8,reg,Houston Texans,Oakland Raiders,HOU,27,24,3,6,51,52,FALSE,1,0,DOME,3,1
2019,8,reg,Indianapolis Colts,Denver Broncos,IND,15,13,2,6,28,42,FALSE,1,0,DOME,4,14
2019,8,reg,Jacksonville Jaguars,New York Jets,JAX,29,15,14,6.5,44,40,FALSE,0,0,"",7.5,4
2019,8,reg,Kansas City Chiefs,Green Bay Packers,GB,24,31,7,5,55,47.5,FALSE,0,0,"",2,7.5
2019,8,reg,Los Angeles Rams,Cincinnati Bengals,LAR,24,10,14,12,34,48.5,TRUE,0,0,"",2,14.5
2019,8,reg,New England Patriots,Cleveland Browns,NE,27,13,14,10,40,43,FALSE,0,0,"",4,3
2019,8,reg,New Orleans Saints,Arizona Cardinals,NO,31,9,22,12.5,40,48,FALSE,1,0,DOME,9.5,8
2019,8,reg,San Francisco 49ers,Carolina Panthers,SF,51,13,38,4,64,40.5,FALSE,0,0,"",34,23.5
2019,8,reg,Tennessee Titans,Tampa Bay Buccaneers,TEN,27,23,4,2,50,45.5,FALSE,0,0,"",2,4.5
2019,8,reg,Pittsburgh Steelers,Miami Dolphins,PIT,27,14,13,14,41,44,FALSE,0,0,"",1,3
2019,9,reg,Arizona Cardinals,San Francisco 49ers,SF,25,28,3,10,53,43,FALSE,1,0,DOME,7,10
2019,9,reg,Baltimore Ravens,New England Patriots,NE,37,20,17,3,57,44.5,FALSE,0,0,"",14,12.5
2019,9,reg,Buffalo Bills,Washington Redskins,BUF,24,9,15,10.5,33,37,FALSE,0,0,"",4.5,4
2019,9,reg,Carolina Panthers,Tennessee Titans,CAR,30,20,10,3.5,50,43,FALSE,0,0,"",6.5,7
2019,9,reg,Denver Broncos,Cleveland Browns,CLE,24,19,5,4,43,39,FALSE,0,0,"",1,4
2019,9,reg,Jacksonville Jaguars,Houston Texans,JAX,3,26,23,1,29,46,TRUE,0,0,"",22,17
2019,9,reg,Kansas City Chiefs,Minnesota Vikings,MIN,26,23,3,5.5,49,45.5,FALSE,0,0,"",2.5,3.5
2019,9,reg,Los Angeles Chargers,Green Bay Packers,GB,26,11,15,4,37,50,FALSE,0,0,"",11,13
2019,9,reg,Miami Dolphins,New York Jets,NYJ,26,18,8,3,44,42.5,FALSE,0,0,"",5,1.5
2019,9,reg,Oakland Raiders,Detroit Lions,OAK,31,24,7,2.5,55,51,FALSE,0,0,"",4.5,4
2019,9,reg,Philadelphia Eagles,Chicago Bears,PHI,22,14,8,5,36,41,FALSE,0,0,"",3,5
2019,9,reg,Pittsburgh Steelers,Indianapolis Colts,PIT,26,24,2,1,50,40,FALSE,0,0,"",1,10
2019,9,reg,Seattle Seahawks,Tampa Bay Buccaneers,SEA,40,34,6,4,74,51,FALSE,0,0,"",2,23
2019,9,reg,New York Giants,Dallas Cowboys,DAL,18,37,19,6.5,55,48.5,FALSE,0,0,"",12.5,6.5
2019,10,reg,Oakland Raiders,Los Angeles Chargers,LAC,26,24,2,1,50,49,FALSE,0,0,"",1,1
2019,10,reg,Chicago Bears,Detroit Lions,CHI,20,13,7,6,33,38,FALSE,0,0,"",1,5
2019,10,reg,Cincinnati Bengals,Baltimore Ravens,BAL,13,49,36,10.5,62,44,FALSE,0,0,"",25.5,18
2019,10,reg,Cleveland Browns,Buffalo Bills,CLE,19,16,3,3,35,42,FALSE,0,0,"",0,7
2019,10,reg,Dallas Cowboys,Minnesota Vikings,DAL,24,28,4,3,52,48,FALSE,1,0,DOME,1,4
2019,10,reg,Green Bay Packers,Carolina Panthers,GB,24,16,8,5,40,49,FALSE,0,0,"",3,9
2019,10,reg,Indianapolis Colts,Miami Dolphins,IND,12,16,4,11,28,44,FALSE,1,0,DOME,7,16
2019,10,reg,New Orleans Saints,Atlanta Falcons,NO,9,26,17,13.5,35,51.5,FALSE,1,0,DOME,3.5,16.5
2019,10,reg,New York Jets,New York Giants,NYG,34,27,7,3,61,43,FALSE,0,0,"",4,18
2019,10,reg,Pittsburgh Steelers,Los Angeles Rams,LAR,17,12,5,4.5,29,43.5,FALSE,0,0,"",0.5,14.5
2019,10,reg,Tampa Bay Buccaneers,Arizona Cardinals,TB,30,27,3,5.5,57,51.5,FALSE,0,0,"",2.5,5.5
2019,10,reg,Tennessee Titans,Kansas City Chiefs,KC,35,32,3,6,67,49,FALSE,0,0,"",3,18
2019,10,reg,San Francisco 49ers,Seattle Seahawks,SF,24,27,3,6.5,51,46.5,FALSE,0,0,"",3.5,4.5
2019,11,reg,Cleveland Browns,Pittsburgh Steelers,CLE,21,7,14,3,28,41.5,FALSE,0,0,"",11,13.5
2019,11,reg,Baltimore Ravens,Houston Texans,BAL,41,7,34,4.5,48,51,FALSE,0,0,"",29.5,3
2019,11,reg,Carolina Panthers,Atlanta Falcons,CAR,3,29,26,4,32,49,FALSE,0,0,"",22,17
2019,11,reg,Detroit Lions,Dallas Cowboys,DAL,27,35,8,7,62,46.5,FALSE,1,0,DOME,1,15.5
2019,11,reg,Indianapolis Colts,Jacksonville Jaguars,IND,33,13,20,2.5,46,41.5,FALSE,1,0,DOME,17.5,4.5
2019,11,reg,Los Angeles Rams,Chicago Bears,LAR,17,7,10,5.5,24,40,FALSE,0,0,"",4.5,16
2019,11,reg,Miami Dolphins,Buffalo Bills,BUF,20,37,17,7,57,41,FALSE,0,0,"",10,16
2019,11,reg,Minnesota Vikings,Denver Broncos,MIN,27,23,4,10,50,40,FALSE,0,0,"",6,10
2019,11,reg,Oakland Raiders,Cincinnati Bengals,OAK,17,10,7,13,27,48,FALSE,0,0,"",6,21
2019,11,reg,Philadelphia Eagles,New England Patriots,NE,10,17,7,4.5,27,45,FALSE,0,0,"",2.5,18
2019,11,reg,San Francisco 49ers,Arizona Cardinals,SF,36,26,10,10,62,44,FALSE,0,0,"",0,18
2019,11,reg,Tampa Bay Buccaneers,New Orleans Saints,NO,17,34,17,5,51,50.5,FALSE,0,0,"",12,0.5
2019,11,reg,Washington Redskins,New York Jets,WAS,17,34,17,2,51,37.5,FALSE,0,0,"",15,13.5
2019,11,reg,Los Angeles Chargers,Kansas City Chiefs,KC,17,24,7,5.5,41,52.5,TRUE,0,0,"",1.5,11.5
2019,12,reg,Houston Texans,Indianapolis Colts,HOU,20,17,3,3.5,37,46,FALSE,1,0,DOME,0.5,9
2019,12,reg,Atlanta Falcons,Tampa Bay Buccaneers,ATL,22,35,13,3.5,57,51.5,FALSE,1,0,DOME,9.5,5.5
2019,12,reg,Buffalo Bills,Denver Broncos,BUF,20,3,17,3.5,23,37,FALSE,0,0,"",13.5,14
2019,12,reg,Chicago Bears,New York Giants,CHI,19,14,5,6,33,41,FALSE,0,0,"",1,8
2019,12,reg,Cincinnati Bengals,Pittsburgh Steelers,PIT,10,16,6,6.5,26,37,FALSE,0,0,"",0.5,11
2019,12,reg,Cleveland Browns,Miami Dolphins,CLE,41,24,17,11,65,46,FALSE,0,0,"",6,19
2019,12,reg,New England Patriots,Dallas Cowboys,NE,13,9,4,5.5,22,44.5,FALSE,0,0,"",1.5,22.5
2019,12,reg,New Orleans Saints,Carolina Panthers,NO,34,31,3,10,65,46.5,FALSE,1,0,DOME,7,18.5
2019,12,reg,New York Jets,Oakland Raiders,OAK,34,3,31,3,37,44.5,FALSE,0,0,"",28,7.5
2019,12,reg,Philadelphia Eagles,Seattle Seahawks,SEA,9,17,8,2,26,45.5,FALSE,0,0,"",6,19.5
2019,12,reg,San Francisco 49ers,Green Bay Packers,SF,37,8,29,3,45,48,FALSE,0,0,"",26,3
2019,12,reg,Tennessee Titans,Jacksonville Jaguars,TEN,42,20,22,4,62,42.5,FALSE,0,0,"",18,19.5
2019,12,reg,Washington Redskins,Detroit Lions,DET,19,16,3,4,35,40,FALSE,0,0,"",1,5
2019,12,reg,Los Angeles Rams,Baltimore Ravens,BAL,6,45,39,3.5,51,47,FALSE,0,0,"",35.5,4
2019,13,reg,Atlanta Falcons,New Orleans Saints,NO,18,26,8,7,44,48,FALSE,1,0,DOME,1,4
2019,13,reg,Dallas Cowboys,Buffalo Bills,DAL,15,26,11,6.5,41,46.5,FALSE,1,0,DOME,4.5,5.5
2019,13,reg,Detroit Lions,Chicago Bears,CHI,20,24,4,5.5,44,37,FALSE,1,0,DOME,1.5,7
2019,13,reg,Arizona Cardinals,Los Angeles Rams,LAR,7,34,27,2.5,41,47,FALSE,1,0,DOME,24.5,6
2019,13,reg,Baltimore Ravens,San Francisco 49ers,BAL,20,17,3,5.5,37,45,FALSE,0,0,"",2.5,8
2019,13,reg,Carolina Panthers,Washington Redskins,CAR,21,29,8,10.5,50,38.5,FALSE,0,0,"",2.5,11.5
2019,13,reg,Cincinnati Bengals,New York Jets,NYJ,22,6,16,3,28,43,FALSE,0,0,"",13,15
2019,13,reg,Denver Broncos,Los Angeles Chargers,LAC,23,20,3,4.5,43,38.5,FALSE,0,0,"",1.5,4.5
2019,13,reg,Houston Texans,New England Patriots,NE,28,22,6,3,50,47,FALSE,1,0,DOME,3,3
2019,13,reg,Indianapolis Colts,Tennessee Titans,TEN,17,31,14,1,48,41.5,FALSE,1,0,DOME,13,6.5
2019,13,reg,Jacksonville Jaguars,Tampa Bay Buccaneers,TB,11,28,17,3,39,46.5,FALSE,0,0,"",14,7.5
2019,13,reg,Kansas City Chiefs,Oakland Raiders,KC,40,9,31,10.5,49,49.5,FALSE,0,0,"",20.5,0.5
2019,13,reg,Miami Dolphins,Philadelphia Eagles,PHI,37,31,6,10,68,44.5,FALSE,0,0,"",4,23.5
2019,13,reg,New York Giants,Green Bay Packers,GB,13,31,18,6.5,44,43.5,FALSE,0,0,"",11.5,0.5
2019,13,reg,Pittsburgh Steelers,Cleveland Browns,CLE,20,13,7,1,33,40,FALSE,0,0,"",6,7
2019,13,reg,Seattle Seahawks,Minnesota Vikings,SEA,37,30,7,2.5,67,48.5,FALSE,0,0,"",4.5,18.5
2019,14,reg,Chicago Bears,Dallas Cowboys,DAL,31,24,7,3,55,43,FALSE,0,0,"",4,12
2019,14,reg,Arizona Cardinals,Pittsburgh Steelers,PIT,17,23,6,2.5,40,43.5,FALSE,1,0,DOME,3.5,3.5
2019,14,reg,Atlanta Falcons,Carolina Panthers,ATL,40,20,20,3.5,60,48,FALSE,1,0,DOME,16.5,12
2019,14,reg,Buffalo Bills,Baltimore Ravens,BAL,17,24,7,6,41,44,FALSE,0,0,"",1,3
2019,14,reg,Cleveland Browns,Cincinnati Bengals,CLE,27,19,8,6.5,46,43.5,FALSE,0,0,"",1.5,2.5
2019,14,reg,Green Bay Packers,Washington Redskins,GB,20,15,5,13,35,42,FALSE,0,0,"",8,7
2019,14,reg,Houston Texans,Denver Broncos,HOU,24,38,14,8,62,42.5,FALSE,1,0,DOME,6,19.5
2019,14,reg,Jacksonville Jaguars,Los Angeles Chargers,LAC,10,45,35,3,55,42,FALSE,0,0,"",32,13
2019,14,reg,Los Angeles Rams,Seattle Seahawks,LAR,28,12,16,1,40,47.5,FALSE,0,0,"",15,7.5
2019,14,reg,Minnesota Vikings,Detroit Lions,MIN,20,7,13,11.5,27,44,FALSE,0,0,"",1.5,17
2019,14,reg,New England Patriots,Kansas City Chiefs,NE,16,23,7,3,39,48.5,FALSE,0,0,"",4,9.5
2019,14,reg,New Orleans Saints,San Francisco 49ers,NO,46,48,2,1.5,94,45,FALSE,1,0,DOME,0.5,49
2019,14,reg,New York Jets,Miami Dolphins,NYJ,22,21,1,5,43,47,FALSE,0,0,"",4,4
2019,14,reg,Oakland Raiders,Tennessee Titans,TEN,21,42,21,2.5,63,47,FALSE,0,0,"",18.5,16
2019,14,reg,Tampa Bay Buccaneers,Indianapolis Colts,TB,38,35,3,3,73,46.5,FALSE,0,0,"",0,26.5
2019,14,reg,Philadelphia Eagles,New York Giants,PHI,23,17,6,9.5,40,45,FALSE,0,0,"",3.5,5
2019,15,reg,Baltimore Ravens,New York Jets,BAL,42,21,21,17,63,44,FALSE,0,0,"",4,19
2019,15,reg,Arizona Cardinals,Cleveland Browns,CLE,38,24,14,3,62,49,FALSE,1,0,DOME,11,13
2019,15,reg,Carolina Panthers,Seattle Seahawks,SEA,24,30,6,6,54,48.5,FALSE,0,0,"",0,5.5
2019,15,reg,Cincinnati Bengals,New England Patriots,NE,13,34,21,10.5,47,41.5,FALSE,0,0,"",10.5,5.5
2019,15,reg,Dallas Cowboys,Los Angeles Rams,LAR,44,21,23,1,65,48.5,FALSE,1,0,DOME,22,16.5
2019,15,reg,Detroit Lions,Tampa Bay Buccaneers,TB,17,38,21,6,55,46,FALSE,1,0,DOME,15,9
2019,15,reg,Green Bay Packers,Chicago Bears,GB,21,13,8,4.5,34,41,FALSE,0,0,"",3.5,7
2019,15,reg,Kansas City Chiefs,Denver Broncos,KC,23,3,20,9,26,43,FALSE,0,0,"",11,17
2019,15,reg,Los Angeles Chargers,Minnesota Vikings,MIN,10,39,29,1,49,45,FALSE,0,0,"",28,4
2019,15,reg,New York Giants,Miami Dolphins,NYG,36,20,16,3.5,56,46.5,FALSE,0,0,"",12.5,9.5
2019,15,reg,Oakland Raiders,Jacksonville Jaguars,OAK,16,20,4,6.5,36,46,FALSE,0,0,"",2.5,10
2019,15,reg,Pittsburgh Steelers,Buffalo Bills,PIT,10,17,7,1,27,37,FALSE,0,0,"",6,10
2019,15,reg,San Francisco 49ers,Atlanta Falcons,SF,22,29,7,10,51,49.5,FALSE,0,0,"",3,1.5
2019,15,reg,Tennessee Titans,Houston Texans,TEN,21,24,3,3,45,50,FALSE,0,0,"",0,5
2019,15,reg,Washington Redskins,Philadelphia Eagles,PHI,27,37,10,6.5,64,38.5,FALSE,0,0,"",3.5,25.5
2019,15,reg,New Orleans Saints,Indianapolis Colts,NO,34,7,27,8.5,41,49,FALSE,1,0,DOME,18.5,8
2019,16,reg,New England Patriots,Buffalo Bills,NE,24,17,7,6.5,41,38.5,FALSE,0,0,"",0.5,2.5
2019,16,reg,San Francisco 49ers,Los Angeles Rams,SF,34,31,3,7,65,45.5,FALSE,0,0,"",4,19.5
2019,16,reg,Tampa Bay Buccaneers,Houston Texans,HOU,20,23,3,3,43,50.5,FALSE,0,0,"",0,7.5
2019,16,reg,Atlanta Falcons,Jacksonville Jaguars,ATL,24,12,12,7,36,48,FALSE,1,0,DOME,5,12
2019,16,reg,Chicago Bears,Kansas City Chiefs,KC,3,26,23,7,29,45.5,FALSE,0,0,"",16,16.5
2019,16,reg,Cleveland Browns,Baltimore Ravens,BAL,15,31,16,10,46,49,FALSE,0,0,"",6,3
2019,16,reg,Denver Broncos,Detroit Lions,DEN,27,17,10,7.5,44,40,FALSE,0,0,"",2.5,4
2019,16,reg,Indianapolis Colts,Carolina Panthers,IND,38,6,32,7,44,46.5,FALSE,1,0,DOME,25,2.5
2019,16,reg,Los Angeles Chargers,Oakland Raiders,LAC,17,24,7,7.5,41,45,FALSE,0,0,"",0.5,4
2019,16,reg,Miami Dolphins,Cincinnati Bengals,CIN,38,35,3,1.5,73,45,FALSE,0,0,"",1.5,28
2019,16,reg,New York Jets,Pittsburgh Steelers,PIT,16,10,6,3,26,36.5,FALSE,0,0,"",3,10.5
2019,16,reg,Philadelphia Eagles,Dallas Cowboys,DAL,17,9,8,2,26,46.5,FALSE,0,0,"",6,20.5
2019,16,reg,Seattle Seahawks,Arizona Cardinals,SEA,13,27,14,8,40,51,FALSE,0,0,"",6,11
2019,16,reg,Tennessee Titans,New Orleans Saints,NO,28,38,10,3,66,49,FALSE,0,0,"",7,17
2019,16,reg,Washington Redskins,New York Giants,NYG,35,41,6,1,76,42,FALSE,0,0,"",5,34
2019,16,reg,Minnesota Vikings,Green Bay Packers,MIN,10,23,13,4,33,46.5,FALSE,0,0,"",9,13.5
2019,17,reg,Baltimore Ravens,Pittsburgh Steelers,PIT,28,10,18,1,38,35,FALSE,0,0,"",17,3
2019,17,reg,Buffalo Bills,New York Jets,NYJ,6,13,7,1,19,37,FALSE,0,0,"",6,18
2019,17,reg,Carolina Panthers,New Orleans Saints,NO,10,42,32,14,52,44.5,FALSE,0,0,"",18,7.5
2019,17,reg,Cincinnati Bengals,Cleveland Browns,CLE,33,23,10,2.5,56,43.5,FALSE,0,0,"",7.5,12.5
2019,17,reg,Dallas Cowboys,Washington Redskins,DAL,47,16,31,12.5,63,47.5,FALSE,1,0,DOME,18.5,15.5
2019,17,reg,Denver Broncos,Oakland Raiders,DEN,16,15,1,4.5,31,41,FALSE,0,0,"",3.5,10
2019,17,reg,Detroit Lions,Green Bay Packers,GB,20,23,3,13,43,44,FALSE,1,0,DOME,10,1
2019,17,reg,Houston Texans,Tennessee Titans,TEN,14,35,21,10,49,43,FALSE,1,0,DOME,11,6
2019,17,reg,Jacksonville Jaguars,Indianapolis Colts,IND,38,20,18,5.5,58,41.5,FALSE,0,0,"",12.5,16.5
2019,17,reg,Kansas City Chiefs,Los Angeles Chargers,KC,31,21,10,9.5,52,46,FALSE,0,0,"",0.5,6
2019,17,reg,Los Angeles Rams,Arizona Cardinals,LAR,31,24,7,7,55,45.5,FALSE,0,0,"",0,9.5
2019,17,reg,Minnesota Vikings,Chicago Bears,CHI,19,21,2,4.5,40,36,FALSE,0,0,"",2.5,4
2019,17,reg,New England Patriots,Miami Dolphins,NE,24,27,3,17,51,45.5,FALSE,0,0,"",14,5.5
2019,17,reg,New York Giants,Philadelphia Eagles,PHI,17,34,17,3.5,51,44.5,FALSE,0,0,"",13.5,6.5
2019,17,reg,Seattle Seahawks,San Francisco 49ers,SF,21,26,5,3.5,47,47,FALSE,0,0,"",1.5,0
2019,17,reg,Tampa Bay Buccaneers,Atlanta Falcons,TB,22,28,6,1,50,48.5,FALSE,0,0,"",5,1.5
2019,Wildcard,post,Houston Texans,Buffalo Bills,HOU,22,19,3,2.5,41,43,FALSE,1,0,DOME,0.5,2
2019,Wildcard,post,New England Patriots,Tennessee Titans,NE,13,20,7,4.5,33,45,FALSE,0,0,"",2.5,12
2019,Wildcard,post,New Orleans Saints,Minnesota Vikings,NO,20,26,6,7.5,46,49.5,FALSE,1,0,DOME,1.5,3.5
2019,Wildcard,post,Philadelphia Eagles,Seattle Seahawks,PHI,9,17,8,1,26,44.5,FALSE,0,0,"",7,18.5
2019,Division,post,Baltimore Ravens,Tennessee Titans,BAL,12,28,16,10,40,47.5,FALSE,0,0,"",6,7.5
2019,Division,post,San Francisco 49ers,Minnesota Vikings,SF,27,10,17,7,37,44.5,FALSE,0,0,"",10,7.5
2019,Division,post,Green Bay Packers,Seattle Seahawks,GB,28,23,5,4.5,51,45.5,FALSE,0,0,"",0.5,5.5
2019,Division,post,Kansas City Chiefs,Houston Texans,KC,51,31,20,10,82,50.5,FALSE,0,0,"",10,31.5
2019,Conference,post,Kansas City Chiefs,Tennessee Titans,KC,35,24,11,7,59,51,FALSE,0,0,"",4,8
2019,Conference,post,San Francisco 49ers,Green Bay Packers,SF,37,20,17,8,57,46.5,FALSE,0,0,"",9,10.5
2019,Superbowl,post,Kansas City Chiefs,San Francisco 49ers,KC,31,20,11,1.5,51,53,TRUE,0,0,"",9.5,2
