season,week,type,home_team,away_team,home_score,away_score,total,game_id
2009,1,reg,PIT,TEN,13,10,23,2009091000
2009,1,reg,CLE,MIN,20,34,54,2009091304
2009,1,reg,NO,DET,45,27,72,2009091307
2009,1,reg,TB,DAL,21,34,55,2009091308
2009,1,reg,HOU,NYJ,7,24,31,2009091305
2009,1,reg,IND,JAC,14,12,26,2009091306
2009,1,reg,CIN,DEN,7,12,19,2009091303
2009,1,reg,CAR,PHI,10,38,48,2009091302
2009,1,reg,BAL,KC,38,24,62,2009091301
2009,1,reg,ATL,MIA,19,7,26,2009091300
2009,1,reg,ARI,SF,16,20,36,2009091309
2009,1,reg,SEA,STL,28,0,28,2009091311
2009,1,reg,NYG,WAS,23,17,40,2009091310
2009,1,reg,GB,CHI,21,15,36,2009091312
2009,1,reg,NE,BUF,25,24,49,2009091400
2009,1,reg,OAK,SD,20,24,44,2009091401
2009,2,reg,ATL,CAR,28,20,48,2009092000
2009,2,reg,DET,MIN,13,27,40,2009092001
2009,2,reg,WAS,STL,9,7,16,2009092008
2009,2,reg,TEN,HOU,31,34,65,2009092007
2009,2,reg,PHI,NO,22,48,70,2009092006
2009,2,reg,NYJ,NE,16,9,25,2009092005
2009,2,reg,KC,OAK,10,13,23,2009092004
2009,2,reg,JAC,ARI,17,31,48,2009092003
2009,2,reg,GB,CIN,24,31,55,2009092002
2009,2,reg,SF,SEA,23,10,33,2009092010
2009,2,reg,BUF,TB,33,20,53,2009092009
2009,2,reg,SD,BAL,26,31,57,2009092013
2009,2,reg,DEN,CLE,27,6,33,2009092012
2009,2,reg,CHI,PIT,17,14,31,2009092011
2009,2,reg,DAL,NYG,31,33,64,2009092014
2009,2,reg,MIA,IND,23,27,50,2009092100
2009,3,reg,BAL,CLE,34,3,37,2009092700
2009,3,reg,NYJ,TEN,24,17,41,2009092711
2009,3,reg,DET,WAS,19,14,33,2009092702
2009,3,reg,HOU,JAC,24,31,55,2009092703
2009,3,reg,MIN,SF,27,24,51,2009092704
2009,3,reg,NE,ATL,26,10,36,2009092705
2009,3,reg,TB,NYG,0,24,24,2009092708
2009,3,reg,PHI,KC,34,14,48,2009092706
2009,3,reg,STL,GB,17,36,53,2009092707
2009,3,reg,BUF,NO,7,27,34,2009092709
2009,3,reg,SEA,CHI,19,25,44,2009092710
2009,3,reg,CIN,PIT,23,20,43,2009092701
2009,3,reg,SD,MIA,23,13,36,2009092713
2009,3,reg,OAK,DEN,3,23,26,2009092712
2009,3,reg,ARI,IND,10,31,41,2009092714
2009,3,reg,DAL,CAR,21,7,28,2009092800
2009,4,reg,CHI,DET,48,24,72,2009100400
2009,4,reg,CLE,CIN,20,23,43,2009100401
2009,4,reg,HOU,OAK,29,6,35,2009100402
2009,4,reg,IND,SEA,34,17,51,2009100403
2009,4,reg,JAC,TEN,37,17,54,2009100404
2009,4,reg,KC,NYG,16,27,43,2009100405
2009,4,reg,NE,BAL,27,21,48,2009100406
2009,4,reg,WAS,TB,16,13,29,2009100407
2009,4,reg,MIA,BUF,38,10,48,2009100408
2009,4,reg,NO,NYJ,24,10,34,2009100409
2009,4,reg,DEN,DAL,17,10,27,2009100410
2009,4,reg,SF,STL,35,0,35,2009100411
2009,4,reg,PIT,SD,38,28,66,2009100412
2009,4,reg,MIN,GB,30,23,53,2009100500
2009,5,reg,STL,MIN,10,38,48,2009101107
2009,5,reg,PHI,TB,33,14,47,2009101106
2009,5,reg,KC,DAL,20,26,46,2009101104
2009,5,reg,DET,PIT,20,28,48,2009101103
2009,5,reg,CAR,WAS,20,17,37,2009101102
2009,5,reg,BUF,CLE,3,6,9,2009101101
2009,5,reg,NYG,OAK,44,7,51,2009101105
2009,5,reg,BAL,CIN,14,17,31,2009101100
2009,5,reg,SF,ATL,10,45,55,2009101108
2009,5,reg,SEA,JAC,41,0,41,2009101111
2009,5,reg,DEN,NE,20,17,37,2009101110
2009,5,reg,ARI,HOU,28,21,49,2009101109
2009,5,reg,TEN,IND,9,31,40,2009101112
2009,5,reg,MIA,NYJ,31,27,58,2009101200
2009,6,reg,CIN,HOU,17,28,45,2009101800
2009,6,reg,GB,DET,26,0,26,2009101801
2009,6,reg,JAC,STL,23,20,43,2009101802
2009,6,reg,MIN,BAL,33,31,64,2009101803
2009,6,reg,NO,NYG,48,27,75,2009101804
2009,6,reg,PIT,CLE,27,14,41,2009101805
2009,6,reg,TB,CAR,21,28,49,2009101806
2009,6,reg,WAS,KC,6,14,20,2009101807
2009,6,reg,OAK,PHI,13,9,22,2009101808
2009,6,reg,SEA,ARI,3,27,30,2009101809
2009,6,reg,NE,TEN,59,0,59,2009101810
2009,6,reg,NYJ,BUF,13,16,29,2009101811
2009,6,reg,ATL,CHI,21,14,35,2009101812
2009,6,reg,SD,DEN,23,34,57,2009101900
2009,7,reg,TB,NE,7,35,42,2009102506
2009,7,reg,STL,IND,6,42,48,2009102505
2009,7,reg,PIT,MIN,27,17,44,2009102504
2009,7,reg,KC,SD,7,37,44,2009102503
2009,7,reg,HOU,SF,24,21,45,2009102502
2009,7,reg,CLE,GB,3,31,34,2009102501
2009,7,reg,OAK,NYJ,0,38,38,2009102508
2009,7,reg,CAR,BUF,9,20,29,2009102507
2009,7,reg,MIA,NO,34,46,80,2009102510
2009,7,reg,DAL,ATL,37,21,58,2009102509
2009,7,reg,CIN,CHI,45,10,55,2009102500
2009,7,reg,NYG,ARI,17,24,41,2009102511
2009,7,reg,WAS,PHI,17,27,44,2009102600
2009,8,reg,BAL,DEN,30,7,37,2009110100
2009,8,reg,BUF,HOU,10,31,41,2009110101
2009,8,reg,CHI,CLE,30,6,36,2009110102
2009,8,reg,DAL,SEA,38,17,55,2009110103
2009,8,reg,DET,STL,10,17,27,2009110104
2009,8,reg,IND,SF,18,14,32,2009110106
2009,8,reg,PHI,NYG,40,17,57,2009110111
2009,8,reg,NYJ,MIA,25,30,55,2009110107
2009,8,reg,SD,OAK,24,16,40,2009110108
2009,8,reg,TEN,JAC,30,13,43,2009110109
2009,8,reg,ARI,CAR,21,34,55,2009110110
2009,8,reg,GB,MIN,26,38,64,2009110105
2009,8,reg,NO,ATL,35,27,62,2009110200
2009,9,reg,ATL,WAS,31,17,48,2009110800
2009,9,reg,CHI,ARI,21,41,62,2009110801
2009,9,reg,CIN,BAL,17,7,24,2009110802
2009,9,reg,IND,HOU,20,17,37,2009110803
2009,9,reg,JAC,KC,24,21,45,2009110804
2009,9,reg,NE,MIA,27,17,44,2009110805
2009,9,reg,TB,GB,38,28,66,2009110806
2009,9,reg,NO,CAR,30,20,50,2009110807
2009,9,reg,SEA,DET,32,20,52,2009110808
2009,9,reg,NYG,SD,20,21,41,2009110809
2009,9,reg,SF,TEN,27,34,61,2009110810
2009,9,reg,PHI,DAL,16,20,36,2009110811
2009,9,reg,DEN,PIT,10,28,38,2009110900
2009,10,reg,SF,CHI,10,6,16,2009111200
2009,10,reg,CAR,ATL,28,19,47,2009111500
2009,10,reg,WAS,DEN,27,17,44,2009111507
2009,10,reg,TEN,BUF,41,17,58,2009111506
2009,10,reg,STL,NO,23,28,51,2009111505
2009,10,reg,PIT,CIN,12,18,30,2009111504
2009,10,reg,NYJ,JAC,22,24,46,2009111503
2009,10,reg,MIA,TB,25,23,48,2009111501
2009,10,reg,MIN,DET,27,10,37,2009111502
2009,10,reg,OAK,KC,10,16,26,2009111508
2009,10,reg,GB,DAL,17,7,24,2009111510
2009,10,reg,ARI,SEA,31,20,51,2009111509
2009,10,reg,SD,PHI,31,23,54,2009111511
2009,10,reg,IND,NE,35,34,69,2009111512
2009,10,reg,CLE,BAL,0,16,16,2009111600
2009,11,reg,CAR,MIA,17,24,41,2009111900
2009,11,reg,BAL,IND,15,17,32,2009112200
2009,11,reg,TB,NO,7,38,45,2009112208
2009,11,reg,NYG,ATL,34,31,65,2009112207
2009,11,reg,MIN,SEA,35,9,44,2009112206
2009,11,reg,KC,PIT,27,24,51,2009112205
2009,11,reg,JAC,BUF,18,15,33,2009112204
2009,11,reg,DAL,WAS,7,6,13,2009112201
2009,11,reg,DET,CLE,38,37,75,2009112202
2009,11,reg,GB,SF,30,24,54,2009112203
2009,11,reg,STL,ARI,13,21,34,2009112209
2009,11,reg,DEN,SD,3,32,35,2009112210
2009,11,reg,OAK,CIN,20,17,37,2009112212
2009,11,reg,NE,NYJ,31,14,45,2009112211
2009,11,reg,CHI,PHI,20,24,44,2009112213
2009,11,reg,HOU,TEN,17,20,37,2009112300
2009,12,reg,DET,GB,12,34,46,2009112600
2009,12,reg,DAL,OAK,24,7,31,2009112601
2009,12,reg,DEN,NYG,26,6,32,2009112602
2009,12,reg,BUF,MIA,31,14,45,2009112901
2009,12,reg,ATL,TB,20,17,37,2009112900
2009,12,reg,CIN,CLE,16,7,23,2009112902
2009,12,reg,STL,SEA,17,27,44,2009112907
2009,12,reg,HOU,IND,27,35,62,2009112903
2009,12,reg,NYJ,CAR,17,6,23,2009112905
2009,12,reg,PHI,WAS,27,24,51,2009112906
2009,12,reg,SF,JAC,20,3,23,2009112910
2009,12,reg,SD,KC,43,14,57,2009112909
2009,12,reg,TEN,ARI,20,17,37,2009112908
2009,12,reg,MIN,CHI,36,10,46,2009112904
2009,12,reg,BAL,PIT,20,17,37,2009112911
2009,12,reg,NO,NE,38,17,55,2009113000
2009,13,reg,BUF,NYJ,13,19,32,2009120300
2009,13,reg,ATL,PHI,7,34,41,2009120600
2009,13,reg,MIA,NE,22,21,43,2009120613
2009,13,reg,WAS,NO,30,33,63,2009120608
2009,13,reg,PIT,OAK,24,27,51,2009120607
2009,13,reg,KC,DEN,13,44,57,2009120606
2009,13,reg,CAR,TB,16,6,22,2009120601
2009,13,reg,CHI,STL,17,9,26,2009120602
2009,13,reg,CIN,DET,23,13,36,2009120603
2009,13,reg,IND,TEN,27,17,44,2009120604
2009,13,reg,JAC,HOU,23,18,41,2009120605
2009,13,reg,CLE,SD,23,30,53,2009120609
2009,13,reg,SEA,SF,20,17,37,2009120612
2009,13,reg,NYG,DAL,31,24,55,2009120611
2009,13,reg,ARI,MIN,30,17,47,2009120610
2009,13,reg,GB,BAL,27,14,41,2009120700
2009,14,reg,CLE,PIT,13,6,19,2009121000
2009,14,reg,HOU,SEA,34,7,41,2009121303
2009,14,reg,KC,BUF,10,16,26,2009121306
2009,14,reg,MIN,CIN,30,10,40,2009121307
2009,14,reg,NE,CAR,20,10,30,2009121308
2009,14,reg,TB,NYJ,3,26,29,2009121309
2009,14,reg,IND,DEN,28,16,44,2009121304
2009,14,reg,JAC,MIA,10,14,24,2009121305
2009,14,reg,CHI,GB,14,21,35,2009121302
2009,14,reg,BAL,DET,48,3,51,2009121301
2009,14,reg,ATL,NO,23,26,49,2009121300
2009,14,reg,TEN,STL,47,7,54,2009121310
2009,14,reg,OAK,WAS,13,34,47,2009121311
2009,14,reg,DAL,SD,17,20,37,2009121312
2009,14,reg,NYG,PHI,38,45,83,2009121313
2009,14,reg,SF,ARI,24,9,33,2009121400
2009,15,reg,JAC,IND,31,35,66,2009121700
2009,15,reg,NO,DAL,17,24,41,2009121900
2009,15,reg,STL,HOU,13,16,29,2009122007
2009,15,reg,KC,CLE,34,41,75,2009122003
2009,15,reg,NYJ,ATL,7,10,17,2009122004
2009,15,reg,BUF,NE,10,17,27,2009122001
2009,15,reg,TEN,MIA,27,24,51,2009122008
2009,15,reg,DET,ARI,24,31,55,2009122002
2009,15,reg,DEN,OAK,19,20,39,2009122009
2009,15,reg,SD,CIN,27,24,51,2009122010
2009,15,reg,PIT,GB,37,36,73,2009122006
2009,15,reg,BAL,CHI,31,7,38,2009122000
2009,15,reg,PHI,SF,27,13,40,2009122005
2009,15,reg,SEA,TB,7,24,31,2009122011
2009,15,reg,CAR,MIN,26,7,33,2009122012
2009,15,reg,WAS,NYG,12,45,57,2009122100
2009,16,reg,TEN,SD,17,42,59,2009122500
2009,16,reg,ATL,BUF,31,3,34,2009122700
2009,16,reg,PIT,BAL,23,20,43,2009122709
2009,16,reg,NO,TB,17,20,37,2009122707
2009,16,reg,NE,JAC,35,7,42,2009122706
2009,16,reg,NYG,CAR,9,41,50,2009122705
2009,16,reg,MIA,HOU,20,27,47,2009122704
2009,16,reg,CIN,KC,17,10,27,2009122701
2009,16,reg,CLE,OAK,23,9,32,2009122702
2009,16,reg,GB,SEA,48,10,58,2009122703
2009,16,reg,ARI,STL,31,10,41,2009122710
2009,16,reg,SF,DET,20,6,26,2009122711
2009,16,reg,PHI,DEN,30,27,57,2009122708
2009,16,reg,IND,NYJ,15,29,44,2009122712
2009,16,reg,WAS,DAL,0,17,17,2009122713
2009,16,reg,CHI,MIN,36,30,66,2009122800
2009,17,reg,BUF,IND,30,7,37,2010010300
2009,17,reg,CAR,NO,23,10,33,2010010301
2009,17,reg,TB,ATL,10,20,30,2010010310
2009,17,reg,STL,SF,6,28,34,2010010309
2009,17,reg,MIN,NYG,44,7,51,2010010307
2009,17,reg,MIA,PIT,24,30,54,2010010306
2009,17,reg,HOU,NE,34,27,61,2010010305
2009,17,reg,DET,CHI,23,37,60,2010010304
2009,17,reg,CLE,JAC,23,17,40,2010010302
2009,17,reg,DEN,KC,24,44,68,2010010312
2009,17,reg,ARI,GB,7,33,40,2010010311
2009,17,reg,SD,WAS,23,20,43,2010010314
2009,17,reg,OAK,BAL,13,21,34,2010010313
2009,17,reg,DAL,PHI,24,0,24,2010010303
2009,17,reg,SEA,TEN,13,17,30,2010010315
2009,17,reg,NYJ,CIN,37,0,37,2010010308
2009,18,post,CIN,NYJ,14,24,38,2010010901
2009,18,post,DAL,PHI,34,14,48,2010010900
2009,18,post,NE,BAL,14,33,47,2010011001
2009,18,post,ARI,GB,51,45,96,2010011000
2009,18,post,NO,ARI,45,14,59,2010011601
2009,18,post,IND,BAL,20,3,23,2010011600
2009,18,post,MIN,DAL,34,3,37,2010011700
2009,18,post,SD,NYJ,14,17,31,2010011701
2009,18,post,IND,NYJ,30,17,47,2010012400
2009,18,post,NO,MIN,31,28,59,2010012401
2009,18,post,APR,NPR,41,34,75,2010013100
2009,18,post,IND,NO,17,31,48,2010020700
2010,1,reg,NO,MIN,14,9,23,2010090900
2010,1,reg,TB,CLE,17,14,31,2010091200
2010,1,reg,PIT,ATL,15,9,24,2010091209
2010,1,reg,CHI,DET,19,14,33,2010091207
2010,1,reg,NYG,CAR,31,18,49,2010091206
2010,1,reg,TEN,OAK,38,13,51,2010091205
2010,1,reg,JAC,DEN,24,17,41,2010091204
2010,1,reg,BUF,MIA,10,15,25,2010091201
2010,1,reg,NE,CIN,38,24,62,2010091202
2010,1,reg,HOU,IND,34,24,58,2010091203
2010,1,reg,PHI,GB,20,27,47,2010091210
2010,1,reg,STL,ARI,13,17,30,2010091208
2010,1,reg,SEA,SF,31,6,37,2010091211
2010,1,reg,WAS,DAL,13,7,20,2010091212
2010,1,reg,NYJ,BAL,9,10,19,2010091300
2010,1,reg,KC,SD,21,14,35,2010091301
2010,2,reg,GB,BUF,34,7,41,2010091901
2010,2,reg,CIN,BAL,15,10,25,2010091912
2010,2,reg,CAR,TB,7,20,27,2010091908
2010,2,reg,ATL,ARI,41,7,48,2010091907
2010,2,reg,DET,PHI,32,35,67,2010091906
2010,2,reg,DAL,CHI,20,27,47,2010091905
2010,2,reg,TEN,PIT,11,19,30,2010091904
2010,2,reg,MIN,MIA,10,14,24,2010091902
2010,2,reg,CLE,KC,14,16,30,2010091903
2010,2,reg,OAK,STL,16,14,30,2010091910
2010,2,reg,DEN,SEA,31,14,45,2010091909
2010,2,reg,NYJ,NE,28,14,42,2010091911
2010,2,reg,SD,JAC,38,13,51,2010091913
2010,2,reg,WAS,HOU,27,30,57,2010091900
2010,2,reg,IND,NYG,38,14,52,2010091914
2010,2,reg,SF,NO,22,25,47,2010092000
2010,3,reg,NYG,TEN,10,29,39,2010092600
2010,3,reg,CAR,CIN,7,20,27,2010092601
2010,3,reg,TB,PIT,13,38,51,2010092602
2010,3,reg,NE,BUF,38,30,68,2010092603
2010,3,reg,HOU,DAL,13,27,40,2010092608
2010,3,reg,MIN,DET,24,10,34,2010092605
2010,3,reg,NO,ATL,24,27,51,2010092606
2010,3,reg,KC,SF,31,10,41,2010092609
2010,3,reg,BAL,CLE,24,17,41,2010092604
2010,3,reg,STL,WAS,30,16,46,2010092607
2010,3,reg,JAC,PHI,3,28,31,2010092610
2010,3,reg,DEN,IND,13,27,40,2010092611
2010,3,reg,ARI,OAK,24,23,47,2010092612
2010,3,reg,SEA,SD,27,20,47,2010092613
2010,3,reg,MIA,NYJ,23,31,54,2010092614
2010,3,reg,CHI,GB,20,17,37,2010092700
2010,4,reg,BUF,NYJ,14,38,52,2010100300
2010,4,reg,CLE,CIN,23,20,43,2010100301
2010,4,reg,PIT,BAL,14,17,31,2010100302
2010,4,reg,TEN,DEN,20,26,46,2010100303
2010,4,reg,GB,DET,28,26,54,2010100304
2010,4,reg,ATL,SF,16,14,30,2010100305
2010,4,reg,NO,CAR,16,14,30,2010100306
2010,4,reg,STL,SEA,20,3,23,2010100307
2010,4,reg,JAC,IND,31,28,59,2010100308
2010,4,reg,OAK,HOU,24,31,55,2010100309
2010,4,reg,PHI,WAS,12,17,29,2010100310
2010,4,reg,SD,ARI,41,10,51,2010100311
2010,4,reg,NYG,CHI,17,3,20,2010100312
2010,4,reg,MIA,NE,14,41,55,2010100400
2010,5,reg,BUF,JAC,26,36,62,2010101000
2010,5,reg,BAL,DEN,31,17,48,2010101001
2010,5,reg,IND,KC,19,9,28,2010101002
2010,5,reg,WAS,GB,16,13,29,2010101003
2010,5,reg,DET,STL,44,6,50,2010101004
2010,5,reg,CAR,CHI,6,23,29,2010101005
2010,5,reg,CIN,TB,21,24,45,2010101006
2010,5,reg,HOU,NYG,10,34,44,2010101008
2010,5,reg,CLE,ATL,10,20,30,2010101007
2010,5,reg,ARI,NO,30,20,50,2010101009
2010,5,reg,DAL,TEN,27,34,61,2010101010
2010,5,reg,OAK,SD,35,27,62,2010101011
2010,5,reg,SF,PHI,24,27,51,2010101012
2010,5,reg,NYJ,MIN,29,20,49,2010101100
2010,6,reg,GB,MIA,20,23,43,2010101700
2010,6,reg,STL,SD,20,17,37,2010101701
2010,6,reg,NE,BAL,23,20,43,2010101702
2010,6,reg,PIT,CLE,28,10,38,2010101703
2010,6,reg,HOU,KC,35,31,66,2010101704
2010,6,reg,NYG,DET,28,20,48,2010101705
2010,6,reg,PHI,ATL,31,17,48,2010101706
2010,6,reg,TB,NO,6,31,37,2010101708
2010,6,reg,CHI,SEA,20,23,43,2010101707
2010,6,reg,DEN,NYJ,20,24,44,2010101709
2010,6,reg,SF,OAK,17,9,26,2010101710
2010,6,reg,MIN,DAL,24,21,45,2010101711
2010,6,reg,WAS,IND,24,27,51,2010101712
2010,6,reg,JAC,TEN,3,30,33,2010101800
2010,7,reg,ATL,CIN,39,32,71,2010102400
2010,7,reg,MIA,PIT,22,23,45,2010102401
2010,7,reg,BAL,BUF,37,34,71,2010102402
2010,7,reg,KC,JAC,42,20,62,2010102403
2010,7,reg,NO,CLE,17,30,47,2010102404
2010,7,reg,CHI,WAS,14,17,31,2010102405
2010,7,reg,CAR,SF,23,20,43,2010102406
2010,7,reg,TEN,PHI,37,19,56,2010102408
2010,7,reg,TB,STL,18,17,35,2010102407
2010,7,reg,SEA,ARI,22,10,32,2010102409
2010,7,reg,SD,NE,20,23,43,2010102410
2010,7,reg,DEN,OAK,14,59,73,2010102411
2010,7,reg,GB,MIN,28,24,52,2010102412
2010,7,reg,DAL,NYG,35,41,76,2010102500
2010,8,reg,SF,DEN,24,16,40,2010103100
2010,8,reg,DAL,JAC,17,35,52,2010103101
2010,8,reg,CIN,MIA,14,22,36,2010103102
2010,8,reg,KC,BUF,13,10,23,2010103103
2010,8,reg,DET,WAS,37,25,62,2010103104
2010,8,reg,STL,CAR,20,10,30,2010103105
2010,8,reg,NYJ,GB,0,9,9,2010103106
2010,8,reg,SD,TEN,33,25,58,2010103107
2010,8,reg,NE,MIN,28,18,46,2010103108
2010,8,reg,ARI,TB,35,38,73,2010103109
2010,8,reg,OAK,SEA,33,3,36,2010103110
2010,8,reg,NO,PIT,20,10,30,2010103111
2010,8,reg,IND,HOU,30,17,47,2010110100
2010,9,reg,DET,NYJ,20,23,43,2010110700
2010,9,reg,BAL,MIA,26,10,36,2010110701
2010,9,reg,CLE,NE,34,14,48,2010110702
2010,9,reg,HOU,SD,23,29,52,2010110703
2010,9,reg,BUF,CHI,19,22,41,2010110704
2010,9,reg,MIN,ARI,27,24,51,2010110705
2010,9,reg,ATL,TB,27,21,48,2010110706
2010,9,reg,CAR,NO,3,34,37,2010110707
2010,9,reg,SEA,NYG,7,41,48,2010110708
2010,9,reg,PHI,IND,26,24,50,2010110709
2010,9,reg,OAK,KC,23,20,43,2010110710
2010,9,reg,GB,DAL,45,7,52,2010110711
2010,9,reg,CIN,PIT,21,27,48,2010110800
2010,10,reg,ATL,BAL,26,21,47,2010111100
2010,10,reg,BUF,DET,14,12,26,2010111406
2010,10,reg,TB,CAR,31,16,47,2010111405
2010,10,reg,JAC,HOU,31,24,55,2010111403
2010,10,reg,IND,CIN,23,17,40,2010111402
2010,10,reg,CLE,NYJ,20,26,46,2010111401
2010,10,reg,MIA,TEN,29,17,46,2010111400
2010,10,reg,CHI,MIN,27,13,40,2010111404
2010,10,reg,DEN,KC,49,29,78,2010111407
2010,10,reg,SF,STL,23,20,43,2010111410
2010,10,reg,ARI,SEA,18,36,54,2010111409
2010,10,reg,NYG,DAL,20,33,53,2010111408
2010,10,reg,PIT,NE,26,39,65,2010111411
2010,10,reg,WAS,PHI,28,59,87,2010111500
2010,11,reg,MIA,CHI,0,16,16,2010111800
2010,11,reg,CAR,BAL,13,37,50,2010112100
2010,11,reg,KC,ARI,31,13,44,2010112109
2010,11,reg,TEN,WAS,16,19,35,2010112108
2010,11,reg,MIN,GB,3,31,34,2010112106
2010,11,reg,DAL,DET,35,19,54,2010112105
2010,11,reg,JAC,CLE,24,20,44,2010112104
2010,11,reg,NYJ,HOU,30,27,57,2010112101
2010,11,reg,CIN,BUF,31,49,80,2010112102
2010,11,reg,PIT,OAK,35,3,38,2010112103
2010,11,reg,STL,ATL,17,34,51,2010112110
2010,11,reg,NO,SEA,34,19,53,2010112107
2010,11,reg,SF,TB,0,21,21,2010112111
2010,11,reg,NE,IND,31,28,59,2010112112
2010,11,reg,PHI,NYG,27,17,44,2010112113
2010,11,reg,SD,DEN,35,14,49,2010112200
2010,12,reg,DET,NE,24,45,69,2010112500
2010,12,reg,DAL,NO,27,30,57,2010112501
2010,12,reg,NYJ,CIN,26,10,36,2010112502
2010,12,reg,WAS,MIN,13,17,30,2010112803
2010,12,reg,CLE,CAR,24,23,47,2010112807
2010,12,reg,BUF,PIT,16,19,35,2010112801
2010,12,reg,NYG,JAC,24,20,44,2010112800
2010,12,reg,HOU,TEN,20,0,20,2010112802
2010,12,reg,ATL,GB,20,17,37,2010112805
2010,12,reg,SEA,KC,24,42,66,2010112808
2010,12,reg,OAK,MIA,17,33,50,2010112809
2010,12,reg,BAL,TB,17,10,27,2010112806
2010,12,reg,CHI,PHI,31,26,57,2010112804
2010,12,reg,DEN,STL,33,36,69,2010112810
2010,12,reg,IND,SD,14,36,50,2010112811
2010,12,reg,ARI,SF,6,27,33,2010112900
2010,13,reg,PHI,HOU,34,24,58,2010120200
2010,13,reg,MIN,BUF,38,14,52,2010120500
2010,13,reg,CIN,NO,30,34,64,2010120508
2010,13,reg,GB,SF,34,16,50,2010120506
2010,13,reg,DET,CHI,20,24,44,2010120505
2010,13,reg,NYG,WAS,31,7,38,2010120504
2010,13,reg,KC,DEN,10,6,16,2010120503
2010,13,reg,TEN,JAC,6,17,23,2010120502
2010,13,reg,MIA,CLE,10,13,23,2010120501
2010,13,reg,SD,OAK,13,28,41,2010120509
2010,13,reg,SEA,CAR,31,14,45,2010120512
2010,13,reg,ARI,STL,6,19,25,2010120511
2010,13,reg,IND,DAL,35,38,73,2010120510
2010,13,reg,TB,ATL,24,28,52,2010120507
2010,13,reg,BAL,PIT,10,13,23,2010120513
2010,13,reg,NE,NYJ,45,3,48,2010120600
2010,14,reg,TEN,IND,28,30,58,2010120900
2010,14,reg,JAC,OAK,38,31,69,2010121203
2010,14,reg,CAR,ATL,10,31,41,2010121207
2010,14,reg,BUF,CLE,13,6,19,2010121201
2010,14,reg,PIT,CIN,23,7,30,2010121202
2010,14,reg,WAS,TB,16,17,33,2010121204
2010,14,reg,DET,GB,7,3,10,2010121205
2010,14,reg,NO,STL,31,13,44,2010121208
2010,14,reg,SF,SEA,40,21,61,2010121209
2010,14,reg,CHI,NE,7,36,43,2010121200
2010,14,reg,SD,KC,31,0,31,2010121212
2010,14,reg,ARI,DEN,43,13,56,2010121211
2010,14,reg,NYJ,MIA,6,10,16,2010121210
2010,14,reg,DAL,PHI,27,30,57,2010121213
2010,14,reg,MIN,NYG,3,21,24,2010121301
2010,14,reg,HOU,BAL,28,34,62,2010121300
2010,15,reg,SD,SF,34,7,41,2010121600
2010,15,reg,STL,KC,13,27,40,2010121900
2010,15,reg,BAL,NO,30,24,54,2010121909
2010,15,reg,TB,DET,20,23,43,2010121908
2010,15,reg,CAR,ARI,19,12,31,2010121907
2010,15,reg,NYG,PHI,31,38,69,2010121906
2010,15,reg,MIA,BUF,14,17,31,2010121901
2010,15,reg,CIN,CLE,19,17,36,2010121902
2010,15,reg,IND,JAC,34,24,58,2010121903
2010,15,reg,TEN,HOU,31,17,48,2010121904
2010,15,reg,DAL,WAS,33,30,63,2010121905
2010,15,reg,SEA,ATL,18,34,52,2010121910
2010,15,reg,OAK,DEN,39,23,62,2010121912
2010,15,reg,PIT,NYJ,17,22,39,2010121911
2010,15,reg,NE,GB,31,27,58,2010121913
2010,15,reg,MIN,CHI,14,40,54,2010122000
2010,16,reg,PIT,CAR,27,3,30,2010122300
2010,16,reg,ARI,DAL,27,26,53,2010122500
2010,16,reg,CLE,BAL,10,20,30,2010122602
2010,16,reg,KC,TEN,34,14,48,2010122603
2010,16,reg,BUF,NE,3,34,37,2010122601
2010,16,reg,CHI,NYJ,38,34,72,2010122600
2010,16,reg,STL,SF,25,17,42,2010122606
2010,16,reg,JAC,WAS,17,20,37,2010122608
2010,16,reg,MIA,DET,27,34,61,2010122607
2010,16,reg,DEN,HOU,24,23,47,2010122609
2010,16,reg,OAK,IND,26,31,57,2010122610
2010,16,reg,CIN,SD,34,20,54,2010122612
2010,16,reg,GB,NYG,45,17,62,2010122611
2010,16,reg,TB,SEA,38,15,53,2010122605
2010,16,reg,ATL,NO,14,17,31,2010122700
2010,16,reg,PHI,MIN,14,24,38,2010122800
2010,17,reg,ATL,CAR,31,10,41,2011010211
2010,17,reg,CLE,PIT,9,41,50,2011010203
2010,17,reg,DET,MIN,20,13,33,2011010209
2010,17,reg,BAL,CIN,13,7,20,2011010202
2010,17,reg,NE,MIA,38,7,45,2011010200
2010,17,reg,NYJ,BUF,38,7,45,2011010201
2010,17,reg,KC,OAK,10,31,41,2011010206
2010,17,reg,NO,TB,13,23,36,2011010212
2010,17,reg,GB,CHI,10,3,13,2011010210
2010,17,reg,WAS,NYG,14,17,31,2011010208
2010,17,reg,IND,TEN,23,20,43,2011010205
2010,17,reg,HOU,JAC,34,17,51,2011010204
2010,17,reg,PHI,DAL,13,14,27,2011010207
2010,17,reg,DEN,SD,28,33,61,2011010213
2010,17,reg,SF,ARI,38,7,45,2011010214
2010,17,reg,SEA,STL,16,6,22,2011010215
2010,18,post,SEA,NO,41,36,77,2011010801
2010,18,post,IND,NYJ,16,17,33,2011010800
2010,18,post,KC,BAL,7,30,37,2011010900
2010,18,post,PHI,GB,16,21,37,2011010901
2010,18,post,PIT,BAL,31,24,55,2011011500
2010,18,post,ATL,GB,21,48,69,2011011501
2010,18,post,CHI,SEA,35,24,59,2011011601
2010,18,post,NE,NYJ,21,28,49,2011011600
2010,18,post,CHI,GB,14,21,35,2011012301
2010,18,post,PIT,NYJ,24,19,43,2011012300
2010,18,post,NPR,APR,55,41,96,2011013000
2010,18,post,GB,PIT,31,25,56,2011020600
2011,1,reg,GB,NO,42,34,76,2011090800
2011,1,reg,BAL,PIT,35,7,42,2011091100
2011,1,reg,STL,PHI,13,31,44,2011091107
2011,1,reg,TB,DET,20,27,47,2011091106
2011,1,reg,CHI,ATL,30,12,42,2011091105
2011,1,reg,KC,BUF,7,41,48,2011091104
2011,1,reg,JAC,TEN,16,14,30,2011091103
2011,1,reg,HOU,IND,34,7,41,2011091102
2011,1,reg,CLE,CIN,17,27,44,2011091101
2011,1,reg,SD,MIN,24,17,41,2011091111
2011,1,reg,SF,SEA,33,17,50,2011091110
2011,1,reg,ARI,CAR,28,21,49,2011091109
2011,1,reg,WAS,NYG,28,14,42,2011091108
2011,1,reg,NYJ,DAL,27,24,51,2011091112
2011,1,reg,MIA,NE,24,38,62,2011091200
2011,1,reg,DEN,OAK,20,23,43,2011091201
2011,2,reg,DET,KC,48,3,51,2011091800
2011,2,reg,BUF,OAK,38,35,73,2011091801
2011,2,reg,PIT,SEA,24,0,24,2011091809
2011,2,reg,NO,CHI,30,13,43,2011091808
2011,2,reg,CAR,GB,23,30,53,2011091807
2011,2,reg,MIN,TB,20,24,44,2011091806
2011,2,reg,WAS,ARI,22,21,43,2011091805
2011,2,reg,TEN,BAL,26,13,39,2011091802
2011,2,reg,NYJ,JAC,32,3,35,2011091803
2011,2,reg,IND,CLE,19,27,46,2011091804
2011,2,reg,SF,DAL,24,27,51,2011091810
2011,2,reg,NE,SD,35,21,56,2011091811
2011,2,reg,MIA,HOU,13,23,36,2011091813
2011,2,reg,DEN,CIN,24,22,46,2011091812
2011,2,reg,ATL,PHI,35,31,66,2011091814
2011,2,reg,NYG,STL,28,16,44,2011091900
2011,3,reg,CAR,JAC,16,10,26,2011092500
2011,3,reg,NO,HOU,40,33,73,2011092501
2011,3,reg,CIN,SF,8,13,21,2011092507
2011,3,reg,MIN,DET,23,26,49,2011092506
2011,3,reg,PHI,NYG,16,29,45,2011092505
2011,3,reg,TEN,DEN,17,14,31,2011092504
2011,3,reg,CLE,MIA,17,16,33,2011092503
2011,3,reg,BUF,NE,34,31,65,2011092502
2011,3,reg,OAK,NYJ,34,24,58,2011092508
2011,3,reg,STL,BAL,7,37,44,2011092510
2011,3,reg,SD,KC,20,17,37,2011092509
2011,3,reg,TB,ATL,16,13,29,2011092513
2011,3,reg,SEA,ARI,13,10,23,2011092512
2011,3,reg,CHI,GB,17,27,44,2011092511
2011,3,reg,IND,PIT,20,23,43,2011092514
2011,3,reg,DAL,WAS,18,16,34,2011092600
2011,4,reg,CIN,BUF,23,20,43,2011100200
2011,4,reg,CLE,TEN,13,31,44,2011100201
2011,4,reg,KC,MIN,22,17,39,2011100208
2011,4,reg,JAC,NO,10,23,33,2011100207
2011,4,reg,STL,WAS,10,17,27,2011100206
2011,4,reg,CHI,CAR,34,29,63,2011100205
2011,4,reg,PHI,SF,23,24,47,2011100204
2011,4,reg,DAL,DET,30,34,64,2011100203
2011,4,reg,HOU,PIT,17,10,27,2011100202
2011,4,reg,SEA,ATL,28,30,58,2011100210
2011,4,reg,ARI,NYG,27,31,58,2011100209
2011,4,reg,SD,MIA,26,16,42,2011100213
2011,4,reg,OAK,NE,19,31,50,2011100212
2011,4,reg,GB,DEN,49,23,72,2011100211
2011,4,reg,BAL,NYJ,34,17,51,2011100214
2011,4,reg,TB,IND,24,17,41,2011100300
2011,5,reg,PIT,TEN,38,17,55,2011100900
2011,5,reg,HOU,OAK,20,25,45,2011100901
2011,5,reg,IND,KC,24,28,52,2011100902
2011,5,reg,JAC,CIN,20,30,50,2011100903
2011,5,reg,NYG,SEA,25,36,61,2011100904
2011,5,reg,MIN,ARI,34,10,44,2011100905
2011,5,reg,CAR,NO,27,30,57,2011100906
2011,5,reg,BUF,PHI,31,24,55,2011100907
2011,5,reg,SF,TB,48,3,51,2011100908
2011,5,reg,NE,NYJ,30,21,51,2011100909
2011,5,reg,DEN,SD,24,29,53,2011100910
2011,5,reg,ATL,GB,14,25,39,2011100911
2011,5,reg,DET,CHI,24,13,37,2011101000
2011,6,reg,NYG,BUF,27,24,51,2011101600
2011,6,reg,CIN,IND,27,17,44,2011101601
2011,6,reg,PIT,JAC,17,13,30,2011101602
2011,6,reg,WAS,PHI,13,20,33,2011101603
2011,6,reg,DET,SF,19,25,44,2011101604
2011,6,reg,GB,STL,24,3,27,2011101605
2011,6,reg,ATL,CAR,31,17,48,2011101606
2011,6,reg,OAK,CLE,24,17,41,2011101607
2011,6,reg,BAL,HOU,29,14,43,2011101608
2011,6,reg,TB,NO,26,20,46,2011101609
2011,6,reg,NE,DAL,20,16,36,2011101610
2011,6,reg,CHI,MIN,39,10,49,2011101611
2011,6,reg,NYJ,MIA,24,6,30,2011101700
2011,7,reg,MIA,DEN,15,18,33,2011102300
2011,7,reg,NYJ,SD,27,21,48,2011102301
2011,7,reg,TEN,HOU,7,41,48,2011102302
2011,7,reg,DET,ATL,16,23,39,2011102303
2011,7,reg,CAR,WAS,33,20,53,2011102304
2011,7,reg,TB,CHI,18,24,42,2011102305
2011,7,reg,CLE,SEA,6,3,9,2011102306
2011,7,reg,ARI,PIT,20,32,52,2011102307
2011,7,reg,OAK,KC,0,28,28,2011102308
2011,7,reg,MIN,GB,27,33,60,2011102309
2011,7,reg,DAL,STL,34,7,41,2011102310
2011,7,reg,NO,IND,62,7,69,2011102311
2011,7,reg,JAC,BAL,12,7,19,2011102400
2011,8,reg,NYG,MIA,20,17,37,2011103000
2011,8,reg,HOU,JAC,24,14,38,2011103001
2011,8,reg,TEN,IND,27,10,37,2011103002
2011,8,reg,CAR,MIN,21,24,45,2011103003
2011,8,reg,STL,NO,31,21,52,2011103004
2011,8,reg,BAL,ARI,30,27,57,2011103005
2011,8,reg,DEN,DET,10,45,55,2011103006
2011,8,reg,BUF,WAS,23,0,23,2011103007
2011,8,reg,PIT,NE,25,17,42,2011103008
2011,8,reg,SF,CLE,20,10,30,2011103009
2011,8,reg,SEA,CIN,12,34,46,2011103010
2011,8,reg,PHI,DAL,34,7,41,2011103011
2011,8,reg,KC,SD,23,20,43,2011103100
2011,9,reg,BUF,NYJ,11,27,38,2011110600
2011,9,reg,HOU,CLE,30,12,42,2011110601
2011,9,reg,KC,MIA,3,31,34,2011110602
2011,9,reg,DAL,SEA,23,13,36,2011110603
2011,9,reg,WAS,SF,11,19,30,2011110604
2011,9,reg,NO,TB,27,16,43,2011110605
2011,9,reg,IND,ATL,7,31,38,2011110606
2011,9,reg,OAK,DEN,24,38,62,2011110607
2011,9,reg,TEN,CIN,17,24,41,2011110608
2011,9,reg,NE,NYG,20,24,44,2011110609
2011,9,reg,SD,GB,38,45,83,2011110610
2011,9,reg,ARI,STL,19,13,32,2011110611
2011,9,reg,PIT,BAL,20,23,43,2011110612
2011,9,reg,PHI,CHI,24,30,54,2011110700
2011,10,reg,SD,OAK,17,24,41,2011111000
2011,10,reg,DAL,BUF,44,7,51,2011111300
2011,10,reg,CLE,STL,12,13,25,2011111310
2011,10,reg,MIA,WAS,20,9,29,2011111309
2011,10,reg,ATL,NO,23,26,49,2011111308
2011,10,reg,PHI,ARI,17,21,38,2011111306
2011,10,reg,CAR,TEN,3,30,33,2011111301
2011,10,reg,TB,HOU,9,37,46,2011111302
2011,10,reg,CIN,PIT,17,24,41,2011111303
2011,10,reg,IND,JAC,3,17,20,2011111304
2011,10,reg,KC,DEN,10,17,27,2011111305
2011,10,reg,SEA,BAL,22,17,39,2011111311
2011,10,reg,CHI,DET,37,13,50,2011111307
2011,10,reg,SF,NYG,27,20,47,2011111312
2011,10,reg,NYJ,NE,16,37,53,2011111313
2011,10,reg,GB,MIN,45,7,52,2011111400
2011,11,reg,DEN,NYJ,17,13,30,2011111700
2011,11,reg,MIN,OAK,21,27,48,2011112000
2011,11,reg,WAS,DAL,24,27,51,2011112005
2011,11,reg,GB,TB,35,26,61,2011112007
2011,11,reg,DET,CAR,49,35,84,2011112006
2011,11,reg,BAL,CIN,31,24,55,2011112004
2011,11,reg,CLE,JAC,14,10,24,2011112003
2011,11,reg,MIA,BUF,35,8,43,2011112002
2011,11,reg,STL,SEA,7,24,31,2011112009
2011,11,reg,SF,ARI,23,7,30,2011112008
2011,11,reg,CHI,SD,31,20,51,2011112010
2011,11,reg,ATL,TEN,23,17,40,2011112001
2011,11,reg,NYG,PHI,10,17,27,2011112011
2011,11,reg,NE,KC,34,3,37,2011112100
2011,12,reg,DET,GB,15,27,42,2011112400
2011,12,reg,DAL,MIA,20,19,39,2011112401
2011,12,reg,BAL,SF,16,6,22,2011112402
2011,12,reg,ATL,MIN,24,14,38,2011112703
2011,12,reg,JAC,HOU,13,20,33,2011112702
2011,12,reg,CIN,CLE,23,20,43,2011112701
2011,12,reg,NYJ,BUF,28,24,52,2011112700
2011,12,reg,STL,ARI,20,23,43,2011112704
2011,12,reg,TEN,TB,23,17,40,2011112706
2011,12,reg,IND,CAR,19,27,46,2011112705
2011,12,reg,SEA,WAS,17,23,40,2011112707
2011,12,reg,OAK,CHI,25,20,45,2011112708
2011,12,reg,PHI,NE,20,38,58,2011112709
2011,12,reg,SD,DEN,13,16,29,2011112710
2011,12,reg,KC,PIT,9,13,22,2011112711
2011,12,reg,NO,NYG,49,24,73,2011112800
2011,13,reg,SEA,PHI,31,14,45,2011120100
2011,13,reg,WAS,NYJ,19,34,53,2011120400
2011,13,reg,NE,IND,31,24,55,2011120413
2011,13,reg,MIN,DEN,32,35,67,2011120409
2011,13,reg,HOU,ATL,17,10,27,2011120408
2011,13,reg,TB,CAR,19,38,57,2011120407
2011,13,reg,PIT,CIN,35,7,42,2011120405
2011,13,reg,CHI,KC,3,10,13,2011120401
2011,13,reg,BUF,TEN,17,23,40,2011120402
2011,13,reg,MIA,OAK,34,14,48,2011120403
2011,13,reg,CLE,BAL,10,24,34,2011120404
2011,13,reg,SF,STL,26,0,26,2011120412
2011,13,reg,ARI,DAL,19,13,32,2011120411
2011,13,reg,NYG,GB,35,38,73,2011120410
2011,13,reg,NO,DET,31,17,48,2011120406
2011,13,reg,JAC,SD,14,38,52,2011120500
2011,14,reg,PIT,CLE,14,3,17,2011120800
2011,14,reg,WAS,NE,27,34,61,2011121100
2011,14,reg,TEN,NO,17,22,39,2011121109
2011,14,reg,JAC,TB,41,14,55,2011121108
2011,14,reg,MIA,PHI,10,26,36,2011121107
2011,14,reg,CAR,ATL,23,31,54,2011121106
2011,14,reg,DET,MIN,34,28,62,2011121105
2011,14,reg,NYJ,KC,37,10,47,2011121102
2011,14,reg,CIN,HOU,19,20,39,2011121103
2011,14,reg,BAL,IND,24,10,34,2011121104
2011,14,reg,DEN,CHI,13,10,23,2011121111
2011,14,reg,ARI,SF,21,19,40,2011121110
2011,14,reg,SD,BUF,37,10,47,2011121112
2011,14,reg,GB,OAK,46,16,62,2011121101
2011,14,reg,DAL,NYG,34,37,71,2011121113
2011,14,reg,SEA,STL,30,13,43,2011121200
2011,15,reg,ATL,JAC,41,14,55,2011121500
2011,15,reg,TB,DAL,15,31,46,2011121700
2011,15,reg,IND,TEN,27,13,40,2011121802
2011,15,reg,NYG,WAS,10,23,33,2011121803
2011,15,reg,CHI,SEA,14,38,52,2011121804
2011,15,reg,BUF,MIA,23,30,53,2011121801
2011,15,reg,STL,CIN,13,20,33,2011121800
2011,15,reg,MIN,NO,20,42,62,2011121805
2011,15,reg,KC,GB,19,14,33,2011121807
2011,15,reg,HOU,CAR,13,28,41,2011121806
2011,15,reg,OAK,DET,27,28,55,2011121808
2011,15,reg,PHI,NYJ,45,19,64,2011121809
2011,15,reg,ARI,CLE,20,17,37,2011121810
2011,15,reg,DEN,NE,23,41,64,2011121811
2011,15,reg,SD,BAL,34,14,48,2011121812
2011,15,reg,SF,PIT,20,3,23,2011121900
2011,16,reg,IND,HOU,19,16,35,2011122200
2011,16,reg,BUF,DEN,40,14,54,2011122400
2011,16,reg,PIT,STL,27,0,27,2011122409
2011,16,reg,CIN,ARI,23,16,39,2011122408
2011,16,reg,CAR,TB,48,16,64,2011122407
2011,16,reg,WAS,MIN,26,33,59,2011122406
2011,16,reg,NE,MIA,27,24,51,2011122401
2011,16,reg,BAL,CLE,20,14,34,2011122402
2011,16,reg,TEN,JAC,23,17,40,2011122403
2011,16,reg,KC,OAK,13,16,29,2011122404
2011,16,reg,NYJ,NYG,14,29,43,2011122405
2011,16,reg,DET,SD,38,10,48,2011122410
2011,16,reg,SEA,SF,17,19,36,2011122412
2011,16,reg,DAL,PHI,7,20,27,2011122411
2011,16,reg,GB,CHI,35,21,56,2011122500
2011,16,reg,NO,ATL,45,16,61,2011122600
2011,17,reg,MIA,NYJ,19,17,36,2012010100
2011,17,reg,NE,BUF,49,21,70,2012010101
2011,17,reg,STL,SF,27,34,61,2012010112
2011,17,reg,NO,CAR,45,17,62,2012010111
2011,17,reg,MIN,CHI,13,17,30,2012010109
2011,17,reg,GB,DET,45,41,86,2012010108
2011,17,reg,PHI,WAS,34,10,44,2012010107
2011,17,reg,JAC,IND,19,13,32,2012010105
2011,17,reg,HOU,TEN,22,23,45,2012010104
2011,17,reg,ATL,TB,45,24,69,2012010110
2011,17,reg,OAK,SD,26,38,64,2012010114
2011,17,reg,DEN,KC,3,7,10,2012010113
2011,17,reg,CLE,PIT,9,13,22,2012010103
2011,17,reg,CIN,BAL,16,24,40,2012010102
2011,17,reg,ARI,SEA,23,20,43,2012010115
2011,17,reg,NYG,DAL,31,14,45,2012010106
2011,18,post,HOU,CIN,31,10,41,2012010700
2011,18,post,NO,DET,45,28,73,2012010701
2011,18,post,NYG,ATL,24,2,26,2012010801
2011,18,post,DEN,PIT,29,23,52,2012010800
2011,18,post,SF,NO,36,32,68,2012011401
2011,18,post,NE,DEN,45,10,55,2012011400
2011,18,post,BAL,HOU,20,13,33,2012011500
2011,18,post,GB,NYG,20,37,57,2012011501
2011,18,post,NE,BAL,23,20,43,2012012200
2011,18,post,SF,NYG,17,20,37,2012012201
2011,18,post,APR,NPR,59,41,100,2012012900
2011,18,post,NE,NYG,17,21,38,2012020500
2012,1,reg,NYG,DAL,17,24,41,2012090500
2012,1,reg,CHI,IND,41,21,62,2012090900
2012,1,reg,KC,ATL,24,40,64,2012090908
2012,1,reg,CLE,PHI,16,17,33,2012090907
2012,1,reg,NO,WAS,32,40,72,2012090906
2012,1,reg,DET,STL,27,23,50,2012090905
2012,1,reg,TEN,NE,13,34,47,2012090904
2012,1,reg,MIN,JAC,26,23,49,2012090901
2012,1,reg,NYJ,BUF,48,28,76,2012090902
2012,1,reg,HOU,MIA,30,10,40,2012090903
2012,1,reg,ARI,SEA,20,16,36,2012090910
2012,1,reg,GB,SF,22,30,52,2012090909
2012,1,reg,TB,CAR,16,10,26,2012090911
2012,1,reg,DEN,PIT,31,19,50,2012090912
2012,1,reg,BAL,CIN,44,13,57,2012091000
2012,1,reg,OAK,SD,14,22,36,2012091001
2012,2,reg,GB,CHI,23,10,33,2012091300
2012,2,reg,NYG,TB,41,34,75,2012091600
2012,2,reg,MIA,OAK,35,13,48,2012091612
2012,2,reg,JAC,HOU,7,27,34,2012091607
2012,2,reg,CIN,CLE,34,27,61,2012091606
2012,2,reg,BUF,KC,35,17,52,2012091605
2012,2,reg,PHI,BAL,24,23,47,2012091604
2012,2,reg,CAR,NO,35,27,62,2012091601
2012,2,reg,NE,ARI,18,20,38,2012091602
2012,2,reg,IND,MIN,23,20,43,2012091603
2012,2,reg,STL,WAS,31,28,59,2012091609
2012,2,reg,SEA,DAL,27,7,34,2012091608
2012,2,reg,PIT,NYJ,27,10,37,2012091610
2012,2,reg,SD,TEN,38,10,48,2012091611
2012,2,reg,SF,DET,27,19,46,2012091613
2012,2,reg,ATL,DEN,27,21,48,2012091700
2012,3,reg,CAR,NYG,7,36,43,2012092000
2012,3,reg,DAL,TB,16,10,26,2012092300
2012,3,reg,IND,JAC,17,22,39,2012092308
2012,3,reg,CLE,BUF,14,24,38,2012092307
2012,3,reg,MIA,NYJ,20,23,43,2012092306
2012,3,reg,NO,KC,24,27,51,2012092305
2012,3,reg,WAS,CIN,31,38,69,2012092304
2012,3,reg,CHI,STL,23,6,29,2012092301
2012,3,reg,MIN,SF,24,13,37,2012092302
2012,3,reg,TEN,DET,44,41,85,2012092303
2012,3,reg,SD,ATL,3,27,30,2012092310
2012,3,reg,ARI,PHI,27,6,33,2012092309
2012,3,reg,OAK,PIT,34,31,65,2012092312
2012,3,reg,DEN,HOU,25,31,56,2012092311
2012,3,reg,BAL,NE,31,30,61,2012092313
2012,3,reg,SEA,GB,14,12,26,2012092400
2012,4,reg,BAL,CLE,23,16,39,2012092700
2012,4,reg,BUF,NE,28,52,80,2012093000
2012,4,reg,NYJ,SF,0,34,34,2012093006
2012,4,reg,STL,SEA,19,13,32,2012093005
2012,4,reg,ATL,CAR,30,28,58,2012093004
2012,4,reg,DET,MIN,13,20,33,2012093003
2012,4,reg,KC,SD,20,37,57,2012093002
2012,4,reg,HOU,TEN,38,14,52,2012093001
2012,4,reg,JAC,CIN,10,27,37,2012093009
2012,4,reg,DEN,OAK,37,6,43,2012093008
2012,4,reg,ARI,MIA,24,21,45,2012093007
2012,4,reg,TB,WAS,22,24,46,2012093011
2012,4,reg,GB,NO,28,27,55,2012093010
2012,4,reg,PHI,NYG,19,17,36,2012093012
2012,4,reg,DAL,CHI,18,34,52,2012100100
2012,5,reg,STL,ARI,17,3,20,2012100400
2012,5,reg,PIT,PHI,16,14,30,2012100701
2012,5,reg,IND,GB,30,27,57,2012100702
2012,5,reg,NYG,CLE,41,27,68,2012100703
2012,5,reg,WAS,ATL,17,24,41,2012100700
2012,5,reg,CIN,MIA,13,17,30,2012100705
2012,5,reg,KC,BAL,6,9,15,2012100706
2012,5,reg,CAR,SEA,12,16,28,2012100707
2012,5,reg,JAC,CHI,3,41,44,2012100708
2012,5,reg,NE,DEN,31,21,52,2012100709
2012,5,reg,SF,BUF,45,3,48,2012100710
2012,5,reg,MIN,TEN,30,7,37,2012100704
2012,5,reg,NO,SD,31,24,55,2012100711
2012,5,reg,NYJ,HOU,17,23,40,2012100800
2012,6,reg,TEN,PIT,26,23,49,2012101100
2012,6,reg,TB,KC,38,10,48,2012101401
2012,6,reg,NYJ,IND,35,9,44,2012101402
2012,6,reg,CLE,CIN,34,24,58,2012101403
2012,6,reg,PHI,DET,23,26,49,2012101404
2012,6,reg,ATL,OAK,23,20,43,2012101400
2012,6,reg,MIA,STL,17,14,31,2012101405
2012,6,reg,BAL,DAL,31,29,60,2012101406
2012,6,reg,ARI,BUF,16,19,35,2012101407
2012,6,reg,SEA,NE,24,23,47,2012101408
2012,6,reg,SF,NYG,3,26,29,2012101409
2012,6,reg,WAS,MIN,38,26,64,2012101410
2012,6,reg,HOU,GB,24,42,66,2012101411
2012,6,reg,SD,DEN,24,35,59,2012101500
2012,7,reg,SF,SEA,13,6,19,2012101800
2012,7,reg,MIN,ARI,21,14,35,2012102101
2012,7,reg,CAR,DAL,14,19,33,2012102102
2012,7,reg,TB,NO,28,35,63,2012102103
2012,7,reg,STL,GB,20,30,50,2012102104
2012,7,reg,NYG,WAS,27,23,50,2012102100
2012,7,reg,HOU,BAL,43,13,56,2012102105
2012,7,reg,BUF,TEN,34,35,69,2012102107
2012,7,reg,IND,CLE,17,13,30,2012102106
2012,7,reg,NE,NYJ,29,26,55,2012102108
2012,7,reg,OAK,JAC,26,23,49,2012102109
2012,7,reg,CIN,PIT,17,24,41,2012102110
2012,7,reg,CHI,DET,13,7,20,2012102200
2012,8,reg,MIN,TB,17,36,53,2012102500
2012,8,reg,NYJ,MIA,9,30,39,2012102801
2012,8,reg,CLE,SD,7,6,13,2012102802
2012,8,reg,TEN,IND,13,19,32,2012102803
2012,8,reg,STL,NE,7,45,52,2012102804
2012,8,reg,GB,JAC,24,15,39,2012102800
2012,8,reg,PHI,ATL,17,30,47,2012102805
2012,8,reg,PIT,WAS,27,12,39,2012102808
2012,8,reg,DET,SEA,28,24,52,2012102807
2012,8,reg,CHI,CAR,23,22,45,2012102806
2012,8,reg,KC,OAK,16,26,42,2012102809
2012,8,reg,DAL,NYG,24,29,53,2012102810
2012,8,reg,DEN,NO,34,14,48,2012102811
2012,8,reg,ARI,SF,3,24,27,2012102900
2012,9,reg,SD,KC,31,13,44,2012110100
2012,9,reg,GB,ARI,31,17,48,2012110401
2012,9,reg,JAC,DET,14,31,45,2012110402
2012,9,reg,TEN,CHI,20,51,71,2012110403
2012,9,reg,CIN,DEN,23,31,54,2012110404
2012,9,reg,WAS,CAR,13,21,34,2012110400
2012,9,reg,CLE,BAL,15,25,40,2012110405
2012,9,reg,IND,MIA,23,20,43,2012110407
2012,9,reg,HOU,BUF,21,9,30,2012110406
2012,9,reg,SEA,MIN,30,20,50,2012110408
2012,9,reg,OAK,TB,32,42,74,2012110409
2012,9,reg,NYG,PIT,20,24,44,2012110410
2012,9,reg,ATL,DAL,19,13,32,2012110411
2012,9,reg,NO,PHI,28,13,41,2012110500
2012,10,reg,JAC,IND,10,27,37,2012110800
2012,10,reg,TB,SD,34,24,58,2012111101
2012,10,reg,MIA,TEN,3,37,40,2012111102
2012,10,reg,NE,BUF,37,31,68,2012111103
2012,10,reg,BAL,OAK,55,20,75,2012111104
2012,10,reg,CAR,DEN,14,36,50,2012111100
2012,10,reg,CIN,NYG,31,13,44,2012111105
2012,10,reg,MIN,DET,34,24,58,2012111107
2012,10,reg,NO,ATL,31,27,58,2012111106
2012,10,reg,SEA,NYJ,28,7,35,2012111108
2012,10,reg,PHI,DAL,23,38,61,2012111109
2012,10,reg,SF,STL,24,24,48,2012111110
2012,10,reg,CHI,HOU,6,13,19,2012111111
2012,10,reg,PIT,KC,16,13,29,2012111200
2012,11,reg,BUF,MIA,19,14,33,2012111500
2012,11,reg,DET,GB,20,24,44,2012111801
2012,11,reg,ATL,ARI,23,19,42,2012111802
2012,11,reg,CAR,TB,21,27,48,2012111803
2012,11,reg,DAL,CLE,23,20,43,2012111804
2012,11,reg,WAS,PHI,31,6,37,2012111800
2012,11,reg,STL,NYJ,13,27,40,2012111805
2012,11,reg,KC,CIN,6,28,34,2012111808
2012,11,reg,HOU,JAC,43,37,80,2012111807
2012,11,reg,OAK,NO,17,38,55,2012111809
2012,11,reg,DEN,SD,30,23,53,2012111810
2012,11,reg,NE,IND,59,24,83,2012111806
2012,11,reg,PIT,BAL,10,13,23,2012111811
2012,11,reg,SF,CHI,32,7,39,2012111900
2012,12,reg,DET,HOU,31,34,65,2012112200
2012,12,reg,DAL,WAS,31,38,69,2012112201
2012,12,reg,NYJ,NE,19,49,68,2012112202
2012,12,reg,JAC,TEN,24,19,43,2012112503
2012,12,reg,IND,BUF,20,13,33,2012112502
2012,12,reg,CLE,PIT,20,14,34,2012112501
2012,12,reg,CIN,OAK,34,10,44,2012112500
2012,12,reg,KC,DEN,9,17,26,2012112504
2012,12,reg,MIA,SEA,24,21,45,2012112507
2012,12,reg,TB,ATL,23,24,47,2012112506
2012,12,reg,CHI,MIN,28,10,38,2012112505
2012,12,reg,SD,BAL,13,16,29,2012112508
2012,12,reg,ARI,STL,17,31,48,2012112510
2012,12,reg,NO,SF,21,31,52,2012112509
2012,12,reg,NYG,GB,38,10,48,2012112511
2012,12,reg,PHI,CAR,22,30,52,2012112600
2012,13,reg,ATL,NO,23,13,36,2012112900
2012,13,reg,CHI,SEA,17,23,40,2012120200
2012,13,reg,TEN,HOU,10,24,34,2012120208
2012,13,reg,MIA,NE,16,23,39,2012120207
2012,13,reg,BUF,JAC,34,18,52,2012120206
2012,13,reg,DET,IND,33,35,68,2012120205
2012,13,reg,KC,CAR,27,21,48,2012120204
2012,13,reg,GB,MIN,23,14,37,2012120201
2012,13,reg,STL,SF,16,13,29,2012120202
2012,13,reg,NYJ,ARI,7,6,13,2012120203
2012,13,reg,DEN,TB,31,23,54,2012120209
2012,13,reg,BAL,PIT,20,23,43,2012120210
2012,13,reg,SD,CIN,13,20,33,2012120212
2012,13,reg,OAK,CLE,17,20,37,2012120211
2012,13,reg,DAL,PHI,38,33,71,2012120213
2012,13,reg,WAS,NYG,17,16,33,2012120300
2012,14,reg,OAK,DEN,13,26,39,2012120600
2012,14,reg,WAS,BAL,31,28,59,2012120900
2012,14,reg,CIN,DAL,19,20,39,2012120909
2012,14,reg,BUF,STL,12,15,27,2012120908
2012,14,reg,TB,PHI,21,23,44,2012120907
2012,14,reg,CAR,ATL,30,20,50,2012120906
2012,14,reg,CLE,KC,30,7,37,2012120901
2012,14,reg,PIT,SD,24,34,58,2012120902
2012,14,reg,IND,TEN,27,23,50,2012120903
2012,14,reg,JAC,NYJ,10,17,27,2012120904
2012,14,reg,MIN,CHI,21,14,35,2012120905
2012,14,reg,SF,MIA,27,13,40,2012120910
2012,14,reg,SEA,ARI,58,0,58,2012120912
2012,14,reg,NYG,NO,52,27,79,2012120911
2012,14,reg,GB,DET,27,20,47,2012120913
2012,14,reg,NE,HOU,42,14,56,2012121000
2012,15,reg,PHI,CIN,13,34,47,2012121300
2012,15,reg,CHI,GB,13,21,34,2012121600
2012,15,reg,HOU,IND,29,17,46,2012121607
2012,15,reg,BAL,DEN,17,34,51,2012121606
2012,15,reg,MIA,JAC,24,3,27,2012121605
2012,15,reg,CLE,WAS,21,38,59,2012121604
2012,15,reg,STL,MIN,22,36,58,2012121603
2012,15,reg,NO,TB,41,0,41,2012121602
2012,15,reg,ATL,NYG,34,0,34,2012121601
2012,15,reg,BUF,SEA,17,50,67,2012121610
2012,15,reg,SD,CAR,7,31,38,2012121609
2012,15,reg,ARI,DET,38,10,48,2012121608
2012,15,reg,OAK,KC,15,0,15,2012121612
2012,15,reg,DAL,PIT,27,24,51,2012121611
2012,15,reg,NE,SF,34,41,75,2012121613
2012,15,reg,TEN,NYJ,14,10,24,2012121700
2012,16,reg,DET,ATL,18,31,49,2012122200
2012,16,reg,CAR,OAK,17,6,23,2012122301
2012,16,reg,MIA,BUF,24,10,34,2012122302
2012,16,reg,PIT,CIN,10,13,23,2012122303
2012,16,reg,JAC,NE,16,23,39,2012122304
2012,16,reg,KC,IND,13,20,33,2012122305
2012,16,reg,DAL,NO,31,34,65,2012122306
2012,16,reg,PHI,WAS,20,27,47,2012122307
2012,16,reg,TB,STL,13,28,41,2012122308
2012,16,reg,NYJ,SD,17,27,44,2012122314
2012,16,reg,GB,TEN,55,7,62,2012122300
2012,16,reg,HOU,MIN,6,23,29,2012122310
2012,16,reg,DEN,CLE,34,12,46,2012122311
2012,16,reg,ARI,CHI,13,28,41,2012122312
2012,16,reg,BAL,NYG,33,14,47,2012122309
2012,16,reg,SEA,SF,42,13,55,2012122313
2012,17,reg,ATL,TB,17,22,39,2012123010
2012,17,reg,BUF,NYJ,28,9,37,2012123000
2012,17,reg,CIN,BAL,23,17,40,2012123002
2012,17,reg,PIT,CLE,24,10,34,2012123003
2012,17,reg,DET,CHI,24,26,50,2012123008
2012,17,reg,TEN,JAC,38,20,58,2012123005
2012,17,reg,NYG,PHI,42,7,49,2012123006
2012,17,reg,NO,CAR,38,44,82,2012123011
2012,17,reg,IND,HOU,28,16,44,2012123004
2012,17,reg,MIN,GB,37,34,71,2012123009
2012,17,reg,SEA,STL,20,13,33,2012123015
2012,17,reg,NE,MIA,28,0,28,2012123001
2012,17,reg,DEN,KC,38,3,41,2012123012
2012,17,reg,SD,OAK,24,21,45,2012123013
2012,17,reg,SF,ARI,27,13,40,2012123014
2012,17,reg,WAS,DAL,28,18,46,2012123007
2012,18,post,HOU,CIN,19,13,32,2013010500
2012,18,post,GB,MIN,24,10,34,2013010501
2012,18,post,BAL,IND,24,9,33,2013010600
2012,18,post,WAS,SEA,14,24,38,2013010601
2012,18,post,DEN,BAL,35,38,73,2013011200
2012,18,post,SF,GB,45,31,76,2013011201
2012,18,post,ATL,SEA,30,28,58,2013011301
2012,18,post,NE,HOU,41,28,69,2013011300
2012,18,post,ATL,SF,24,28,52,2013012001
2012,18,post,NE,BAL,13,28,41,2013012000
2012,18,post,NPR,APR,62,35,97,2013012700
2012,18,post,SF,BAL,31,34,65,2013020300
2013,1,reg,DEN,BAL,49,27,76,2013090500
2013,1,reg,BUF,NE,21,23,44,2013090800
2013,1,reg,PIT,TEN,9,16,25,2013090809
2013,1,reg,NO,ATL,23,17,40,2013090808
2013,1,reg,NYJ,TB,18,17,35,2013090807
2013,1,reg,JAC,KC,2,28,30,2013090806
2013,1,reg,CAR,SEA,7,12,19,2013090801
2013,1,reg,CHI,CIN,24,21,45,2013090802
2013,1,reg,CLE,MIA,10,23,33,2013090803
2013,1,reg,DET,MIN,34,24,58,2013090804
2013,1,reg,IND,OAK,21,17,38,2013090805
2013,1,reg,SF,GB,34,28,62,2013090811
2013,1,reg,STL,ARI,27,24,51,2013090810
2013,1,reg,DAL,NYG,36,31,67,2013090812
2013,1,reg,WAS,PHI,27,33,60,2013090900
2013,1,reg,SD,HOU,28,31,59,2013090901
2013,2,reg,NE,NYJ,13,10,23,2013091200
2013,2,reg,ATL,STL,31,24,55,2013091500
2013,2,reg,PHI,SD,30,33,63,2013091508
2013,2,reg,KC,DAL,17,16,33,2013091507
2013,2,reg,IND,MIA,20,24,44,2013091506
2013,2,reg,HOU,TEN,30,24,54,2013091505
2013,2,reg,GB,WAS,38,20,58,2013091504
2013,2,reg,BAL,CLE,14,6,20,2013091501
2013,2,reg,BUF,CAR,24,23,47,2013091502
2013,2,reg,CHI,MIN,31,30,61,2013091503
2013,2,reg,TB,NO,14,16,30,2013091510
2013,2,reg,ARI,DET,25,21,46,2013091509
2013,2,reg,OAK,JAC,19,9,28,2013091512
2013,2,reg,NYG,DEN,23,41,64,2013091511
2013,2,reg,SEA,SF,29,3,32,2013091513
2013,2,reg,CIN,PIT,20,10,30,2013091600
2013,3,reg,PHI,KC,16,26,42,2013091900
2013,3,reg,BAL,HOU,30,9,39,2013092200
2013,3,reg,CAR,NYG,38,0,38,2013092210
2013,3,reg,WAS,DET,20,27,47,2013092209
2013,3,reg,TEN,SD,20,17,37,2013092208
2013,3,reg,NO,ARI,31,7,38,2013092207
2013,3,reg,NE,TB,23,3,26,2013092206
2013,3,reg,CIN,GB,34,30,64,2013092201
2013,3,reg,DAL,STL,31,7,38,2013092202
2013,3,reg,MIN,CLE,27,31,58,2013092204
2013,3,reg,MIA,ATL,27,23,50,2013092203
2013,3,reg,NYJ,BUF,27,20,47,2013092205
2013,3,reg,SF,IND,7,27,34,2013092211
2013,3,reg,SEA,JAC,45,17,62,2013092212
2013,3,reg,PIT,CHI,23,40,63,2013092213
2013,3,reg,DEN,OAK,37,21,58,2013092300
2013,4,reg,STL,SF,11,35,46,2013092600
2013,4,reg,BUF,BAL,23,20,43,2013092900
2013,4,reg,TB,ARI,10,13,23,2013092907
2013,4,reg,MIN,PIT,34,27,61,2013092906
2013,4,reg,KC,NYG,31,7,38,2013092905
2013,4,reg,JAC,IND,3,37,40,2013092904
2013,4,reg,HOU,SEA,20,23,43,2013092903
2013,4,reg,CLE,CIN,17,6,23,2013092901
2013,4,reg,DET,CHI,40,32,72,2013092902
2013,4,reg,TEN,NYJ,38,13,51,2013092908
2013,4,reg,OAK,WAS,14,24,38,2013092910
2013,4,reg,DEN,PHI,52,20,72,2013092909
2013,4,reg,SD,DAL,30,21,51,2013092911
2013,4,reg,ATL,NE,23,30,53,2013092912
2013,4,reg,NO,MIA,38,17,55,2013093000
2013,5,reg,CLE,BUF,37,24,61,2013100300
2013,5,reg,CIN,NE,13,6,19,2013100601
2013,5,reg,GB,DET,22,9,31,2013100602
2013,5,reg,IND,SEA,34,28,62,2013100603
2013,5,reg,MIA,BAL,23,26,49,2013100604
2013,5,reg,CHI,NO,18,26,44,2013100600
2013,5,reg,NYG,PHI,21,36,57,2013100605
2013,5,reg,TEN,KC,17,26,43,2013100607
2013,5,reg,STL,JAC,34,20,54,2013100606
2013,5,reg,ARI,CAR,22,6,28,2013100608
2013,5,reg,DAL,DEN,48,51,99,2013100609
2013,5,reg,SF,HOU,34,3,37,2013100611
2013,5,reg,OAK,SD,27,17,44,2013100610
2013,5,reg,ATL,NYJ,28,30,58,2013100700
2013,6,reg,CHI,NYG,27,21,48,2013101000
2013,6,reg,BAL,GB,17,19,36,2013101300
2013,6,reg,BUF,CIN,24,27,51,2013101301
2013,6,reg,CLE,DET,17,31,48,2013101302
2013,6,reg,HOU,STL,13,38,51,2013101303
2013,6,reg,MIN,CAR,10,35,45,2013101305
2013,6,reg,KC,OAK,24,7,31,2013101304
2013,6,reg,NYJ,PIT,6,19,25,2013101306
2013,6,reg,TB,PHI,20,31,51,2013101307
2013,6,reg,DEN,JAC,35,19,54,2013101308
2013,6,reg,SEA,TEN,20,13,33,2013101309
2013,6,reg,NE,NO,30,27,57,2013101310
2013,6,reg,SF,ARI,32,20,52,2013101311
2013,6,reg,DAL,WAS,31,16,47,2013101312
2013,6,reg,SD,IND,19,9,28,2013101400
2013,7,reg,ARI,SEA,22,34,56,2013101700
2013,7,reg,ATL,TB,31,23,54,2013102000
2013,7,reg,WAS,CHI,45,41,86,2013102009
2013,7,reg,PHI,DAL,3,17,20,2013102008
2013,7,reg,NYJ,NE,30,27,57,2013102007
2013,7,reg,MIA,BUF,21,23,44,2013102006
2013,7,reg,JAC,SD,6,24,30,2013102004
2013,7,reg,CAR,STL,30,15,45,2013102001
2013,7,reg,DET,CIN,24,27,51,2013102002
2013,7,reg,TEN,SF,17,31,48,2013102010
2013,7,reg,KC,HOU,17,16,33,2013102005
2013,7,reg,PIT,BAL,19,16,35,2013102011
2013,7,reg,GB,CLE,31,13,44,2013102003
2013,7,reg,IND,DEN,39,33,72,2013102012
2013,7,reg,NYG,MIN,23,7,30,2013102100
2013,8,reg,TB,CAR,13,31,44,2013102400
2013,8,reg,JAC,SF,10,42,52,2013102701
2013,8,reg,KC,CLE,23,17,40,2013102702
2013,8,reg,NE,MIA,27,17,44,2013102703
2013,8,reg,NO,BUF,35,17,52,2013102704
2013,8,reg,DET,DAL,31,30,61,2013102700
2013,8,reg,PHI,NYG,7,15,22,2013102705
2013,8,reg,OAK,PIT,21,18,39,2013102706
2013,8,reg,CIN,NYJ,49,9,58,2013102707
2013,8,reg,ARI,ATL,27,13,40,2013102708
2013,8,reg,DEN,WAS,45,21,66,2013102709
2013,8,reg,MIN,GB,31,44,75,2013102710
2013,8,reg,STL,SEA,9,14,23,2013102800
2013,9,reg,MIA,CIN,22,20,42,2013103100
2013,9,reg,CAR,ATL,34,10,44,2013110301
2013,9,reg,DAL,MIN,27,23,50,2013110302
2013,9,reg,NYJ,NO,26,20,46,2013110303
2013,9,reg,STL,TEN,21,28,49,2013110304
2013,9,reg,BUF,KC,13,23,36,2013110300
2013,9,reg,WAS,SD,30,24,54,2013110305
2013,9,reg,OAK,PHI,20,49,69,2013110306
2013,9,reg,SEA,TB,27,24,51,2013110307
2013,9,reg,CLE,BAL,24,18,42,2013110308
2013,9,reg,NE,PIT,55,31,86,2013110309
2013,9,reg,HOU,IND,24,27,51,2013110310
2013,9,reg,GB,CHI,20,27,47,2013110400
2013,10,reg,MIN,WAS,34,27,61,2013110700
2013,10,reg,GB,PHI,13,27,40,2013111003
2013,10,reg,TEN,JAC,27,29,56,2013111007
2013,10,reg,PIT,BUF,23,10,33,2013111006
2013,10,reg,NYG,OAK,24,20,44,2013111005
2013,10,reg,IND,STL,8,38,46,2013111004
2013,10,reg,ATL,SEA,10,33,43,2013111000
2013,10,reg,BAL,CIN,20,17,37,2013111001
2013,10,reg,CHI,DET,19,21,40,2013111002
2013,10,reg,SF,CAR,9,10,19,2013111008
2013,10,reg,ARI,HOU,27,24,51,2013111009
2013,10,reg,SD,DEN,20,28,48,2013111010
2013,10,reg,NO,DAL,49,17,66,2013111011
2013,10,reg,TB,MIA,22,19,41,2013111100
2013,11,reg,TEN,IND,27,30,57,2013111400
2013,11,reg,BUF,NYJ,37,14,51,2013111700
2013,11,reg,TB,ATL,41,28,69,2013111708
2013,11,reg,PIT,DET,37,27,64,2013111707
2013,11,reg,PHI,WAS,24,16,40,2013111706
2013,11,reg,JAC,ARI,14,27,41,2013111704
2013,11,reg,HOU,OAK,23,28,51,2013111703
2013,11,reg,CHI,BAL,23,20,43,2013111701
2013,11,reg,CIN,CLE,41,20,61,2013111702
2013,11,reg,MIA,SD,20,16,36,2013111705
2013,11,reg,NYG,GB,27,13,40,2013111712
2013,11,reg,SEA,MIN,41,20,61,2013111711
2013,11,reg,NO,SF,23,20,43,2013111710
2013,11,reg,DEN,KC,27,17,44,2013111709
2013,11,reg,CAR,NE,24,20,44,2013111800
2013,12,reg,ATL,NO,13,17,30,2013112100
2013,12,reg,DET,TB,21,24,45,2013112402
2013,12,reg,GB,MIN,26,26,52,2013112403
2013,12,reg,HOU,JAC,6,13,19,2013112404
2013,12,reg,KC,SD,38,41,79,2013112405
2013,12,reg,MIA,CAR,16,20,36,2013112406
2013,12,reg,CLE,PIT,11,27,38,2013112401
2013,12,reg,STL,CHI,42,21,63,2013112407
2013,12,reg,BAL,NYJ,19,3,22,2013112400
2013,12,reg,OAK,TEN,19,23,42,2013112409
2013,12,reg,ARI,IND,40,11,51,2013112408
2013,12,reg,NYG,DAL,21,24,45,2013112410
2013,12,reg,NE,DEN,34,31,65,2013112411
2013,12,reg,WAS,SF,6,27,33,2013112500
2013,13,reg,DET,GB,40,10,50,2013112800
2013,13,reg,DAL,OAK,31,24,55,2013112801
2013,13,reg,BAL,PIT,22,20,42,2013112802
2013,13,reg,IND,TEN,22,14,36,2013120102
2013,13,reg,CLE,JAC,28,32,60,2013120101
2013,13,reg,CAR,TB,27,6,33,2013120100
2013,13,reg,MIN,CHI,23,20,43,2013120104
2013,13,reg,HOU,NE,31,34,65,2013120109
2013,13,reg,PHI,ARI,24,21,45,2013120106
2013,13,reg,NYJ,MIA,3,23,26,2013120105
2013,13,reg,BUF,ATL,31,34,65,2013120107
2013,13,reg,SF,STL,23,13,36,2013120108
2013,13,reg,SD,CIN,10,17,27,2013120110
2013,13,reg,KC,DEN,28,35,63,2013120103
2013,13,reg,WAS,NYG,17,24,41,2013120111
2013,13,reg,SEA,NO,34,7,41,2013120200
2013,14,reg,JAC,HOU,27,20,47,2013120500
2013,14,reg,CIN,IND,42,28,70,2013120801
2013,14,reg,NE,CLE,27,26,53,2013120802
2013,14,reg,NYJ,OAK,37,27,64,2013120803
2013,14,reg,WAS,KC,10,45,55,2013120808
2013,14,reg,BAL,MIN,29,26,55,2013120800
2013,14,reg,GB,ATL,22,21,43,2013120813
2013,14,reg,TB,BUF,27,6,33,2013120807
2013,14,reg,PIT,MIA,28,34,62,2013120806
2013,14,reg,PHI,DET,34,20,54,2013120805
2013,14,reg,DEN,TEN,51,28,79,2013120809
2013,14,reg,ARI,STL,30,10,40,2013120810
2013,14,reg,SF,SEA,19,17,36,2013120812
2013,14,reg,SD,NYG,37,14,51,2013120811
2013,14,reg,NO,CAR,31,13,44,2013120804
2013,14,reg,CHI,DAL,45,28,73,2013120900
2013,15,reg,DEN,SD,20,27,47,2013121200
2013,15,reg,ATL,WAS,27,26,53,2013121500
2013,15,reg,TB,SF,14,33,47,2013121508
2013,15,reg,NYG,SEA,0,23,23,2013121506
2013,15,reg,MIN,PHI,48,30,78,2013121505
2013,15,reg,MIA,NE,24,20,44,2013121504
2013,15,reg,JAC,BUF,20,27,47,2013121503
2013,15,reg,IND,HOU,25,3,28,2013121502
2013,15,reg,CLE,CHI,31,38,69,2013121501
2013,15,reg,OAK,KC,31,56,87,2013121511
2013,15,reg,CAR,NYJ,30,20,50,2013121510
2013,15,reg,DAL,GB,36,37,73,2013121512
2013,15,reg,TEN,ARI,34,37,71,2013121509
2013,15,reg,STL,NO,27,16,43,2013121507
2013,15,reg,PIT,CIN,30,20,50,2013121513
2013,15,reg,DET,BAL,16,18,34,2013121600
2013,16,reg,BUF,MIA,19,0,19,2013122200
2013,16,reg,CAR,NO,17,13,30,2013122201
2013,16,reg,CIN,MIN,42,14,56,2013122202
2013,16,reg,HOU,DEN,13,37,50,2013122203
2013,16,reg,JAC,TEN,16,20,36,2013122204
2013,16,reg,KC,IND,7,23,30,2013122205
2013,16,reg,WAS,DAL,23,24,47,2013122209
2013,16,reg,NYJ,CLE,24,13,37,2013122206
2013,16,reg,STL,TB,23,13,36,2013122208
2013,16,reg,SEA,ARI,10,17,27,2013122211
2013,16,reg,DET,NYG,20,23,43,2013122210
2013,16,reg,BAL,NE,7,41,48,2013122214
2013,16,reg,SD,OAK,26,13,39,2013122213
2013,16,reg,GB,PIT,31,38,69,2013122212
2013,16,reg,PHI,CHI,54,11,65,2013122207
2013,16,reg,SF,ATL,34,24,58,2013122300
2013,17,reg,PIT,CLE,20,7,27,2013122910
2013,17,reg,NYG,WAS,20,6,26,2013122909
2013,17,reg,CIN,BAL,34,17,51,2013122902
2013,17,reg,TEN,HOU,16,10,26,2013122911
2013,17,reg,IND,JAC,30,10,40,2013122904
2013,17,reg,MIA,NYJ,7,20,27,2013122905
2013,17,reg,MIN,DET,14,13,27,2013122906
2013,17,reg,ATL,CAR,20,21,41,2013122900
2013,17,reg,NO,TB,42,17,59,2013122908
2013,17,reg,NE,BUF,34,20,54,2013122907
2013,17,reg,SEA,STL,27,9,36,2013122915
2013,17,reg,CHI,GB,28,33,61,2013122901
2013,17,reg,ARI,SF,20,23,43,2013122912
2013,17,reg,OAK,DEN,14,34,48,2013122913
2013,17,reg,SD,KC,27,24,51,2013122914
2013,17,reg,DAL,PHI,22,24,46,2013122903
2013,18,post,IND,KC,45,44,89,2014010400
2013,18,post,PHI,NO,24,26,50,2014010401
2013,18,post,CIN,SD,10,27,37,2014010500
2013,18,post,GB,SF,20,23,43,2014010501
2013,18,post,SEA,NO,23,15,38,2014011100
2013,18,post,NE,IND,43,22,65,2014011101
2013,18,post,CAR,SF,10,23,33,2014011200
2013,18,post,DEN,SD,24,17,41,2014011201
2013,18,post,DEN,NE,26,16,42,2014011900
2013,18,post,SEA,SF,23,17,40,2014011901
2013,18,post,SAN,RIC,21,22,43,2014012600
2013,18,post,DEN,SEA,8,43,51,2014020200
2014,1,reg,SEA,GB,36,16,52,2014090400
2014,1,reg,ATL,NO,37,34,71,2014090700
2014,1,reg,STL,MIN,6,34,40,2014090709
2014,1,reg,PIT,CLE,30,27,57,2014090708
2014,1,reg,PHI,JAC,34,17,51,2014090707
2014,1,reg,NYJ,OAK,19,14,33,2014090706
2014,1,reg,BAL,CIN,16,23,39,2014090701
2014,1,reg,CHI,BUF,20,23,43,2014090702
2014,1,reg,HOU,WAS,17,6,23,2014090703
2014,1,reg,KC,TEN,10,26,36,2014090704
2014,1,reg,MIA,NE,33,20,53,2014090705
2014,1,reg,TB,CAR,14,20,34,2014090711
2014,1,reg,DAL,SF,17,28,45,2014090710
2014,1,reg,DEN,IND,31,24,55,2014090712
2014,1,reg,DET,NYG,35,14,49,2014090800
2014,1,reg,ARI,SD,18,17,35,2014090801
2014,2,reg,BAL,PIT,26,6,32,2014091100
2014,2,reg,BUF,MIA,29,10,39,2014091400
2014,2,reg,WAS,JAC,41,10,51,2014091407
2014,2,reg,TEN,DAL,10,26,36,2014091406
2014,2,reg,NYG,ARI,14,25,39,2014091405
2014,2,reg,MIN,NE,7,30,37,2014091404
2014,2,reg,CLE,NO,26,24,50,2014091403
2014,2,reg,CIN,ATL,24,10,34,2014091402
2014,2,reg,CAR,DET,24,7,31,2014091401
2014,2,reg,TB,STL,17,19,36,2014091409
2014,2,reg,SD,SEA,30,21,51,2014091408
2014,2,reg,OAK,HOU,14,30,44,2014091412
2014,2,reg,GB,NYJ,31,24,55,2014091411
2014,2,reg,DEN,KC,24,17,41,2014091410
2014,2,reg,SF,CHI,20,28,48,2014091413
2014,2,reg,IND,PHI,27,30,57,2014091500
2014,3,reg,ATL,TB,56,14,70,2014091800
2014,3,reg,BUF,SD,10,22,32,2014092100
2014,3,reg,STL,DAL,31,34,65,2014092109
2014,3,reg,PHI,WAS,37,34,71,2014092108
2014,3,reg,NYG,HOU,30,17,47,2014092107
2014,3,reg,NO,MIN,20,9,29,2014092106
2014,3,reg,CIN,TEN,33,7,40,2014092101
2014,3,reg,CLE,BAL,21,23,44,2014092102
2014,3,reg,DET,GB,19,7,26,2014092103
2014,3,reg,JAC,IND,17,44,61,2014092104
2014,3,reg,NE,OAK,16,9,25,2014092105
2014,3,reg,ARI,SF,23,14,37,2014092110
2014,3,reg,SEA,DEN,26,20,46,2014092112
2014,3,reg,MIA,KC,15,34,49,2014092111
2014,3,reg,CAR,PIT,19,37,56,2014092113
2014,3,reg,NYJ,CHI,19,27,46,2014092200
2014,4,reg,WAS,NYG,14,45,59,2014092500
2014,4,reg,CHI,GB,17,38,55,2014092801
2014,4,reg,HOU,BUF,23,17,40,2014092802
2014,4,reg,IND,TEN,41,17,58,2014092803
2014,4,reg,BAL,CAR,38,10,48,2014092800
2014,4,reg,NYJ,DET,17,24,41,2014092805
2014,4,reg,PIT,TB,24,27,51,2014092807
2014,4,reg,OAK,MIA,14,38,52,2014092806
2014,4,reg,SD,JAC,33,14,47,2014092808
2014,4,reg,SF,PHI,26,21,47,2014092809
2014,4,reg,MIN,ATL,41,28,69,2014092804
2014,4,reg,DAL,NO,38,17,55,2014092810
2014,4,reg,KC,NE,41,14,55,2014092900
2014,5,reg,GB,MIN,42,10,52,2014100200
2014,5,reg,CAR,CHI,31,24,55,2014100500
2014,5,reg,TEN,CLE,28,29,57,2014100508
2014,5,reg,PHI,STL,34,28,62,2014100507
2014,5,reg,NYG,ATL,30,20,50,2014100506
2014,5,reg,NO,TB,37,31,68,2014100505
2014,5,reg,DAL,HOU,20,17,37,2014100501
2014,5,reg,DET,BUF,14,17,31,2014100502
2014,5,reg,IND,BAL,20,13,33,2014100503
2014,5,reg,JAC,PIT,9,17,26,2014100504
2014,5,reg,DEN,ARI,41,20,61,2014100509
2014,5,reg,SF,KC,22,17,39,2014100511
2014,5,reg,SD,NYJ,31,0,31,2014100510
2014,5,reg,NE,CIN,43,17,60,2014100512
2014,5,reg,WAS,SEA,17,27,44,2014100600
2014,6,reg,HOU,IND,28,33,61,2014100900
2014,6,reg,CLE,PIT,31,10,41,2014101203
2014,6,reg,BUF,NE,22,37,59,2014101201
2014,6,reg,CIN,CAR,37,37,74,2014101202
2014,6,reg,TEN,JAC,16,14,30,2014101208
2014,6,reg,MIA,GB,24,27,51,2014101204
2014,6,reg,MIN,DET,3,17,20,2014101205
2014,6,reg,NYJ,DEN,17,31,48,2014101206
2014,6,reg,TB,BAL,17,48,65,2014101207
2014,6,reg,OAK,SD,28,31,59,2014101209
2014,6,reg,ATL,CHI,13,27,40,2014101200
2014,6,reg,SEA,DAL,23,30,53,2014101211
2014,6,reg,ARI,WAS,30,20,50,2014101210
2014,6,reg,PHI,NYG,27,0,27,2014101212
2014,6,reg,STL,SF,17,31,48,2014101300
2014,7,reg,NE,NYJ,27,25,52,2014101600
2014,7,reg,BAL,ATL,29,7,36,2014101900
2014,7,reg,WAS,TEN,19,17,36,2014101908
2014,7,reg,STL,SEA,28,26,54,2014101907
2014,7,reg,JAC,CLE,24,6,30,2014101906
2014,7,reg,IND,CIN,27,0,27,2014101905
2014,7,reg,BUF,MIN,17,16,33,2014101901
2014,7,reg,CHI,MIA,14,27,41,2014101902
2014,7,reg,DET,NO,24,23,47,2014101903
2014,7,reg,GB,CAR,38,17,55,2014101904
2014,7,reg,SD,KC,20,23,43,2014101909
2014,7,reg,OAK,ARI,13,24,37,2014101911
2014,7,reg,DAL,NYG,31,21,52,2014101910
2014,7,reg,DEN,SF,42,17,59,2014101912
2014,7,reg,PIT,HOU,30,23,53,2014102000
2014,8,reg,DEN,SD,35,21,56,2014102300
2014,8,reg,ATL,DET,21,22,43,2014102600
2014,8,reg,TB,MIN,13,19,32,2014102607
2014,8,reg,NYJ,BUF,23,43,66,2014102606
2014,8,reg,NE,CHI,51,23,74,2014102605
2014,8,reg,CAR,SEA,9,13,22,2014102601
2014,8,reg,JAC,MIA,13,27,40,2014102603
2014,8,reg,CIN,BAL,27,24,51,2014102602
2014,8,reg,TEN,HOU,16,30,46,2014102608
2014,8,reg,KC,STL,34,7,41,2014102604
2014,8,reg,ARI,PHI,24,20,44,2014102609
2014,8,reg,PIT,IND,51,34,85,2014102611
2014,8,reg,CLE,OAK,23,13,36,2014102610
2014,8,reg,NO,GB,44,23,67,2014102612
2014,8,reg,DAL,WAS,17,20,37,2014102700
2014,9,reg,CAR,NO,10,28,38,2014103000
2014,9,reg,CLE,TB,22,17,39,2014110201
2014,9,reg,DAL,ARI,17,28,45,2014110202
2014,9,reg,HOU,PHI,21,31,52,2014110203
2014,9,reg,KC,NYJ,24,10,34,2014110204
2014,9,reg,CIN,JAC,33,23,56,2014110200
2014,9,reg,MIA,SD,37,0,37,2014110205
2014,9,reg,MIN,WAS,29,26,55,2014110206
2014,9,reg,SF,STL,10,13,23,2014110207
2014,9,reg,NE,DEN,43,21,64,2014110208
2014,9,reg,SEA,OAK,30,24,54,2014110209
2014,9,reg,PIT,BAL,43,23,66,2014110210
2014,9,reg,NYG,IND,24,40,64,2014110300
2014,10,reg,CIN,CLE,3,24,27,2014110600
2014,10,reg,BUF,KC,13,17,30,2014110901
2014,10,reg,DET,MIA,20,16,36,2014110902
2014,10,reg,JAC,DAL,17,31,48,2014110903
2014,10,reg,NO,SF,24,27,51,2014110904
2014,10,reg,BAL,TEN,21,7,28,2014110900
2014,10,reg,NYJ,PIT,20,13,33,2014110905
2014,10,reg,TB,ATL,17,27,44,2014110906
2014,10,reg,OAK,DEN,17,41,58,2014110907
2014,10,reg,ARI,STL,31,14,45,2014110908
2014,10,reg,SEA,NYG,38,17,55,2014110909
2014,10,reg,GB,CHI,55,14,69,2014110910
2014,10,reg,PHI,CAR,45,21,66,2014111000
2014,11,reg,MIA,BUF,22,9,31,2014111300
2014,11,reg,CHI,MIN,21,13,34,2014111601
2014,11,reg,CLE,HOU,7,23,30,2014111602
2014,11,reg,CAR,ATL,17,19,36,2014111600
2014,11,reg,NO,CIN,10,27,37,2014111605
2014,11,reg,WAS,TB,7,27,34,2014111608
2014,11,reg,STL,DEN,22,7,29,2014111607
2014,11,reg,NYG,SF,10,16,26,2014111606
2014,11,reg,KC,SEA,24,20,44,2014111604
2014,11,reg,SD,OAK,13,6,19,2014111609
2014,11,reg,ARI,DET,14,6,20,2014111610
2014,11,reg,GB,PHI,53,20,73,2014111603
2014,11,reg,IND,NE,20,42,62,2014111611
2014,11,reg,TEN,PIT,24,27,51,2014111700
2014,12,reg,OAK,KC,24,20,44,2014112000
2014,12,reg,ATL,CLE,24,26,50,2014112300
2014,12,reg,PHI,TEN,43,24,67,2014112307
2014,12,reg,NE,DET,34,9,43,2014112306
2014,12,reg,MIN,GB,21,24,45,2014112305
2014,12,reg,IND,JAC,23,3,26,2014112304
2014,12,reg,HOU,CIN,13,22,35,2014112303
2014,12,reg,CHI,TB,21,13,34,2014112302
2014,12,reg,SEA,ARI,19,3,22,2014112309
2014,12,reg,SD,STL,27,24,51,2014112308
2014,12,reg,SF,WAS,17,13,30,2014112311
2014,12,reg,DEN,MIA,39,36,75,2014112310
2014,12,reg,NYG,DAL,28,31,59,2014112312
2014,12,reg,BUF,NYJ,38,3,41,2014112301
2014,12,reg,NO,BAL,27,34,61,2014112400
2014,13,reg,DET,CHI,34,17,51,2014112700
2014,13,reg,DAL,PHI,10,33,43,2014112701
2014,13,reg,SF,SEA,3,19,22,2014112702
2014,13,reg,IND,WAS,49,27,76,2014113003
2014,13,reg,HOU,TEN,45,21,66,2014113002
2014,13,reg,BUF,CLE,26,10,36,2014113001
2014,13,reg,BAL,SD,33,34,67,2014113000
2014,13,reg,JAC,NYG,25,24,49,2014113004
2014,13,reg,TB,CIN,13,14,27,2014113008
2014,13,reg,STL,OAK,52,0,52,2014113007
2014,13,reg,PIT,NO,32,35,67,2014113006
2014,13,reg,MIN,CAR,31,13,44,2014113005
2014,13,reg,ATL,ARI,29,18,47,2014113009
2014,13,reg,GB,NE,26,21,47,2014113010
2014,13,reg,KC,DEN,16,29,45,2014113011
2014,13,reg,NYJ,MIA,13,16,29,2014120100
2014,14,reg,CHI,DAL,28,41,69,2014120400
2014,14,reg,CIN,PIT,21,42,63,2014120700
2014,14,reg,WAS,STL,0,24,24,2014120708
2014,14,reg,TEN,NYG,7,36,43,2014120707
2014,14,reg,NO,CAR,10,41,51,2014120706
2014,14,reg,MIN,NYJ,30,24,54,2014120705
2014,14,reg,MIA,BAL,13,28,41,2014120704
2014,14,reg,CLE,IND,24,25,49,2014120701
2014,14,reg,DET,TB,34,17,51,2014120702
2014,14,reg,JAC,HOU,13,27,40,2014120703
2014,14,reg,DEN,BUF,24,17,41,2014120710
2014,14,reg,ARI,KC,17,14,31,2014120709
2014,14,reg,PHI,SEA,14,24,38,2014120712
2014,14,reg,OAK,SF,24,13,37,2014120711
2014,14,reg,SD,NE,14,23,37,2014120713
2014,14,reg,GB,ATL,43,37,80,2014120800
2014,15,reg,STL,ARI,6,12,18,2014121100
2014,15,reg,ATL,PIT,20,27,47,2014121400
2014,15,reg,NYG,WAS,24,13,37,2014121409
2014,15,reg,NE,MIA,41,13,54,2014121408
2014,15,reg,KC,OAK,31,13,44,2014121407
2014,15,reg,IND,HOU,17,10,27,2014121406
2014,15,reg,CLE,CIN,0,30,30,2014121404
2014,15,reg,BAL,JAC,20,12,32,2014121401
2014,15,reg,BUF,GB,21,13,34,2014121402
2014,15,reg,CAR,TB,19,17,36,2014121403
2014,15,reg,TEN,NYJ,11,16,27,2014121411
2014,15,reg,SD,DEN,10,22,32,2014121410
2014,15,reg,DET,MIN,16,14,30,2014121405
2014,15,reg,SEA,SF,17,7,24,2014121412
2014,15,reg,PHI,DAL,27,38,65,2014121413
2014,15,reg,CHI,NO,15,31,46,2014121500
2014,16,reg,JAC,TEN,21,13,34,2014121800
2014,16,reg,WAS,PHI,27,24,51,2014122000
2014,16,reg,SF,SD,35,38,73,2014122001
2014,16,reg,MIA,MIN,37,35,72,2014122103
2014,16,reg,HOU,BAL,25,13,38,2014122102
2014,16,reg,CHI,DET,14,20,34,2014122101
2014,16,reg,CAR,CLE,17,13,30,2014122100
2014,16,reg,NO,ATL,14,30,44,2014122104
2014,16,reg,TB,GB,3,20,23,2014122107
2014,16,reg,PIT,KC,20,12,32,2014122106
2014,16,reg,NYJ,NE,16,17,33,2014122105
2014,16,reg,STL,NYG,27,37,64,2014122108
2014,16,reg,OAK,BUF,26,24,50,2014122110
2014,16,reg,DAL,IND,42,7,49,2014122109
2014,16,reg,ARI,SEA,6,35,41,2014122111
2014,16,reg,CIN,DEN,37,28,65,2014122200
2014,17,reg,BAL,CLE,20,10,30,2014122801
2014,17,reg,WAS,DAL,17,44,61,2014122812
2014,17,reg,TEN,IND,10,27,37,2014122811
2014,17,reg,TB,NO,20,23,43,2014122810
2014,17,reg,NYG,PHI,26,34,60,2014122808
2014,17,reg,NE,BUF,9,17,26,2014122807
2014,17,reg,HOU,JAC,23,17,40,2014122803
2014,17,reg,KC,SD,19,7,26,2014122804
2014,17,reg,MIA,NYJ,24,37,61,2014122805
2014,17,reg,MIN,CHI,13,9,22,2014122806
2014,17,reg,DEN,OAK,47,14,61,2014122813
2014,17,reg,SF,ARI,20,17,37,2014122814
2014,17,reg,GB,DET,30,20,50,2014122802
2014,17,reg,SEA,STL,20,6,26,2014122815
2014,17,reg,ATL,CAR,3,34,37,2014122800
2014,17,reg,PIT,CIN,27,17,44,2014122809
2014,18,post,CAR,ARI,27,16,43,2015010300
2014,18,post,PIT,BAL,17,30,47,2015010301
2014,18,post,IND,CIN,26,10,36,2015010400
2014,18,post,DAL,DET,24,20,44,2015010401
2014,18,post,NE,BAL,35,31,66,2015011000
2014,18,post,SEA,CAR,31,17,48,2015011001
2014,18,post,GB,DAL,26,21,47,2015011100
2014,18,post,DEN,IND,13,24,37,2015011101
2014,18,post,SEA,GB,28,22,50,2015011800
2014,18,post,NE,IND,45,7,52,2015011801
2014,18,post,CRT,IRV,28,32,60,2015012500
2014,18,post,SEA,NE,24,28,52,2015020100
2015,1,reg,NE,PIT,28,21,49,2015091000
2015,1,reg,CHI,GB,23,31,54,2015091300
2015,1,reg,HOU,KC,20,27,47,2015091306
2015,1,reg,NYJ,CLE,31,10,41,2015091305
2015,1,reg,BUF,IND,27,14,41,2015091304
2015,1,reg,WAS,MIA,10,17,27,2015091303
2015,1,reg,JAC,CAR,9,20,29,2015091302
2015,1,reg,STL,SEA,34,31,65,2015091301
2015,1,reg,ARI,NO,31,19,50,2015091307
2015,1,reg,SD,DET,33,28,61,2015091308
2015,1,reg,TB,TEN,14,42,56,2015091311
2015,1,reg,OAK,CIN,13,33,46,2015091310
2015,1,reg,DEN,BAL,19,13,32,2015091309
2015,1,reg,DAL,NYG,27,26,53,2015091312
2015,1,reg,ATL,PHI,26,24,50,2015091400
2015,1,reg,SF,MIN,20,3,23,2015091401
2015,2,reg,KC,DEN,24,31,55,2015091700
2015,2,reg,CAR,HOU,24,17,41,2015092000
2015,2,reg,PIT,SF,43,18,61,2015092009
2015,2,reg,NO,TB,19,26,45,2015092008
2015,2,reg,MIN,DET,26,16,42,2015092007
2015,2,reg,CHI,ARI,23,48,71,2015092006
2015,2,reg,BUF,NE,32,40,72,2015092001
2015,2,reg,CIN,SD,24,19,43,2015092002
2015,2,reg,CLE,TEN,28,14,42,2015092003
2015,2,reg,NYG,ATL,20,24,44,2015092004
2015,2,reg,WAS,STL,24,10,34,2015092005
2015,2,reg,JAC,MIA,23,20,43,2015092011
2015,2,reg,OAK,BAL,37,33,70,2015092010
2015,2,reg,PHI,DAL,10,20,30,2015092012
2015,2,reg,GB,SEA,27,17,44,2015092013
2015,2,reg,IND,NYJ,7,20,27,2015092100
2015,3,reg,NYG,WAS,32,21,53,2015092400
2015,3,reg,DAL,ATL,28,39,67,2015092700
2015,3,reg,TEN,IND,33,35,68,2015092709
2015,3,reg,CLE,OAK,20,27,47,2015092708
2015,3,reg,BAL,CIN,24,28,52,2015092707
2015,3,reg,NE,JAC,51,17,68,2015092706
2015,3,reg,CAR,NO,27,22,49,2015092701
2015,3,reg,NYJ,PHI,17,24,41,2015092702
2015,3,reg,HOU,TB,19,9,28,2015092703
2015,3,reg,MIN,SD,31,14,45,2015092704
2015,3,reg,STL,PIT,6,12,18,2015092705
2015,3,reg,ARI,SF,47,7,54,2015092710
2015,3,reg,MIA,BUF,14,41,55,2015092712
2015,3,reg,SEA,CHI,26,0,26,2015092711
2015,3,reg,DET,DEN,12,24,36,2015092713
2015,3,reg,GB,KC,38,28,66,2015092800
2015,4,reg,PIT,BAL,20,23,43,2015100100
2015,4,reg,MIA,NYJ,14,27,41,2015100400
2015,4,reg,IND,JAC,16,13,29,2015100404
2015,4,reg,BUF,NYG,10,24,34,2015100407
2015,4,reg,TB,CAR,23,37,60,2015100406
2015,4,reg,WAS,PHI,23,20,43,2015100405
2015,4,reg,CHI,OAK,22,20,42,2015100401
2015,4,reg,ATL,HOU,48,21,69,2015100402
2015,4,reg,CIN,KC,36,21,57,2015100403
2015,4,reg,SD,CLE,30,27,57,2015100408
2015,4,reg,SF,GB,3,17,20,2015100409
2015,4,reg,ARI,STL,22,24,46,2015100410
2015,4,reg,DEN,MIN,23,20,43,2015100411
2015,4,reg,NO,DAL,26,20,46,2015100412
2015,4,reg,SEA,DET,13,10,23,2015100500
2015,5,reg,HOU,IND,20,27,47,2015100800
2015,5,reg,KC,CHI,17,18,35,2015101101
2015,5,reg,CIN,SEA,27,24,51,2015101102
2015,5,reg,ATL,WAS,25,19,44,2015101103
2015,5,reg,TB,JAC,38,31,69,2015101104
2015,5,reg,PHI,NO,39,17,56,2015101100
2015,5,reg,BAL,CLE,30,33,63,2015101105
2015,5,reg,GB,STL,24,10,34,2015101107
2015,5,reg,TEN,BUF,13,14,27,2015101106
2015,5,reg,DET,ARI,17,42,59,2015101108
2015,5,reg,DAL,NE,6,30,36,2015101109
2015,5,reg,OAK,DEN,10,16,26,2015101110
2015,5,reg,NYG,SF,30,27,57,2015101111
2015,5,reg,SD,PIT,20,24,44,2015101200
2015,6,reg,NO,ATL,31,21,52,2015101500
2015,6,reg,NYJ,WAS,34,20,54,2015101801
2015,6,reg,PIT,ARI,25,13,38,2015101802
2015,6,reg,MIN,KC,16,10,26,2015101803
2015,6,reg,BUF,CIN,21,34,55,2015101804
2015,6,reg,DET,CHI,37,34,71,2015101800
2015,6,reg,CLE,DEN,23,26,49,2015101805
2015,6,reg,JAC,HOU,20,31,51,2015101807
2015,6,reg,TEN,MIA,10,38,48,2015101806
2015,6,reg,SEA,CAR,23,27,50,2015101808
2015,6,reg,GB,SD,27,20,47,2015101809
2015,6,reg,SF,BAL,25,20,45,2015101810
2015,6,reg,IND,NE,27,34,61,2015101811
2015,6,reg,PHI,NYG,27,7,34,2015101900
2015,7,reg,SF,SEA,3,20,23,2015102200
2015,7,reg,JAC,BUF,34,31,65,2015102500
2015,7,reg,WAS,TB,31,30,61,2015102505
2015,7,reg,TEN,ATL,7,10,17,2015102508
2015,7,reg,IND,NO,21,27,48,2015102507
2015,7,reg,DET,MIN,19,28,47,2015102506
2015,7,reg,KC,PIT,23,13,36,2015102504
2015,7,reg,STL,CLE,24,6,30,2015102501
2015,7,reg,MIA,HOU,44,26,70,2015102502
2015,7,reg,NE,NYJ,30,23,53,2015102503
2015,7,reg,SD,OAK,29,37,66,2015102509
2015,7,reg,NYG,DAL,27,20,47,2015102510
2015,7,reg,CAR,PHI,27,16,43,2015102511
2015,7,reg,ARI,BAL,26,18,44,2015102600
2015,8,reg,NE,MIA,36,7,43,2015102900
2015,8,reg,KC,DET,45,10,55,2015110100
2015,8,reg,ATL,TB,20,23,43,2015110105
2015,8,reg,CLE,ARI,20,34,54,2015110108
2015,8,reg,STL,SF,27,6,33,2015110107
2015,8,reg,NO,NYG,52,49,101,2015110106
2015,8,reg,CHI,MIN,20,23,43,2015110104
2015,8,reg,BAL,SD,29,26,55,2015110101
2015,8,reg,PIT,CIN,10,16,26,2015110102
2015,8,reg,HOU,TEN,20,6,26,2015110103
2015,8,reg,OAK,NYJ,34,20,54,2015110109
2015,8,reg,DAL,SEA,12,13,25,2015110110
2015,8,reg,DEN,GB,29,10,39,2015110111
2015,8,reg,CAR,IND,29,26,55,2015110200
2015,9,reg,CIN,CLE,31,10,41,2015110500
2015,9,reg,CAR,GB,37,29,66,2015110801
2015,9,reg,NE,WAS,27,10,37,2015110802
2015,9,reg,NO,TEN,28,34,62,2015110803
2015,9,reg,BUF,MIA,33,17,50,2015110804
2015,9,reg,MIN,STL,21,18,39,2015110800
2015,9,reg,NYJ,JAC,28,23,51,2015110805
2015,9,reg,PIT,OAK,38,35,73,2015110806
2015,9,reg,TB,NYG,18,32,50,2015110807
2015,9,reg,SF,ATL,17,16,33,2015110808
2015,9,reg,IND,DEN,27,24,51,2015110809
2015,9,reg,DAL,PHI,27,33,60,2015110810
2015,9,reg,SD,CHI,19,22,41,2015110900
2015,10,reg,NYJ,BUF,17,22,39,2015111200
2015,10,reg,GB,DET,16,18,34,2015111501
2015,10,reg,TB,DAL,10,6,16,2015111502
2015,10,reg,TEN,CAR,10,27,37,2015111503
2015,10,reg,STL,CHI,13,37,50,2015111504
2015,10,reg,WAS,NO,47,14,61,2015111500
2015,10,reg,PHI,MIA,19,20,39,2015111505
2015,10,reg,PIT,CLE,30,9,39,2015111507
2015,10,reg,BAL,JAC,20,22,42,2015111506
2015,10,reg,OAK,MIN,14,30,44,2015111508
2015,10,reg,NYG,NE,26,27,53,2015111509
2015,10,reg,DEN,KC,13,29,42,2015111510
2015,10,reg,SEA,ARI,32,39,71,2015111511
2015,10,reg,CIN,HOU,6,10,16,2015111600
2015,11,reg,JAC,TEN,19,13,32,2015111900
2015,11,reg,DET,OAK,18,13,31,2015112201
2015,11,reg,ATL,IND,21,24,45,2015112202
2015,11,reg,BAL,STL,16,13,29,2015112208
2015,11,reg,PHI,TB,17,45,62,2015112204
2015,11,reg,CHI,DEN,15,17,32,2015112200
2015,11,reg,HOU,NYJ,24,17,41,2015112203
2015,11,reg,CAR,WAS,44,16,60,2015112206
2015,11,reg,MIA,DAL,14,24,38,2015112207
2015,11,reg,SD,KC,3,33,36,2015112211
2015,11,reg,MIN,GB,13,30,43,2015112205
2015,11,reg,SEA,SF,29,13,42,2015112210
2015,11,reg,ARI,CIN,34,31,65,2015112209
2015,11,reg,NE,BUF,20,13,33,2015112300
2015,12,reg,DET,PHI,45,14,59,2015112600
2015,12,reg,DAL,CAR,14,33,47,2015112601
2015,12,reg,GB,CHI,13,17,30,2015112602
2015,12,reg,HOU,NO,24,6,30,2015112903
2015,12,reg,CIN,STL,31,7,38,2015112902
2015,12,reg,ATL,MIN,10,20,30,2015112901
2015,12,reg,WAS,NYG,20,14,34,2015112900
2015,12,reg,IND,TB,25,12,37,2015112904
2015,12,reg,KC,BUF,30,22,52,2015112908
2015,12,reg,TEN,OAK,21,24,45,2015112907
2015,12,reg,JAC,SD,25,31,56,2015112906
2015,12,reg,NYJ,MIA,38,20,58,2015112905
2015,12,reg,SF,ARI,13,19,32,2015112909
2015,12,reg,SEA,PIT,39,30,69,2015112910
2015,12,reg,DEN,NE,30,24,54,2015112911
2015,12,reg,CLE,BAL,27,33,60,2015113000
2015,13,reg,DET,GB,23,27,50,2015120300
2015,13,reg,NYG,NYJ,20,23,43,2015120600
2015,13,reg,STL,ARI,3,27,30,2015120609
2015,13,reg,TB,ATL,23,19,42,2015120608
2015,13,reg,MIN,SEA,7,38,45,2015120606
2015,13,reg,CHI,SF,20,26,46,2015120605
2015,13,reg,TEN,JAC,42,39,81,2015120604
2015,13,reg,BUF,HOU,30,21,51,2015120601
2015,13,reg,MIA,BAL,15,13,28,2015120602
2015,13,reg,CLE,CIN,3,37,40,2015120603
2015,13,reg,OAK,KC,20,34,54,2015120610
2015,13,reg,SD,DEN,3,17,20,2015120611
2015,13,reg,NE,PHI,28,35,63,2015120612
2015,13,reg,NO,CAR,38,41,79,2015120607
2015,13,reg,PIT,IND,45,10,55,2015120613
2015,13,reg,WAS,DAL,16,19,35,2015120700
2015,14,reg,ARI,MIN,23,20,43,2015121000
2015,14,reg,PHI,BUF,23,20,43,2015121300
2015,14,reg,BAL,SEA,6,35,41,2015121313
2015,14,reg,CLE,SF,24,10,34,2015121310
2015,14,reg,STL,DET,21,14,35,2015121309
2015,14,reg,NYJ,TEN,30,8,38,2015121301
2015,14,reg,CIN,PIT,20,33,53,2015121302
2015,14,reg,JAC,IND,51,16,67,2015121304
2015,14,reg,KC,SD,10,3,13,2015121305
2015,14,reg,CHI,WAS,21,24,45,2015121306
2015,14,reg,CAR,ATL,38,0,38,2015121307
2015,14,reg,TB,NO,17,24,41,2015121308
2015,14,reg,DEN,OAK,12,15,27,2015121311
2015,14,reg,GB,DAL,28,7,35,2015121312
2015,14,reg,HOU,NE,6,27,33,2015121303
2015,14,reg,MIA,NYG,24,31,55,2015121400
2015,15,reg,STL,TB,31,23,54,2015121700
2015,15,reg,DAL,NYJ,16,19,35,2015121900
2015,15,reg,NYG,CAR,35,38,73,2015122000
2015,15,reg,NE,TEN,33,16,49,2015122005
2015,15,reg,WAS,BUF,35,25,60,2015122007
2015,15,reg,BAL,KC,14,34,48,2015122006
2015,15,reg,IND,HOU,10,16,26,2015122004
2015,15,reg,JAC,ATL,17,23,40,2015122003
2015,15,reg,MIN,CHI,38,17,55,2015122002
2015,15,reg,OAK,GB,20,30,50,2015122009
2015,15,reg,SEA,CLE,30,13,43,2015122008
2015,15,reg,SF,CIN,14,24,38,2015122012
2015,15,reg,SD,MIA,30,14,44,2015122011
2015,15,reg,PIT,DEN,34,27,61,2015122010
2015,15,reg,PHI,ARI,17,40,57,2015122001
2015,15,reg,NO,DET,27,35,62,2015122100
2015,16,reg,OAK,SD,23,20,43,2015122400
2015,16,reg,PHI,WAS,24,38,62,2015122600
2015,16,reg,DET,SF,32,17,49,2015122705
2015,16,reg,BAL,PIT,20,17,37,2015122712
2015,16,reg,BUF,DAL,16,6,22,2015122709
2015,16,reg,TB,CHI,21,26,47,2015122708
2015,16,reg,ATL,CAR,20,13,33,2015122707
2015,16,reg,MIA,IND,12,18,30,2015122701
2015,16,reg,NYJ,NE,26,20,46,2015122702
2015,16,reg,TEN,HOU,6,34,40,2015122703
2015,16,reg,KC,CLE,17,13,30,2015122704
2015,16,reg,NO,JAC,38,27,65,2015122700
2015,16,reg,ARI,GB,38,8,46,2015122710
2015,16,reg,SEA,STL,17,23,40,2015122711
2015,16,reg,MIN,NYG,49,17,66,2015122706
2015,16,reg,DEN,CIN,20,17,37,2015122800
2015,17,reg,BUF,NYJ,22,17,39,2016010300
2015,17,reg,MIA,NE,20,10,30,2016010301
2015,17,reg,ATL,NO,17,20,37,2016010311
2015,17,reg,CHI,DET,20,24,44,2016010309
2015,17,reg,NYG,PHI,30,35,65,2016010308
2015,17,reg,DAL,WAS,23,34,57,2016010307
2015,17,reg,IND,TEN,30,24,54,2016010305
2015,17,reg,CIN,BAL,24,16,40,2016010302
2015,17,reg,CLE,PIT,12,28,40,2016010303
2015,17,reg,HOU,JAC,30,6,36,2016010304
2015,17,reg,KC,OAK,23,17,40,2016010306
2015,17,reg,DEN,SD,27,20,47,2016010313
2015,17,reg,CAR,TB,38,10,48,2016010312
2015,17,reg,ARI,SEA,6,36,42,2016010314
2015,17,reg,SF,STL,19,16,35,2016010315
2015,17,reg,GB,MIN,13,20,33,2016010310
2015,18,post,HOU,KC,0,30,30,2016010900
2015,18,post,CIN,PIT,16,18,34,2016010901
2015,18,post,MIN,SEA,9,10,19,2016011000
2015,18,post,WAS,GB,18,35,53,2016011001
2015,18,post,NE,KC,27,20,47,2016011600
2015,18,post,ARI,GB,26,20,46,2016011601
2015,18,post,CAR,SEA,31,24,55,2016011700
2015,18,post,DEN,PIT,23,16,39,2016011701
2015,18,post,DEN,NE,20,18,38,2016012400
2015,18,post,CAR,ARI,49,15,64,2016012401
2015,18,post,RIC,IRV,27,49,76,2016013100
2015,18,post,DEN,CAR,24,10,34,2016020700
2016,1,reg,DEN,CAR,21,20,41,2016090800
2016,1,reg,ATL,TB,24,31,55,2016091100
2016,1,reg,TEN,MIN,16,25,41,2016091108
2016,1,reg,PHI,CLE,29,10,39,2016091107
2016,1,reg,NYJ,CIN,22,23,45,2016091106
2016,1,reg,NO,OAK,34,35,69,2016091105
2016,1,reg,KC,SD,33,27,60,2016091104
2016,1,reg,BAL,BUF,13,7,20,2016091101
2016,1,reg,HOU,CHI,23,14,37,2016091102
2016,1,reg,JAX,GB,23,27,50,2016091103
2016,1,reg,SEA,MIA,12,10,22,2016091109
2016,1,reg,DAL,NYG,19,20,39,2016091110
2016,1,reg,IND,DET,35,39,74,2016091111
2016,1,reg,ARI,NE,21,23,44,2016091112
2016,1,reg,WAS,PIT,16,38,54,2016091200
2016,1,reg,SF,LA,28,0,28,2016091201
2016,2,reg,BUF,NYJ,31,37,68,2016091500
2016,2,reg,CAR,SF,46,27,73,2016091800
2016,2,reg,WAS,DAL,23,27,50,2016091807
2016,2,reg,PIT,CIN,24,16,40,2016091806
2016,2,reg,NYG,NO,16,13,29,2016091805
2016,2,reg,NE,MIA,31,24,55,2016091804
2016,2,reg,HOU,KC,19,12,31,2016091803
2016,2,reg,DET,TEN,15,16,31,2016091802
2016,2,reg,CLE,BAL,20,25,45,2016091801
2016,2,reg,LA,SEA,9,3,12,2016091809
2016,2,reg,ARI,TB,40,7,47,2016091808
2016,2,reg,SD,JAX,38,14,52,2016091812
2016,2,reg,OAK,ATL,28,35,63,2016091811
2016,2,reg,DEN,IND,34,20,54,2016091810
2016,2,reg,MIN,GB,17,14,31,2016091813
2016,2,reg,CHI,PHI,14,29,43,2016091900
2016,3,reg,NE,HOU,27,0,27,2016092200
2016,3,reg,BUF,ARI,33,18,51,2016092500
2016,3,reg,TEN,OAK,10,17,27,2016092507
2016,3,reg,NYG,WAS,27,29,56,2016092506
2016,3,reg,MIA,CLE,30,24,54,2016092505
2016,3,reg,JAX,BAL,17,19,36,2016092504
2016,3,reg,GB,DET,34,27,61,2016092503
2016,3,reg,CIN,DEN,17,29,46,2016092502
2016,3,reg,CAR,MIN,10,22,32,2016092501
2016,3,reg,TB,LA,32,37,69,2016092509
2016,3,reg,SEA,SF,37,18,55,2016092508
2016,3,reg,KC,NYJ,24,3,27,2016092512
2016,3,reg,IND,SD,26,22,48,2016092511
2016,3,reg,PHI,PIT,34,3,37,2016092510
2016,3,reg,DAL,CHI,31,17,48,2016092513
2016,3,reg,NO,ATL,32,45,77,2016092600
2016,4,reg,CIN,MIA,22,7,29,2016092900
2016,4,reg,JAX,IND,30,27,57,2016100200
2016,4,reg,HOU,TEN,27,20,47,2016100204
2016,4,reg,WAS,CLE,31,20,51,2016100207
2016,4,reg,NYJ,SEA,17,27,44,2016100206
2016,4,reg,NE,BUF,0,16,16,2016100205
2016,4,reg,ATL,CAR,48,33,81,2016100201
2016,4,reg,BAL,OAK,27,28,55,2016100202
2016,4,reg,CHI,DET,17,14,31,2016100203
2016,4,reg,TB,DEN,7,27,34,2016100208
2016,4,reg,ARI,LA,13,17,30,2016100209
2016,4,reg,SD,NO,34,35,69,2016100210
2016,4,reg,SF,DAL,17,24,41,2016100211
2016,4,reg,PIT,KC,43,14,57,2016100212
2016,4,reg,MIN,NYG,24,10,34,2016100300
2016,5,reg,SF,ARI,21,33,54,2016100600
2016,5,reg,CLE,NE,13,33,46,2016100901
2016,5,reg,DET,PHI,24,23,47,2016100902
2016,5,reg,IND,CHI,29,23,52,2016100903
2016,5,reg,MIA,TEN,17,30,47,2016100904
2016,5,reg,BAL,WAS,10,16,26,2016100900
2016,5,reg,MIN,HOU,31,13,44,2016100905
2016,5,reg,PIT,NYJ,31,13,44,2016100906
2016,5,reg,DEN,ATL,16,23,39,2016100907
2016,5,reg,DAL,CIN,28,14,42,2016100908
2016,5,reg,LA,BUF,19,30,49,2016100909
2016,5,reg,OAK,SD,34,31,65,2016100910
2016,5,reg,GB,NYG,23,16,39,2016100911
2016,5,reg,CAR,TB,14,17,31,2016101000
2016,6,reg,SD,DEN,21,13,34,2016101300
2016,6,reg,BUF,SF,45,16,61,2016101600
2016,6,reg,WAS,PHI,27,20,47,2016101608
2016,6,reg,TEN,CLE,28,26,54,2016101607
2016,6,reg,NYG,BAL,27,23,50,2016101606
2016,6,reg,NO,CAR,41,38,79,2016101605
2016,6,reg,CHI,JAX,16,17,33,2016101601
2016,6,reg,DET,LA,31,28,59,2016101602
2016,6,reg,MIA,PIT,30,15,45,2016101603
2016,6,reg,NE,CIN,35,17,52,2016101604
2016,6,reg,OAK,KC,10,26,36,2016101609
2016,6,reg,SEA,ATL,26,24,50,2016101611
2016,6,reg,GB,DAL,16,30,46,2016101610
2016,6,reg,HOU,IND,26,23,49,2016101612
2016,6,reg,ARI,NYJ,28,3,31,2016101700
2016,7,reg,GB,CHI,26,10,36,2016102000
2016,7,reg,LA,NYG,10,17,27,2016102300
2016,7,reg,KC,NO,27,21,48,2016102304
2016,7,reg,TEN,IND,26,34,60,2016102308
2016,7,reg,PHI,MIN,21,10,31,2016102307
2016,7,reg,CIN,CLE,31,17,48,2016102301
2016,7,reg,DET,WAS,20,17,37,2016102302
2016,7,reg,JAX,OAK,16,33,49,2016102303
2016,7,reg,MIA,BUF,28,25,53,2016102305
2016,7,reg,NYJ,BAL,24,16,40,2016102306
2016,7,reg,SF,TB,17,34,51,2016102310
2016,7,reg,ATL,SD,30,33,63,2016102309
2016,7,reg,PIT,NE,16,27,43,2016102311
2016,7,reg,ARI,SEA,6,6,12,2016102312
2016,7,reg,DEN,HOU,27,9,36,2016102400
2016,8,reg,TEN,JAX,36,22,58,2016102700
2016,8,reg,CIN,WAS,27,27,54,2016103000
2016,8,reg,IND,KC,14,30,44,2016103005
2016,8,reg,CAR,ARI,30,20,50,2016103009
2016,8,reg,TB,OAK,24,30,54,2016103007
2016,8,reg,NO,SEA,25,20,45,2016103006
2016,8,reg,HOU,DET,20,13,33,2016103004
2016,8,reg,BUF,NE,25,41,66,2016103002
2016,8,reg,CLE,NYJ,28,31,59,2016103003
2016,8,reg,DEN,SD,27,19,46,2016103008
2016,8,reg,ATL,GB,33,32,65,2016103001
2016,8,reg,DAL,PHI,29,23,52,2016103010
2016,8,reg,CHI,MIN,20,10,30,2016103100
2016,9,reg,TB,ATL,28,43,71,2016110300
2016,9,reg,MIN,DET,16,22,38,2016110605
2016,9,reg,NYG,PHI,28,23,51,2016110606
2016,9,reg,MIA,NYJ,27,23,50,2016110604
2016,9,reg,KC,JAX,19,14,33,2016110603
2016,9,reg,CLE,DAL,10,35,45,2016110602
2016,9,reg,BAL,PIT,21,14,35,2016110601
2016,9,reg,SF,NO,23,41,64,2016110608
2016,9,reg,LA,CAR,10,13,23,2016110607
2016,9,reg,GB,IND,26,31,57,2016110609
2016,9,reg,SD,TEN,43,35,78,2016110610
2016,9,reg,OAK,DEN,30,20,50,2016110600
2016,9,reg,SEA,BUF,31,25,56,2016110700
2016,10,reg,BAL,CLE,28,7,35,2016111000
2016,10,reg,JAX,HOU,21,24,45,2016111302
2016,10,reg,NO,DEN,23,25,48,2016111303
2016,10,reg,NYJ,LA,6,9,15,2016111304
2016,10,reg,PHI,ATL,24,15,39,2016111305
2016,10,reg,CAR,KC,17,20,37,2016111301
2016,10,reg,TB,CHI,36,10,46,2016111306
2016,10,reg,WAS,MIN,26,20,46,2016111308
2016,10,reg,TEN,GB,47,25,72,2016111307
2016,10,reg,SD,MIA,24,31,55,2016111309
2016,10,reg,ARI,SF,23,20,43,2016111310
2016,10,reg,PIT,DAL,30,35,65,2016111311
2016,10,reg,NE,SEA,24,31,55,2016111312
2016,10,reg,NYG,CIN,21,20,41,2016111400
2016,11,reg,CAR,NO,23,20,43,2016111700
2016,11,reg,CLE,PIT,9,24,33,2016112001
2016,11,reg,DAL,BAL,27,17,44,2016112002
2016,11,reg,DET,JAX,26,19,45,2016112003
2016,11,reg,IND,TEN,24,17,41,2016112004
2016,11,reg,CIN,BUF,12,16,28,2016112000
2016,11,reg,KC,TB,17,19,36,2016112005
2016,11,reg,NYG,CHI,22,16,38,2016112007
2016,11,reg,MIN,ARI,30,24,54,2016112006
2016,11,reg,LA,MIA,10,14,24,2016112008
2016,11,reg,SF,NE,17,30,47,2016112009
2016,11,reg,SEA,PHI,26,15,41,2016112010
2016,11,reg,WAS,GB,42,24,66,2016112011
2016,11,reg,OAK,HOU,27,20,47,2016112100
2016,12,reg,DET,MIN,16,13,29,2016112400
2016,12,reg,DAL,WAS,31,26,57,2016112401
2016,12,reg,IND,PIT,7,28,35,2016112402
2016,12,reg,CHI,TEN,21,27,48,2016112703
2016,12,reg,BUF,JAX,28,21,49,2016112702
2016,12,reg,BAL,CIN,19,14,33,2016112701
2016,12,reg,ATL,ARI,38,19,57,2016112700
2016,12,reg,CLE,NYG,13,27,40,2016112704
2016,12,reg,NO,LA,49,21,70,2016112707
2016,12,reg,MIA,SF,31,24,55,2016112706
2016,12,reg,HOU,SD,13,21,34,2016112705
2016,12,reg,TB,SEA,14,5,19,2016112708
2016,12,reg,NYJ,NE,17,22,39,2016112711
2016,12,reg,OAK,CAR,35,32,67,2016112710
2016,12,reg,DEN,KC,27,30,57,2016112709
2016,12,reg,PHI,GB,13,27,40,2016112800
2016,13,reg,MIN,DAL,15,17,32,2016120100
2016,13,reg,ATL,KC,28,29,57,2016120400
2016,13,reg,NO,DET,13,28,41,2016120407
2016,13,reg,NE,LA,26,10,36,2016120406
2016,13,reg,JAX,DEN,10,20,30,2016120405
2016,13,reg,GB,HOU,21,13,34,2016120404
2016,13,reg,CIN,PHI,32,14,46,2016120403
2016,13,reg,BAL,MIA,38,6,44,2016120401
2016,13,reg,CHI,SF,26,6,32,2016120402
2016,13,reg,OAK,BUF,38,24,62,2016120408
2016,13,reg,PIT,NYG,24,14,38,2016120410
2016,13,reg,ARI,WAS,31,23,54,2016120409
2016,13,reg,SD,TB,21,28,49,2016120411
2016,13,reg,SEA,CAR,40,7,47,2016120412
2016,13,reg,NYJ,IND,10,41,51,2016120500
2016,14,reg,KC,OAK,21,13,34,2016120800
2016,14,reg,BUF,PIT,20,27,47,2016121100
2016,14,reg,TEN,DEN,13,10,23,2016121109
2016,14,reg,PHI,WAS,22,27,49,2016121107
2016,14,reg,MIA,ARI,26,23,49,2016121106
2016,14,reg,JAX,MIN,16,25,41,2016121105
2016,14,reg,IND,HOU,17,22,39,2016121104
2016,14,reg,CAR,SD,28,16,44,2016121101
2016,14,reg,CLE,CIN,10,23,33,2016121102
2016,14,reg,DET,CHI,20,17,37,2016121103
2016,14,reg,SF,NYJ,17,23,40,2016121110
2016,14,reg,TB,NO,16,11,27,2016121108
2016,14,reg,LA,ATL,14,42,56,2016121112
2016,14,reg,GB,SEA,38,10,48,2016121111
2016,14,reg,NYG,DAL,10,7,17,2016121113
2016,14,reg,NE,BAL,30,23,53,2016121200
2016,15,reg,SEA,LA,24,3,27,2016121500
2016,15,reg,NYJ,MIA,13,34,47,2016121700
2016,15,reg,CHI,GB,27,30,57,2016121802
2016,15,reg,BUF,CLE,33,13,46,2016121801
2016,15,reg,BAL,PHI,27,26,53,2016121800
2016,15,reg,KC,TEN,17,19,36,2016121805
2016,15,reg,CIN,PIT,20,24,44,2016121812
2016,15,reg,NYG,DET,17,6,23,2016121807
2016,15,reg,MIN,IND,6,34,40,2016121806
2016,15,reg,HOU,JAX,21,20,41,2016121804
2016,15,reg,ARI,NO,41,48,89,2016121808
2016,15,reg,ATL,SF,41,13,54,2016121809
2016,15,reg,SD,OAK,16,19,35,2016121811
2016,15,reg,DEN,NE,3,16,19,2016121810
2016,15,reg,DAL,TB,26,20,46,2016121803
2016,15,reg,WAS,CAR,15,26,41,2016121900
2016,16,reg,PHI,NYG,24,19,43,2016122200
2016,16,reg,BUF,MIA,31,34,65,2016122400
2016,16,reg,NE,NYJ,41,3,44,2016122406
2016,16,reg,JAX,TEN,38,17,55,2016122405
2016,16,reg,GB,MIN,38,25,63,2016122404
2016,16,reg,CLE,SD,20,17,37,2016122403
2016,16,reg,CHI,WAS,21,41,62,2016122402
2016,16,reg,CAR,ATL,16,33,49,2016122401
2016,16,reg,OAK,IND,33,25,58,2016122408
2016,16,reg,NO,TB,31,24,55,2016122407
2016,16,reg,SEA,ARI,31,34,65,2016122410
2016,16,reg,LA,SF,21,22,43,2016122409
2016,16,reg,HOU,CIN,12,10,22,2016122411
2016,16,reg,PIT,BAL,31,27,58,2016122500
2016,16,reg,KC,DEN,33,10,43,2016122501
2016,16,reg,DAL,DET,42,21,63,2016122600
2016,17,reg,CIN,BAL,27,10,37,2017010101
2016,17,reg,TEN,HOU,24,17,41,2017010110
2016,17,reg,TB,CAR,17,16,33,2017010109
2016,17,reg,PIT,CLE,27,24,51,2017010108
2016,17,reg,PHI,DAL,27,13,40,2017010107
2016,17,reg,NYJ,BUF,30,10,40,2017010106
2016,17,reg,MIN,CHI,38,10,48,2017010105
2016,17,reg,IND,JAX,24,20,44,2017010103
2016,17,reg,MIA,NE,14,35,49,2017010104
2016,17,reg,SD,KC,27,37,64,2017010114
2016,17,reg,LA,ARI,6,44,50,2017010113
2016,17,reg,DEN,OAK,24,6,30,2017010112
2016,17,reg,WAS,NYG,10,19,29,2017010111
2016,17,reg,SF,SEA,23,25,48,2017010115
2016,17,reg,ATL,NO,38,32,70,2017010100
2016,17,reg,DET,GB,24,31,55,2017010102
2016,18,post,HOU,OAK,27,14,41,2017010700
2016,18,post,SEA,DET,26,6,32,2017010701
2016,18,post,PIT,MIA,30,12,42,2017010800
2016,18,post,GB,NYG,38,13,51,2017010801
2016,18,post,ATL,SEA,36,20,56,2017011400
2016,18,post,NE,HOU,34,16,50,2017011401
2016,18,post,DAL,GB,31,34,65,2017011501
2016,18,post,KC,PIT,16,18,34,2017011500
2016,18,post,ATL,GB,44,21,65,2017012200
2016,18,post,NE,PIT,36,17,53,2017012201
2016,18,post,NPR,APR,13,20,33,2017012900
2016,18,post,ATL,NE,28,34,62,2017020500
2017,1,reg,NE,KC,27,42,69,2017090700
2017,1,reg,BUF,NYJ,21,12,33,2017091000
2017,1,reg,WAS,PHI,17,30,47,2017091008
2017,1,reg,TEN,OAK,16,26,42,2017091007
2017,1,reg,HOU,JAX,7,29,36,2017091005
2017,1,reg,DET,ARI,35,23,58,2017091004
2017,1,reg,CLE,PIT,18,21,39,2017091003
2017,1,reg,CHI,ATL,17,23,40,2017091001
2017,1,reg,CIN,BAL,0,20,20,2017091002
2017,1,reg,LA,IND,46,9,55,2017091009
2017,1,reg,SF,CAR,3,23,26,2017091011
2017,1,reg,GB,SEA,17,9,26,2017091010
2017,1,reg,DAL,NYG,19,3,22,2017091012
2017,1,reg,MIN,NO,29,19,48,2017091100
2017,1,reg,DEN,LAC,24,21,45,2017091101
2017,2,reg,CIN,HOU,9,13,22,2017091400
2017,2,reg,BAL,CLE,24,10,34,2017091700
2017,2,reg,TB,CHI,29,7,36,2017091707
2017,2,reg,PIT,MIN,26,9,35,2017091706
2017,2,reg,NO,NE,20,36,56,2017091705
2017,2,reg,KC,PHI,27,20,47,2017091704
2017,2,reg,JAX,TEN,16,37,53,2017091703
2017,2,reg,IND,ARI,13,16,29,2017091702
2017,2,reg,CAR,BUF,9,3,12,2017091701
2017,2,reg,OAK,NYJ,45,20,65,2017091709
2017,2,reg,LAC,MIA,17,19,36,2017091708
2017,2,reg,SEA,SF,12,9,21,2017091712
2017,2,reg,LA,WAS,20,27,47,2017091711
2017,2,reg,DEN,DAL,42,17,59,2017091710
2017,2,reg,ATL,GB,34,23,57,2017091713
2017,2,reg,NYG,DET,10,24,34,2017091800
2017,3,reg,SF,LA,39,41,80,2017092100
2017,3,reg,JAX,BAL,44,7,51,2017092400
2017,3,reg,IND,CLE,31,28,59,2017092405
2017,3,reg,PHI,NYG,27,24,51,2017092409
2017,3,reg,NYJ,MIA,20,6,26,2017092408
2017,3,reg,BUF,DEN,26,16,42,2017092401
2017,3,reg,CAR,NO,13,34,47,2017092402
2017,3,reg,CHI,PIT,23,17,40,2017092403
2017,3,reg,DET,ATL,26,30,56,2017092404
2017,3,reg,MIN,TB,34,17,51,2017092406
2017,3,reg,NE,HOU,36,33,69,2017092407
2017,3,reg,TEN,SEA,33,27,60,2017092410
2017,3,reg,GB,CIN,27,24,51,2017092411
2017,3,reg,LAC,KC,10,24,34,2017092412
2017,3,reg,WAS,OAK,27,10,37,2017092413
2017,3,reg,ARI,DAL,17,28,45,2017092500
2017,4,reg,GB,CHI,35,14,49,2017092800
2017,4,reg,MIA,NO,0,20,20,2017100100
2017,4,reg,HOU,TEN,57,14,71,2017100105
2017,4,reg,NYJ,JAX,23,20,43,2017100108
2017,4,reg,NE,CAR,30,33,63,2017100107
2017,4,reg,MIN,DET,7,14,21,2017100106
2017,4,reg,ATL,BUF,17,23,40,2017100101
2017,4,reg,BAL,PIT,9,26,35,2017100102
2017,4,reg,CLE,CIN,7,31,38,2017100103
2017,4,reg,DAL,LA,30,35,65,2017100104
2017,4,reg,LAC,PHI,24,26,50,2017100110
2017,4,reg,TB,NYG,25,23,48,2017100111
2017,4,reg,ARI,SF,18,15,33,2017100109
2017,4,reg,DEN,OAK,16,10,26,2017100112
2017,4,reg,SEA,IND,46,18,64,2017100113
2017,4,reg,KC,WAS,29,20,49,2017100200
2017,5,reg,TB,NE,14,19,33,2017100500
2017,5,reg,CLE,NYJ,14,17,31,2017100801
2017,5,reg,DET,CAR,24,27,51,2017100802
2017,5,reg,IND,SF,26,23,49,2017100803
2017,5,reg,MIA,TEN,16,10,26,2017100804
2017,5,reg,CIN,BUF,20,16,36,2017100800
2017,5,reg,NYG,LAC,22,27,49,2017100805
2017,5,reg,PIT,JAX,9,30,39,2017100807
2017,5,reg,PHI,ARI,34,7,41,2017100806
2017,5,reg,LA,SEA,10,16,26,2017100808
2017,5,reg,OAK,BAL,17,30,47,2017100809
2017,5,reg,DAL,GB,31,35,66,2017100810
2017,5,reg,HOU,KC,34,42,76,2017100811
2017,5,reg,CHI,MIN,17,20,37,2017100900
2017,6,reg,CAR,PHI,23,28,51,2017101200
2017,6,reg,BAL,CHI,24,27,51,2017101501
2017,6,reg,HOU,CLE,33,17,50,2017101502
2017,6,reg,MIN,GB,23,10,33,2017101503
2017,6,reg,NO,DET,52,38,90,2017101504
2017,6,reg,ATL,MIA,17,20,37,2017101500
2017,6,reg,NYJ,NE,17,24,41,2017101505
2017,6,reg,WAS,SF,26,24,50,2017101506
2017,6,reg,ARI,TB,38,33,71,2017101507
2017,6,reg,JAX,LA,17,27,44,2017101508
2017,6,reg,KC,PIT,13,19,32,2017101509
2017,6,reg,OAK,LAC,16,17,33,2017101510
2017,6,reg,DEN,NYG,10,23,33,2017101511
2017,6,reg,TEN,IND,36,22,58,2017101600
2017,7,reg,OAK,KC,31,30,61,2017101900
2017,7,reg,BUF,TB,30,27,57,2017102200
2017,7,reg,MIN,BAL,24,16,40,2017102207
2017,7,reg,MIA,NYJ,31,28,59,2017102206
2017,7,reg,LA,ARI,33,0,33,2017102205
2017,7,reg,IND,JAX,0,27,27,2017102204
2017,7,reg,GB,NO,17,26,43,2017102203
2017,7,reg,CHI,CAR,17,3,20,2017102201
2017,7,reg,CLE,TEN,9,12,21,2017102202
2017,7,reg,SF,DAL,10,40,50,2017102209
2017,7,reg,LAC,DEN,21,0,21,2017102210
2017,7,reg,PIT,CIN,29,14,43,2017102208
2017,7,reg,NYG,SEA,7,24,31,2017102211
2017,7,reg,NE,ATL,23,7,30,2017102212
2017,7,reg,PHI,WAS,34,24,58,2017102300
2017,8,reg,BAL,MIA,40,0,40,2017102600
2017,8,reg,CLE,MIN,16,33,49,2017102900
2017,8,reg,NYJ,ATL,20,25,45,2017102905
2017,8,reg,TB,CAR,3,17,20,2017102907
2017,8,reg,PHI,SF,33,10,43,2017102906
2017,8,reg,NO,CHI,20,12,32,2017102904
2017,8,reg,NE,LAC,21,13,34,2017102903
2017,8,reg,BUF,OAK,34,14,48,2017102901
2017,8,reg,CIN,IND,24,23,47,2017102902
2017,8,reg,SEA,HOU,41,38,79,2017102908
2017,8,reg,WAS,DAL,19,33,52,2017102909
2017,8,reg,DET,PIT,15,20,35,2017102910
2017,8,reg,KC,DEN,29,19,48,2017103000
2017,9,reg,NYJ,BUF,34,21,55,2017110200
2017,9,reg,HOU,IND,14,20,34,2017110501
2017,9,reg,JAX,CIN,23,7,30,2017110502
2017,9,reg,NO,TB,30,10,40,2017110503
2017,9,reg,NYG,LA,17,51,68,2017110504
2017,9,reg,CAR,ATL,20,17,37,2017110500
2017,9,reg,PHI,DEN,51,23,74,2017110505
2017,9,reg,TEN,BAL,23,20,43,2017110506
2017,9,reg,SF,ARI,10,20,30,2017110507
2017,9,reg,SEA,WAS,14,17,31,2017110508
2017,9,reg,DAL,KC,28,17,45,2017110509
2017,9,reg,MIA,OAK,24,27,51,2017110510
2017,9,reg,GB,DET,17,30,47,2017110600
2017,10,reg,ARI,SEA,16,22,38,2017110900
2017,10,reg,CHI,GB,16,23,39,2017111201
2017,10,reg,DET,CLE,38,24,62,2017111202
2017,10,reg,IND,PIT,17,20,37,2017111203
2017,10,reg,JAX,LAC,20,17,37,2017111204
2017,10,reg,BUF,NO,10,47,57,2017111200
2017,10,reg,TB,NYJ,15,10,25,2017111205
2017,10,reg,WAS,MIN,30,38,68,2017111207
2017,10,reg,TEN,CIN,24,20,44,2017111206
2017,10,reg,LA,HOU,33,7,40,2017111208
2017,10,reg,ATL,DAL,27,7,34,2017111209
2017,10,reg,SF,NYG,31,21,52,2017111210
2017,10,reg,DEN,NE,16,41,57,2017111211
2017,10,reg,CAR,MIA,45,21,66,2017111300
2017,11,reg,PIT,TEN,40,17,57,2017111600
2017,11,reg,CHI,DET,24,27,51,2017111900
2017,11,reg,CLE,JAX,7,19,26,2017111901
2017,11,reg,GB,BAL,0,23,23,2017111902
2017,11,reg,HOU,ARI,31,21,52,2017111903
2017,11,reg,MIA,TB,20,30,50,2017111911
2017,11,reg,MIN,LA,24,7,31,2017111904
2017,11,reg,NYG,KC,12,9,21,2017111906
2017,11,reg,NO,WAS,34,31,65,2017111905
2017,11,reg,LAC,BUF,54,24,78,2017111907
2017,11,reg,DEN,CIN,17,20,37,2017111908
2017,11,reg,OAK,NE,8,33,41,2017111909
2017,11,reg,DAL,PHI,9,37,46,2017111910
2017,11,reg,SEA,ATL,31,34,65,2017112000
2017,12,reg,DET,MIN,23,30,53,2017112300
2017,12,reg,DAL,LAC,6,28,34,2017112301
2017,12,reg,WAS,NYG,20,10,30,2017112302
2017,12,reg,KC,BUF,10,16,26,2017112603
2017,12,reg,IND,TEN,16,20,36,2017112602
2017,12,reg,CIN,CLE,30,16,46,2017112601
2017,12,reg,ATL,TB,34,20,54,2017112600
2017,12,reg,NE,MIA,35,17,52,2017112604
2017,12,reg,PHI,CHI,31,3,34,2017112606
2017,12,reg,NYJ,CAR,27,35,62,2017112605
2017,12,reg,SF,SEA,13,24,37,2017112608
2017,12,reg,LA,NO,26,20,46,2017112607
2017,12,reg,ARI,JAX,27,24,51,2017112609
2017,12,reg,OAK,DEN,21,14,35,2017112610
2017,12,reg,PIT,GB,31,28,59,2017112611
2017,12,reg,BAL,HOU,23,16,39,2017112700
2017,13,reg,DAL,WAS,38,14,52,2017113000
2017,13,reg,ATL,MIN,9,14,23,2017120300
2017,13,reg,TEN,HOU,24,13,37,2017120309
2017,13,reg,NYJ,KC,38,31,69,2017120308
2017,13,reg,MIA,DEN,35,9,44,2017120306
2017,13,reg,JAX,IND,30,10,40,2017120305
2017,13,reg,GB,TB,26,20,46,2017120304
2017,13,reg,BAL,DET,44,20,64,2017120301
2017,13,reg,BUF,NE,3,23,26,2017120302
2017,13,reg,CHI,SF,14,15,29,2017120303
2017,13,reg,LAC,CLE,19,10,29,2017120310
2017,13,reg,OAK,NYG,24,17,41,2017120312
2017,13,reg,NO,CAR,31,21,52,2017120307
2017,13,reg,ARI,LA,16,32,48,2017120311
2017,13,reg,SEA,PHI,24,10,34,2017120313
2017,13,reg,CIN,PIT,20,23,43,2017120400
2017,14,reg,ATL,NO,20,17,37,2017120700
2017,14,reg,BUF,IND,13,7,20,2017121000
2017,14,reg,NYG,DAL,10,30,40,2017121012
2017,14,reg,TB,DET,21,24,45,2017121007
2017,14,reg,KC,OAK,26,15,41,2017121006
2017,14,reg,HOU,SF,16,26,42,2017121004
2017,14,reg,CLE,GB,21,27,48,2017121003
2017,14,reg,CIN,CHI,7,33,40,2017121002
2017,14,reg,CAR,MIN,31,24,55,2017121001
2017,14,reg,LAC,WAS,30,13,43,2017121010
2017,14,reg,DEN,NYJ,23,0,23,2017121009
2017,14,reg,ARI,TEN,12,7,19,2017121008
2017,14,reg,LA,PHI,35,43,78,2017121011
2017,14,reg,JAX,SEA,30,24,54,2017121005
2017,14,reg,PIT,BAL,39,38,77,2017121013
2017,14,reg,MIA,NE,27,20,47,2017121100
2017,15,reg,IND,DEN,13,25,38,2017121400
2017,15,reg,DET,CHI,20,10,30,2017121600
2017,15,reg,KC,LAC,30,13,43,2017121601
2017,15,reg,JAX,HOU,45,7,52,2017121703
2017,15,reg,CLE,BAL,10,27,37,2017121702
2017,15,reg,CAR,GB,31,24,55,2017121701
2017,15,reg,BUF,MIA,24,16,40,2017121700
2017,15,reg,MIN,CIN,34,7,41,2017121704
2017,15,reg,WAS,ARI,20,15,35,2017121707
2017,15,reg,NYG,PHI,29,34,63,2017121706
2017,15,reg,NO,NYJ,31,19,50,2017121705
2017,15,reg,SEA,LA,7,42,49,2017121708
2017,15,reg,SF,TEN,25,23,48,2017121710
2017,15,reg,PIT,NE,24,27,51,2017121709
2017,15,reg,OAK,DAL,17,20,37,2017121711
2017,15,reg,TB,ATL,21,24,45,2017121800
2017,16,reg,BAL,IND,23,16,39,2017122300
2017,16,reg,GB,MIN,0,16,16,2017122301
2017,16,reg,CIN,DET,26,17,43,2017122402
2017,16,reg,KC,MIA,29,13,42,2017122403
2017,16,reg,NE,BUF,37,16,53,2017122404
2017,16,reg,CHI,CLE,20,3,23,2017122401
2017,16,reg,CAR,TB,22,19,41,2017122400
2017,16,reg,NO,ATL,23,13,36,2017122405
2017,16,reg,WAS,DEN,27,11,38,2017122408
2017,16,reg,TEN,LA,23,27,50,2017122407
2017,16,reg,NYJ,LAC,7,14,21,2017122406
2017,16,reg,SF,JAX,44,33,77,2017122409
2017,16,reg,DAL,SEA,12,21,33,2017122411
2017,16,reg,ARI,NYG,23,0,23,2017122410
2017,16,reg,HOU,PIT,6,34,40,2017122500
2017,16,reg,PHI,OAK,19,10,29,2017122501
2017,17,reg,NYG,WAS,18,10,28,2017123107
2017,17,reg,NE,NYJ,26,6,32,2017123106
2017,17,reg,MIN,CHI,23,10,33,2017123105
2017,17,reg,DET,GB,35,11,46,2017123102
2017,17,reg,IND,HOU,22,13,35,2017123103
2017,17,reg,PIT,CLE,28,24,52,2017123109
2017,17,reg,PHI,DAL,0,6,6,2017123108
2017,17,reg,LA,SF,13,34,47,2017123114
2017,17,reg,LAC,OAK,30,10,40,2017123113
2017,17,reg,DEN,KC,24,27,51,2017123112
2017,17,reg,TEN,JAX,15,10,25,2017123111
2017,17,reg,TB,NO,31,24,55,2017123110
2017,17,reg,MIA,BUF,16,22,38,2017123104
2017,17,reg,SEA,ARI,24,26,50,2017123115
2017,17,reg,ATL,CAR,22,10,32,2017123100
2017,17,reg,BAL,CIN,27,31,58,2017123101
2017,18,post,KC,TEN,21,22,43,2018010600
2017,18,post,LA,ATL,13,26,39,2018010601
2017,18,post,JAX,BUF,10,3,13,2018010700
2017,18,post,NO,CAR,31,26,57,2018010701
2017,18,post,PHI,ATL,15,10,25,2018011300
2017,18,post,NE,TEN,35,14,49,2018011301
2017,18,post,PIT,JAX,42,45,87,2018011400
2017,18,post,MIN,NO,29,24,53,2018011401
2017,18,post,NE,JAX,24,20,44,2018012100
2017,18,post,PHI,MIN,38,7,45,2018012101
2017,18,post,APR,NPR,24,23,47,2018012800
2017,18,post,NE,PHI,33,41,74,2018020400
2018,1,reg,PHI,ATL,18,12,30,2018090600
2018,1,reg,BAL,BUF,47,3,50,2018090900
2018,1,reg,NYG,JAX,15,20,35,2018090907
2018,1,reg,NO,TB,40,48,88,2018090906
2018,1,reg,NE,HOU,27,20,47,2018090905
2018,1,reg,MIN,SF,24,16,40,2018090904
2018,1,reg,MIA,TEN,27,20,47,2018090903
2018,1,reg,IND,CIN,23,34,57,2018090902
2018,1,reg,CLE,PIT,21,21,42,2018090901
2018,1,reg,LAC,KC,28,38,66,2018090908
2018,1,reg,DEN,SEA,27,24,51,2018090911
2018,1,reg,CAR,DAL,16,8,24,2018090910
2018,1,reg,ARI,WAS,6,24,30,2018090909
2018,1,reg,GB,CHI,24,23,47,2018090912
2018,1,reg,DET,NYJ,17,48,65,2018091000
2018,1,reg,OAK,LA,13,33,46,2018091001
2018,2,reg,CIN,BAL,34,23,57,2018091300
2018,2,reg,ATL,CAR,31,24,55,2018091600
2018,2,reg,WAS,IND,9,21,30,2018091608
2018,2,reg,TEN,HOU,20,17,37,2018091607
2018,2,reg,TB,PHI,27,21,48,2018091606
2018,2,reg,PIT,KC,37,42,79,2018091605
2018,2,reg,NYJ,MIA,12,20,32,2018091604
2018,2,reg,BUF,LAC,20,31,51,2018091601
2018,2,reg,GB,MIN,29,29,58,2018091602
2018,2,reg,NO,CLE,21,18,39,2018091603
2018,2,reg,SF,DET,30,27,57,2018091610
2018,2,reg,LA,ARI,34,0,34,2018091609
2018,2,reg,JAX,NE,31,20,51,2018091612
2018,2,reg,DEN,OAK,20,19,39,2018091611
2018,2,reg,DAL,NYG,20,13,33,2018091613
2018,2,reg,CHI,SEA,24,17,41,2018091700
2018,3,reg,CLE,NYJ,21,17,38,2018092000
2018,3,reg,ATL,NO,37,43,80,2018092300
2018,3,reg,WAS,GB,31,17,48,2018092309
2018,3,reg,PHI,IND,20,16,36,2018092308
2018,3,reg,MIN,BUF,6,27,33,2018092307
2018,3,reg,MIA,OAK,28,20,48,2018092306
2018,3,reg,BAL,DEN,27,14,41,2018092301
2018,3,reg,CAR,CIN,31,21,52,2018092302
2018,3,reg,HOU,NYG,22,27,49,2018092303
2018,3,reg,JAX,TEN,6,9,15,2018092304
2018,3,reg,KC,SF,38,27,65,2018092305
2018,3,reg,LA,LAC,35,23,58,2018092310
2018,3,reg,SEA,DAL,24,13,37,2018092312
2018,3,reg,ARI,CHI,14,16,30,2018092311
2018,3,reg,DET,NE,26,10,36,2018092313
2018,3,reg,TB,PIT,27,30,57,2018092400
2018,4,reg,LA,MIN,38,31,69,2018092700
2018,4,reg,JAX,NYJ,31,12,43,2018093005
2018,4,reg,NE,MIA,38,7,45,2018093006
2018,4,reg,TEN,PHI,26,23,49,2018093007
2018,4,reg,IND,HOU,34,37,71,2018093004
2018,4,reg,GB,BUF,22,0,22,2018093003
2018,4,reg,DAL,DET,26,24,50,2018093002
2018,4,reg,CHI,TB,48,10,58,2018093001
2018,4,reg,ATL,CIN,36,37,73,2018093000
2018,4,reg,ARI,SEA,17,20,37,2018093008
2018,4,reg,OAK,CLE,45,42,87,2018093009
2018,4,reg,NYG,NO,18,33,51,2018093011
2018,4,reg,LAC,SF,29,27,56,2018093010
2018,4,reg,PIT,BAL,14,26,40,2018093012
2018,4,reg,DEN,KC,23,27,50,2018100100
2018,5,reg,NE,IND,38,24,62,2018100400
2018,5,reg,BUF,TEN,13,12,25,2018100700
2018,5,reg,PIT,ATL,41,17,58,2018100707
2018,5,reg,NYJ,DEN,34,16,50,2018100706
2018,5,reg,KC,JAX,30,14,44,2018100705
2018,5,reg,DET,GB,31,23,54,2018100704
2018,5,reg,CLE,BAL,12,9,21,2018100703
2018,5,reg,CAR,NYG,33,31,64,2018100701
2018,5,reg,CIN,MIA,27,17,44,2018100702
2018,5,reg,LAC,OAK,26,10,36,2018100708
2018,5,reg,SF,ARI,18,28,46,2018100710
2018,5,reg,PHI,MIN,21,23,44,2018100709
2018,5,reg,SEA,LA,31,33,64,2018100711
2018,5,reg,HOU,DAL,19,16,35,2018100712
2018,5,reg,NO,WAS,43,19,62,2018100800
2018,6,reg,NYG,PHI,13,34,47,2018101100
2018,6,reg,ATL,TB,34,29,63,2018101400
2018,6,reg,WAS,CAR,23,17,40,2018101408
2018,6,reg,OAK,SEA,3,27,30,2018101407
2018,6,reg,NYJ,IND,42,34,76,2018101406
2018,6,reg,MIN,ARI,27,17,44,2018101405
2018,6,reg,CIN,PIT,21,28,49,2018101401
2018,6,reg,CLE,LAC,14,38,52,2018101402
2018,6,reg,HOU,BUF,20,13,33,2018101403
2018,6,reg,MIA,CHI,31,28,59,2018101404
2018,6,reg,DEN,LA,20,23,43,2018101409
2018,6,reg,TEN,BAL,0,21,21,2018101411
2018,6,reg,DAL,JAX,40,7,47,2018101410
2018,6,reg,NE,KC,43,40,83,2018101412
2018,6,reg,GB,SF,33,30,63,2018101500
2018,7,reg,ARI,DEN,10,45,55,2018101800
2018,7,reg,LAC,TEN,20,19,39,2018102100
2018,7,reg,JAX,HOU,7,20,27,2018102104
2018,7,reg,PHI,CAR,17,21,38,2018102108
2018,7,reg,NYJ,MIN,17,37,54,2018102107
2018,7,reg,CHI,NE,31,38,69,2018102102
2018,7,reg,IND,BUF,37,5,42,2018102103
2018,7,reg,TB,CLE,26,23,49,2018102109
2018,7,reg,MIA,DET,21,32,53,2018102106
2018,7,reg,BAL,NO,23,24,47,2018102101
2018,7,reg,WAS,DAL,20,17,37,2018102110
2018,7,reg,SF,LA,10,39,49,2018102111
2018,7,reg,KC,CIN,45,10,55,2018102105
2018,7,reg,ATL,NYG,23,20,43,2018102200
2018,8,reg,HOU,MIA,42,23,65,2018102500
2018,8,reg,JAX,PHI,18,24,42,2018102800
2018,8,reg,KC,DEN,30,23,53,2018102805
2018,8,reg,PIT,CLE,33,18,51,2018102807
2018,8,reg,NYG,WAS,13,20,33,2018102806
2018,8,reg,DET,SEA,14,28,42,2018102804
2018,8,reg,CIN,TB,37,34,71,2018102803
2018,8,reg,CHI,NYJ,24,10,34,2018102802
2018,8,reg,CAR,BAL,36,21,57,2018102801
2018,8,reg,OAK,IND,28,42,70,2018102808
2018,8,reg,ARI,SF,18,15,33,2018102809
2018,8,reg,LA,GB,29,27,56,2018102810
2018,8,reg,MIN,NO,20,30,50,2018102811
2018,8,reg,BUF,NE,6,25,31,2018102900
2018,9,reg,SF,OAK,34,3,37,2018110100
2018,9,reg,BUF,CHI,9,41,50,2018110401
2018,9,reg,CAR,TB,42,28,70,2018110402
2018,9,reg,CLE,KC,21,37,58,2018110403
2018,9,reg,MIA,NYJ,13,6,19,2018110404
2018,9,reg,BAL,PIT,16,23,39,2018110400
2018,9,reg,MIN,DET,24,9,33,2018110405
2018,9,reg,WAS,ATL,14,38,52,2018110406
2018,9,reg,DEN,HOU,17,19,36,2018110407
2018,9,reg,SEA,LAC,17,25,42,2018110408
2018,9,reg,NO,LA,45,35,80,2018110409
2018,9,reg,NE,GB,31,17,48,2018110410
2018,9,reg,DAL,TEN,14,28,42,2018110500
2018,10,reg,PIT,CAR,52,21,73,2018110800
2018,10,reg,CIN,NO,14,51,65,2018111101
2018,10,reg,CLE,ATL,28,16,44,2018111102
2018,10,reg,CHI,DET,34,22,56,2018111100
2018,10,reg,KC,ARI,26,14,40,2018111105
2018,10,reg,TEN,NE,34,10,44,2018111108
2018,10,reg,TB,WAS,3,16,19,2018111107
2018,10,reg,NYJ,BUF,10,41,51,2018111106
2018,10,reg,IND,JAX,29,26,55,2018111104
2018,10,reg,OAK,LAC,6,20,26,2018111109
2018,10,reg,LA,SEA,36,31,67,2018111110
2018,10,reg,GB,MIA,31,12,43,2018111103
2018,10,reg,PHI,DAL,20,27,47,2018111111
2018,10,reg,SF,NYG,23,27,50,2018111200
2018,11,reg,SEA,GB,27,24,51,2018111500
2018,11,reg,BAL,CIN,24,21,45,2018111801
2018,11,reg,ATL,DAL,19,22,41,2018111800
2018,11,reg,NYG,TB,38,35,73,2018111805
2018,11,reg,JAX,PIT,16,20,36,2018111810
2018,11,reg,WAS,HOU,21,23,44,2018111806
2018,11,reg,IND,TEN,38,10,48,2018111804
2018,11,reg,DET,CAR,20,19,39,2018111803
2018,11,reg,LAC,DEN,22,23,45,2018111808
2018,11,reg,ARI,OAK,21,23,44,2018111807
2018,11,reg,NO,PHI,48,7,55,2018111809
2018,11,reg,CHI,MIN,25,20,45,2018111802
2018,11,reg,LA,KC,54,51,105,2018111900
2018,12,reg,DET,CHI,16,23,39,2018112200
2018,12,reg,DAL,WAS,31,23,54,2018112201
2018,12,reg,NO,ATL,31,17,48,2018112202
2018,12,reg,CIN,CLE,20,35,55,2018112503
2018,12,reg,TB,SF,27,9,36,2018112507
2018,12,reg,BUF,JAX,24,21,45,2018112501
2018,12,reg,BAL,OAK,34,17,51,2018112500
2018,12,reg,CAR,SEA,27,30,57,2018112502
2018,12,reg,NYJ,NE,13,27,40,2018112505
2018,12,reg,PHI,NYG,25,22,47,2018112506
2018,12,reg,LAC,ARI,45,10,55,2018112508
2018,12,reg,IND,MIA,27,24,51,2018112504
2018,12,reg,DEN,PIT,24,17,41,2018112509
2018,12,reg,MIN,GB,24,17,41,2018112510
2018,12,reg,HOU,TEN,34,17,51,2018112600
2018,13,reg,DAL,NO,13,10,23,2018112900
2018,13,reg,ATL,BAL,16,26,42,2018120200
2018,13,reg,TB,CAR,24,17,41,2018120209
2018,13,reg,NYG,CHI,30,27,57,2018120207
2018,13,reg,MIA,BUF,21,17,38,2018120206
2018,13,reg,JAX,IND,6,0,6,2018120205
2018,13,reg,HOU,CLE,29,13,42,2018120204
2018,13,reg,CIN,DEN,10,24,34,2018120201
2018,13,reg,DET,LA,16,30,46,2018120202
2018,13,reg,GB,ARI,17,20,37,2018120203
2018,13,reg,OAK,KC,33,40,73,2018120210
2018,13,reg,TEN,NYJ,26,22,48,2018120211
2018,13,reg,SEA,SF,43,16,59,2018120213
2018,13,reg,NE,MIN,24,10,34,2018120212
2018,13,reg,PIT,LAC,30,33,63,2018120208
2018,13,reg,PHI,WAS,28,13,41,2018120300
2018,14,reg,TEN,JAX,30,9,39,2018120600
2018,14,reg,BUF,NYJ,23,27,50,2018120900
2018,14,reg,WAS,NYG,16,40,56,2018120908
2018,14,reg,TB,NO,14,28,42,2018120907
2018,14,reg,MIA,NE,34,33,67,2018120906
2018,14,reg,KC,BAL,27,24,51,2018120905
2018,14,reg,HOU,IND,21,24,45,2018120904
2018,14,reg,GB,ATL,34,20,54,2018120903
2018,14,reg,CLE,CAR,26,20,46,2018120902
2018,14,reg,SF,DEN,20,14,34,2018120910
2018,14,reg,LAC,CIN,26,21,47,2018120909
2018,14,reg,ARI,DET,3,17,20,2018120911
2018,14,reg,OAK,PIT,24,21,45,2018120913
2018,14,reg,DAL,PHI,29,23,52,2018120912
2018,14,reg,CHI,LA,15,6,21,2018120901
2018,14,reg,SEA,MIN,21,7,28,2018121000
2018,15,reg,KC,LAC,28,29,57,2018121300
2018,15,reg,NYJ,HOU,22,29,51,2018121500
2018,15,reg,DEN,CLE,16,17,33,2018121501
2018,15,reg,CHI,GB,24,17,41,2018121603
2018,15,reg,BUF,DET,14,13,27,2018121602
2018,15,reg,BAL,TB,20,12,32,2018121601
2018,15,reg,ATL,ARI,40,14,54,2018121600
2018,15,reg,CIN,OAK,30,16,46,2018121604
2018,15,reg,NYG,TEN,0,17,17,2018121608
2018,15,reg,MIN,MIA,41,17,58,2018121607
2018,15,reg,JAX,WAS,13,16,29,2018121606
2018,15,reg,IND,DAL,23,0,23,2018121605
2018,15,reg,SF,SEA,26,23,49,2018121609
2018,15,reg,PIT,NE,17,10,27,2018121610
2018,15,reg,LA,PHI,23,30,53,2018121611
2018,15,reg,CAR,NO,9,12,21,2018121700
2018,16,reg,TEN,WAS,25,16,41,2018122200
2018,16,reg,LAC,BAL,10,22,32,2018122201
2018,16,reg,CLE,CIN,26,18,44,2018122305
2018,16,reg,DAL,TB,27,20,47,2018122306
2018,16,reg,DET,MIN,9,27,36,2018122307
2018,16,reg,NE,BUF,24,12,36,2018122308
2018,16,reg,NYJ,GB,38,44,82,2018122309
2018,16,reg,PHI,HOU,32,30,62,2018122310
2018,16,reg,CAR,ATL,10,24,34,2018122304
2018,16,reg,IND,NYG,28,27,55,2018122300
2018,16,reg,MIA,JAX,7,17,24,2018122302
2018,16,reg,ARI,LA,9,31,40,2018122311
2018,16,reg,SF,CHI,9,14,23,2018122312
2018,16,reg,NO,PIT,31,28,59,2018122313
2018,16,reg,SEA,KC,38,31,69,2018122314
2018,16,reg,OAK,DEN,27,14,41,2018122400
2018,17,reg,BUF,MIA,42,17,59,2018123001
2018,17,reg,TB,ATL,32,34,66,2018123010
2018,17,reg,NYG,DAL,35,36,71,2018123008
2018,17,reg,NO,CAR,14,33,47,2018123007
2018,17,reg,NE,NYJ,38,3,41,2018123006
2018,17,reg,HOU,JAX,20,3,23,2018123003
2018,17,reg,GB,DET,0,31,31,2018123002
2018,17,reg,WAS,PHI,0,24,24,2018123012
2018,17,reg,DEN,LAC,9,23,32,2018123013
2018,17,reg,KC,OAK,35,3,38,2018123004
2018,17,reg,MIN,CHI,10,24,34,2018123005
2018,17,reg,BAL,CLE,26,24,50,2018123000
2018,17,reg,LA,SF,48,32,80,2018123014
2018,17,reg,PIT,CIN,16,13,29,2018123009
2018,17,reg,SEA,ARI,27,24,51,2018123015
2018,17,reg,TEN,IND,17,33,50,2018123011
2018,18,post,HOU,IND,7,21,28,2019010500
2018,18,post,DAL,SEA,24,22,46,2019010501
2018,18,post,BAL,LAC,17,23,40,2019010600
2018,18,post,CHI,PHI,15,16,31,2019010601
2018,18,post,KC,IND,31,13,44,2019011200
2018,18,post,LA,DAL,30,22,52,2019011201
2018,18,post,NE,LAC,41,28,69,2019011300
2018,18,post,NO,PHI,20,14,34,2019011301
2018,18,post,NO,LA,23,26,49,2019012000
2018,18,post,KC,NE,31,37,68,2019012001
2018,18,post,NPR,APR,7,26,33,2019012700
2018,18,post,LA,NE,3,13,16,2019020300
2019,1,reg,CHI,GB,3,10,13,2019090500
2019,1,reg,CAR,LA,27,30,57,2019090800
2019,1,reg,PHI,WAS,32,27,59,2019090806
2019,1,reg,NYJ,BUF,16,17,33,2019090805
2019,1,reg,MIN,ATL,28,12,40,2019090804
2019,1,reg,MIA,BAL,10,59,69,2019090803
2019,1,reg,JAX,KC,26,40,66,2019090802
2019,1,reg,CLE,TEN,13,43,56,2019090801
2019,1,reg,LAC,IND,30,24,54,2019090807
2019,1,reg,SEA,CIN,21,20,41,2019090808
2019,1,reg,TB,SF,17,31,48,2019090811
2019,1,reg,DAL,NYG,35,17,52,2019090810
2019,1,reg,ARI,DET,27,27,54,2019090809
2019,1,reg,NE,PIT,33,3,36,2019090812
2019,1,reg,NO,HOU,30,28,58,2019090900
2019,1,reg,OAK,DEN,24,16,40,2019090901
2019,2,reg,CAR,TB,14,20,34,2019091200
2019,2,reg,BAL,ARI,23,17,40,2019091500
2019,2,reg,WAS,DAL,21,31,52,2019091509
2019,2,reg,TEN,IND,17,19,36,2019091508
2019,2,reg,PIT,SEA,26,28,54,2019091507
2019,2,reg,NYG,BUF,14,28,42,2019091506
2019,2,reg,CIN,SF,17,41,58,2019091501
2019,2,reg,DET,LAC,13,10,23,2019091502
2019,2,reg,GB,MIN,21,16,37,2019091503
2019,2,reg,HOU,JAX,13,12,25,2019091504
2019,2,reg,MIA,NE,0,43,43,2019091505
2019,2,reg,OAK,KC,10,28,38,2019091510
2019,2,reg,LA,NO,27,9,36,2019091512
2019,2,reg,DEN,CHI,14,16,30,2019091511
2019,2,reg,ATL,PHI,24,20,44,2019091513
2019,2,reg,NYJ,CLE,3,23,26,2019091600
2019,3,reg,JAX,TEN,20,7,27,2019091900
2019,3,reg,BUF,CIN,21,17,38,2019092200
2019,3,reg,PHI,DET,24,27,51,2019092207
2019,3,reg,NE,NYJ,30,14,44,2019092206
2019,3,reg,MIN,OAK,34,14,48,2019092205
2019,3,reg,KC,BAL,33,28,61,2019092204
2019,3,reg,IND,ATL,27,24,51,2019092203
2019,3,reg,GB,DEN,27,16,43,2019092202
2019,3,reg,DAL,MIA,31,6,37,2019092201
2019,3,reg,TB,NYG,31,32,63,2019092209
2019,3,reg,ARI,CAR,20,38,58,2019092208
2019,3,reg,SF,PIT,24,20,44,2019092212
2019,3,reg,SEA,NO,27,33,60,2019092211
2019,3,reg,LAC,HOU,20,27,47,2019092210
2019,3,reg,CLE,LA,13,20,33,2019092213
2019,3,reg,WAS,CHI,15,31,46,2019092300
2019,4,reg,GB,PHI,27,34,61,2019092600
2019,4,reg,ATL,TEN,10,24,34,2019092900
2019,4,reg,NYG,WAS,24,3,27,2019092907
2019,4,reg,MIA,LAC,10,30,40,2019092906
2019,4,reg,IND,OAK,24,31,55,2019092905
2019,4,reg,HOU,CAR,10,16,26,2019092904
2019,4,reg,DET,KC,30,34,64,2019092903
2019,4,reg,BAL,CLE,25,40,65,2019092901
2019,4,reg,BUF,NE,10,16,26,2019092902
2019,4,reg,LA,TB,40,55,95,2019092909
2019,4,reg,ARI,SEA,10,27,37,2019092908
2019,4,reg,CHI,MIN,16,6,22,2019092910
2019,4,reg,DEN,JAX,24,26,50,2019092911
2019,4,reg,NO,DAL,12,10,22,2019092912
2019,4,reg,PIT,CIN,27,3,30,2019093000
2019,5,reg,SEA,LA,30,29,59,2019100300
2019,5,reg,CAR,JAX,34,27,61,2019100600
2019,5,reg,WAS,NE,7,33,40,2019100609
2019,5,reg,TEN,BUF,7,14,21,2019100608
2019,5,reg,PIT,BAL,23,26,49,2019100607
2019,5,reg,CIN,ARI,23,26,49,2019100601
2019,5,reg,HOU,ATL,53,32,85,2019100602
2019,5,reg,NO,TB,31,24,55,2019100603
2019,5,reg,NYG,MIN,10,28,38,2019100604
2019,5,reg,OAK,CHI,24,21,45,2019100605
2019,5,reg,PHI,NYJ,31,6,37,2019100606
2019,5,reg,LAC,DEN,13,20,33,2019100610
2019,5,reg,DAL,GB,24,34,58,2019100611
2019,5,reg,KC,IND,13,19,32,2019100612
2019,5,reg,SF,CLE,31,3,34,2019100700
2019,6,reg,NE,NYG,35,14,49,2019101000
2019,6,reg,TB,CAR,26,37,63,2019101300
2019,6,reg,MIA,WAS,16,17,33,2019101305
2019,6,reg,MIN,PHI,38,20,58,2019101306
2019,6,reg,KC,HOU,24,31,55,2019101304
2019,6,reg,JAX,NO,6,13,19,2019101303
2019,6,reg,CLE,SEA,28,32,60,2019101302
2019,6,reg,BAL,CIN,23,17,40,2019101301
2019,6,reg,LA,SF,7,20,27,2019101308
2019,6,reg,ARI,ATL,34,33,67,2019101307
2019,6,reg,NYJ,DAL,24,22,46,2019101310
2019,6,reg,DEN,TEN,16,0,16,2019101309
2019,6,reg,LAC,PIT,17,24,41,2019101311
2019,6,reg,GB,DET,23,22,45,2019101400
2019,7,reg,DEN,KC,6,30,36,2019101700
2019,7,reg,BUF,MIA,31,21,52,2019102001
2019,7,reg,CIN,JAX,17,27,44,2019102002
2019,7,reg,DET,MIN,30,42,72,2019102003
2019,7,reg,GB,OAK,42,24,66,2019102004
2019,7,reg,ATL,LA,10,37,47,2019102000
2019,7,reg,IND,HOU,30,23,53,2019102005
2019,7,reg,WAS,SF,0,9,9,2019102007
2019,7,reg,NYG,ARI,21,27,48,2019102006
2019,7,reg,TEN,LAC,23,20,43,2019102008
2019,7,reg,CHI,NO,25,36,61,2019102009
2019,7,reg,SEA,BAL,16,30,46,2019102010
2019,7,reg,DAL,PHI,37,10,47,2019102011
2019,7,reg,NYJ,NE,0,33,33,2019102100
2019,8,reg,MIN,WAS,19,9,28,2019102400
2019,8,reg,ATL,SEA,20,27,47,2019102700
2019,8,reg,IND,DEN,15,13,28,2019102710
2019,8,reg,TEN,TB,27,23,50,2019102708
2019,8,reg,NO,ARI,31,9,40,2019102707
2019,8,reg,LA,CIN,24,10,34,2019102706
2019,8,reg,BUF,PHI,13,31,44,2019102701
2019,8,reg,CHI,LAC,16,17,33,2019102702
2019,8,reg,DET,NYG,31,26,57,2019102703
2019,8,reg,JAX,NYJ,29,15,44,2019102705
2019,8,reg,SF,CAR,51,13,64,2019102709
2019,8,reg,HOU,OAK,27,24,51,2019102704
2019,8,reg,NE,CLE,27,13,40,2019102711
2019,8,reg,KC,GB,24,31,55,2019102712
2019,8,reg,PIT,MIA,27,14,41,2019102800
2019,9,reg,ARI,SF,25,28,53,2019103100
2019,9,reg,JAX,HOU,3,26,29,2019110300
2019,9,reg,PHI,CHI,22,14,36,2019110305
2019,9,reg,PIT,IND,26,24,50,2019110306
2019,9,reg,MIA,NYJ,26,18,44,2019110304
2019,9,reg,KC,MIN,26,23,49,2019110303
2019,9,reg,CAR,TEN,30,20,50,2019110302
2019,9,reg,BUF,WAS,24,9,33,2019110301
2019,9,reg,SEA,TB,40,34,74,2019110308
2019,9,reg,OAK,DET,31,24,55,2019110307
2019,9,reg,LAC,GB,26,11,37,2019110310
2019,9,reg,DEN,CLE,24,19,43,2019110309
2019,9,reg,BAL,NE,37,20,57,2019110311
2019,9,reg,NYG,DAL,18,37,55,2019110400
2019,10,reg,OAK,LAC,26,24,50,2019110700
2019,10,reg,CIN,BAL,13,49,62,2019111001
2019,10,reg,CLE,BUF,19,16,35,2019111002
2019,10,reg,CHI,DET,20,13,33,2019111000
2019,10,reg,NYJ,NYG,34,27,61,2019111005
2019,10,reg,TEN,KC,35,32,67,2019111007
2019,10,reg,TB,ARI,30,27,57,2019111006
2019,10,reg,NO,ATL,9,26,35,2019111004
2019,10,reg,IND,MIA,12,16,28,2019111008
2019,10,reg,PIT,LA,17,12,29,2019111009
2019,10,reg,GB,CAR,24,16,40,2019111003
2019,10,reg,DAL,MIN,24,28,52,2019111010
2019,10,reg,SF,SEA,24,27,51,2019111100
2019,11,reg,CLE,PIT,21,7,28,2019111400
2019,11,reg,CAR,ATL,3,29,32,2019111701
2019,11,reg,DET,DAL,27,35,62,2019111702
2019,11,reg,IND,JAX,33,13,46,2019111703
2019,11,reg,MIA,BUF,20,37,57,2019111704
2019,11,reg,BAL,HOU,41,7,48,2019111700
2019,11,reg,MIN,DEN,27,23,50,2019111705
2019,11,reg,WAS,NYJ,17,34,51,2019111707
2019,11,reg,TB,NO,17,34,51,2019111706
2019,11,reg,SF,ARI,36,26,62,2019111708
2019,11,reg,OAK,CIN,17,10,27,2019111709
2019,11,reg,PHI,NE,10,17,27,2019111710
2019,11,reg,LA,CHI,17,7,24,2019111711
2019,11,reg,LAC,KC,17,24,41,2019111800
2019,12,reg,HOU,IND,20,17,37,2019112100
2019,12,reg,BUF,DEN,20,3,23,2019112401
2019,12,reg,CHI,NYG,19,14,33,2019112402
2019,12,reg,CIN,PIT,10,16,26,2019112403
2019,12,reg,CLE,MIA,41,24,65,2019112404
2019,12,reg,ATL,TB,22,35,57,2019112400
2019,12,reg,NO,CAR,34,31,65,2019112405
2019,12,reg,PHI,SEA,9,17,26,2019112411
2019,12,reg,WAS,DET,19,16,35,2019112407
2019,12,reg,NYJ,OAK,34,3,37,2019112406
2019,12,reg,TEN,JAX,42,20,62,2019112408
2019,12,reg,NE,DAL,13,9,22,2019112409
2019,12,reg,SF,GB,37,8,45,2019112410
2019,12,reg,LA,BAL,6,45,51,2019112500
2019,13,reg,DET,CHI,20,24,44,2019112800
2019,13,reg,DAL,BUF,15,26,41,2019112801
2019,13,reg,ATL,NO,18,26,44,2019112802
2019,13,reg,IND,TEN,17,31,48,2019120103
2019,13,reg,CIN,NYJ,22,6,28,2019120102
2019,13,reg,CAR,WAS,21,29,50,2019120101
2019,13,reg,BAL,SF,20,17,37,2019120100
2019,13,reg,JAX,TB,11,28,39,2019120104
2019,13,reg,PIT,CLE,20,13,33,2019120110
2019,13,reg,NYG,GB,13,31,44,2019120107
2019,13,reg,MIA,PHI,37,31,68,2019120106
2019,13,reg,ARI,LA,7,34,41,2019120108
2019,13,reg,DEN,LAC,23,20,43,2019120109
2019,13,reg,KC,OAK,40,9,49,2019120105
2019,13,reg,HOU,NE,28,22,50,2019120111
2019,13,reg,SEA,MIN,37,30,67,2019120200
2019,14,reg,CHI,DAL,31,24,55,2019120500
2019,14,reg,ATL,CAR,40,20,60,2019120800
2019,14,reg,TB,IND,38,35,73,2019120808
2019,14,reg,NYJ,MIA,22,21,43,2019120807
2019,14,reg,NO,SF,46,48,94,2019120806
2019,14,reg,MIN,DET,20,7,27,2019120805
2019,14,reg,HOU,DEN,24,38,62,2019120804
2019,14,reg,BUF,BAL,17,24,41,2019120801
2019,14,reg,CLE,CIN,27,19,46,2019120802
2019,14,reg,GB,WAS,20,15,35,2019120803
2019,14,reg,JAX,LAC,10,45,55,2019120809
2019,14,reg,ARI,PIT,17,23,40,2019120810
2019,14,reg,OAK,TEN,21,42,63,2019120812
2019,14,reg,NE,KC,16,23,39,2019120811
2019,14,reg,LA,SEA,28,12,40,2019120813
2019,14,reg,PHI,NYG,23,17,40,2019120900
2019,15,reg,BAL,NYJ,42,21,63,2019121200
2019,15,reg,CIN,NE,13,34,47,2019121501
2019,15,reg,DET,TB,17,38,55,2019121502
2019,15,reg,TEN,HOU,21,24,45,2019121507
2019,15,reg,KC,DEN,23,3,26,2019121504
2019,15,reg,NYG,MIA,36,20,56,2019121505
2019,15,reg,WAS,PHI,27,37,64,2019121508
2019,15,reg,CAR,SEA,24,30,54,2019121500
2019,15,reg,GB,CHI,21,13,34,2019121503
2019,15,reg,LAC,MIN,10,39,49,2019121513
2019,15,reg,OAK,JAX,16,20,36,2019121510
2019,15,reg,ARI,CLE,38,24,62,2019121509
2019,15,reg,DAL,LA,44,21,65,2019121511
2019,15,reg,SF,ATL,22,29,51,2019121512
2019,15,reg,PIT,BUF,10,17,27,2019121506
2019,15,reg,NO,IND,34,7,41,2019121600
2019,16,reg,TB,HOU,20,23,43,2019122100
2019,16,reg,NE,BUF,24,17,41,2019122101
2019,16,reg,SF,LA,34,31,65,2019122102
2019,16,reg,MIA,CIN,38,35,73,2019122208
2019,16,reg,NYJ,PIT,16,10,26,2019122209
2019,16,reg,WAS,NYG,35,41,76,2019122211
2019,16,reg,IND,CAR,38,6,44,2019122207
2019,16,reg,CLE,BAL,15,31,46,2019122206
2019,16,reg,ATL,JAX,24,12,36,2019122205
2019,16,reg,TEN,NO,28,38,66,2019122210
2019,16,reg,LAC,OAK,17,24,41,2019122201
2019,16,reg,DEN,DET,27,17,44,2019122200
2019,16,reg,SEA,ARI,13,27,40,2019122213
2019,16,reg,PHI,DAL,17,9,26,2019122212
2019,16,reg,CHI,KC,3,26,29,2019122214
2019,16,reg,MIN,GB,10,23,33,2019122300
2019,17,reg,CIN,CLE,33,23,56,2019122903
2019,17,reg,NE,MIA,24,27,51,2019122910
2019,17,reg,MIN,CHI,19,21,40,2019122909
2019,17,reg,KC,LAC,31,21,52,2019122908
2019,17,reg,BUF,NYJ,6,13,19,2019122901
2019,17,reg,DET,GB,20,23,43,2019122905
2019,17,reg,CAR,NO,10,42,52,2019122902
2019,17,reg,TB,ATL,22,28,50,2019122912
2019,17,reg,NYG,PHI,17,34,51,2019122911
2019,17,reg,HOU,TEN,14,35,49,2019122906
2019,17,reg,DAL,WAS,47,16,63,2019122904
2019,17,reg,BAL,PIT,28,10,38,2019122900
2019,17,reg,JAX,IND,38,20,58,2019122907
2019,17,reg,DEN,OAK,16,15,31,2019122913
2019,17,reg,LA,ARI,31,24,55,2019122914
2019,17,reg,SEA,SF,21,26,47,2019122915
2019,18,post,APR,NPR,,,,2020012600
2019,18,post,HOU,BUF,22,19,41,2020010400
2019,18,post,NE,TEN,13,20,33,2020010401
2019,18,post,NO,MIN,20,26,46,2020010500
2019,18,post,PHI,SEA,9,17,26,2020010501
2019,18,post,SF,MIN,27,10,37,2020011100
2019,18,post,BAL,TEN,12,28,40,2020011101
2019,18,post,KC,HOU,51,31,82,2020011200
2019,18,post,GB,SEA,28,23,51,2020011201
2019,18,post,KC,TEN,35,24,59,2020011900
2019,18,post,SF,GB,37,20,57,2020011901
2019,18,post,KC,SF,31,20,51,2020020200
